광역	광역코드	시군구	선거인수	투표수	유효투표수	무효투표수	기권수	국민중심당	민주노동당	민주당	시민당	열린우리당	한나라당	한미준	희망사회당
서울특별시	1100	종로구	134603	71343	70174	1169	63260	297	6403	9380	164	14856	38784	92	198
서울특별시	1100	중구	107164	55367	54312	1055	51797	213	4252	5588	226	13437	30327	115	154
서울특별시	1100	용산구	187461	95809	94453	1356	91652	434	8460	9879	238	19015	56066	152	209
서울특별시	1100	성동구	266956	131928	129989	1939	135028	504	13381	16125	249	27719	71456	177	378
서울특별시	1100	광진구	293308	141078	139184	1894	152230	865	13805	15683	361	31086	76984	136	264
서울특별시	1100	동대문구	305097	153566	151300	2266	151531	644	14231	16865	299	32589	85965	191	516
서울특별시	1100	중랑구	332783	155618	153529	2089	177165	753	14661	16146	339	33542	87526	156	406
서울특별시	1100	성북구	369617	183341	180779	2562	186276	827	19740	19644	313	41099	98412	248	496
서울특별시	1100	강북구	280448	133966	132151	1815	146482	601	14099	19400	383	28754	68315	208	391
서울특별시	1100	도봉구	291852	147644	145962	1682	144208	802	14734	15118	214	33069	81580	123	322
서울특별시	1100	노원구	465546	239942	236926	3016	225604	1403	27498	22021	376	54081	130631	374	542
서울특별시	1100	은평구	367295	173524	171065	2459	193771	924	16723	19104	335	40239	93018	239	483
서울특별시	1100	서대문구	277490	137876	135768	2108	139614	625	14051	13196	215	32278	74966	134	303
서울특별시	1100	마포구	312630	154433	152070	2363	158197	651	17072	15670	584	34646	82885	177	385
서울특별시	1100	양천구	374034	193203	190494	2709	180831	1043	18212	18143	385	42216	109427	573	495
서울특별시	1100	강서구	430027	211558	208632	2926	218469	1070	22370	20575	420	45751	117367	490	589
서울특별시	1100	구로구	327895	164412	161567	2845	163483	1087	18701	15971	262	36764	88243	193	346
서울특별시	1100	금천구	199986	97773	96108	1665	102213	775	10555	12223	206	21989	49947	150	263
서울특별시	1100	영등포구	325010	163783	161375	2408	161227	892	14769	16020	456	36203	92370	216	449
서울특별시	1100	동작구	328129	166421	164200	2221	161708	863	17326	20035	267	36448	88715	185	361
서울특별시	1100	관악구	431791	210835	208183	2652	220956	1159	29077	30925	389	46260	99637	203	533
서울특별시	1100	서초구	316852	164432	162438	1994	152420	576	11508	11764	152	24991	113044	123	280
서울특별시	1100	강남구	433889	216748	214780	1968	217141	654	13904	13196	219	30811	155450	135	411
서울특별시	1100	송파구	467011	237296	234803	2493	229715	901	20200	20690	271	45297	146796	177	471
서울특별시	1100	강동구	356774	175768	173429	2339	181006	959	15477	16440	260	34189	105562	145	397
부산광역시	2600	중구	43062	22766	22193	573	20296	0	2397	536	0	4134	15126	0	0
부산광역시	2600	서구	112683	55036	53733	1303	57647	0	5896	1558	0	9230	37049	0	0
부산광역시	2600	동구	89864	46769	45240	1529	43095	0	5166	1038	0	8410	30626	0	0
부산광역시	2600	영도구	131447	63269	62019	1250	68178	0	7934	1924	0	14710	37451	0	0
부산광역시	2600	부산진구	325963	157491	155105	2386	168472	0	20342	2931	0	28452	103380	0	0
부산광역시	2600	동래구	216997	107494	105996	1498	109503	0	13028	1824	0	17864	73280	0	0
부산광역시	2600	남구	238368	116835	115088	1747	121533	0	15648	1983	0	22646	74811	0	0
부산광역시	2600	북구	248396	117436	115873	1563	130960	0	15583	2189	0	25113	72988	0	0
부산광역시	2600	해운대구	309668	145645	143503	2142	164023	0	18480	2706	0	27934	94383	0	0
부산광역시	2600	기장군	61953	36131	35241	890	25822	0	4575	750	0	6938	22978	0	0
부산광역시	2600	사하구	284656	128358	126541	1817	156298	0	16366	2373	0	27000	80802	0	0
부산광역시	2600	금정구	209276	103939	102094	1845	105337	0	12511	1829	0	18388	69366	0	0
부산광역시	2600	강서구	44796	26884	26106	778	17912	0	3105	675	0	6643	15683	0	0
부산광역시	2600	연제구	172349	84789	83506	1283	87560	0	10210	1565	0	15482	56249	0	0
부산광역시	2600	수영구	143359	67639	66635	1004	75720	0	7820	1183	0	11705	45927	0	0
부산광역시	2600	사상구	212267	98086	96737	1349	114181	0	11536	2095	0	22086	61020	0	0
대구광역시	2700	중구	66126	35272	34443	829	30854	335	2551	0	0	4223	27334	0	0
대구광역시	2700	동구	267710	129209	127442	1767	138501	985	10508	0	0	18534	97415	0	0
대구광역시	2700	서구	194812	92265	90897	1368	102547	1008	8019	0	0	10090	71780	0	0
대구광역시	2700	남구	145954	70018	69000	1018	75936	531	5496	0	0	8517	54456	0	0
대구광역시	2700	북구	341531	159684	157841	1843	181847	1314	14329	0	0	20562	121636	0	0
대구광역시	2700	수성구	320246	157444	155769	1675	162802	1069	11884	0	0	18465	124351	0	0
대구광역시	2700	달서구	432607	206958	204900	2058	225649	1521	19744	0	0	24826	158809	0	0
대구광역시	2700	달성군	116057	64167	62576	1591	51890	1017	8224	0	0	8326	45009	0	0
인천광역시	2800	중구	72876	34797	34232	565	38079	0	3631	2607	0	6974	20757	0	263
인천광역시	2800	동구	61515	30819	30244	575	30696	0	4947	1933	0	5687	17334	0	343
인천광역시	2800	남구	327614	140572	138590	1982	187042	0	16991	8159	0	27690	84647	0	1103
인천광역시	2800	연수구	191076	88040	87180	860	103036	0	11210	3596	0	17247	54617	0	510
인천광역시	2800	남동구	284121	123414	122009	1405	160707	0	17359	9692	0	24788	69255	0	915
인천광역시	2800	부평구	425004	181468	179314	2154	243536	0	28865	14924	0	35468	98520	0	1537
인천광역시	2800	계양구	239585	100433	99398	1035	139152	0	13535	7344	0	23410	54356	0	753
인천광역시	2800	서구	271645	114475	113111	1364	157170	0	15782	8777	0	24578	63108	0	866
인천광역시	2800	강화군	53699	35401	33837	1564	18298	0	3226	1419	0	6750	21717	0	725
인천광역시	2800	옹진군	13268	10165	9798	367	3103	0	601	413	0	2439	6104	0	241
광주광역시	2900	동구	90767	43239	42492	747	47528	0	5476	21370	0	12460	2724	0	462
광주광역시	2900	서구	221034	102565	101398	1167	118469	0	18008	48784	0	28996	4840	0	770
광주광역시	2900	남구	161406	78304	77257	1047	83102	0	9851	41447	0	21589	3727	0	643
광주광역시	2900	북구	333413	147710	145796	1914	185703	0	22733	71810	0	43257	6679	0	1317
광주광역시	2900	광산구	208000	97518	95966	1552	110482	0	20501	45120	0	25131	3937	0	1277
대전광역시	3000	동구	183206	87966	86348	1618	95240	18325	6875	0	0	22994	38154	0	0
대전광역시	3000	중구	203076	100890	99351	1539	102186	20203	6739	0	0	25798	46611	0	0
대전광역시	3000	서구	367265	182487	180402	2085	184778	31042	14981	0	0	47041	87338	0	0
대전광역시	3000	유성구	164867	84059	83160	899	80808	12055	9004	0	0	23635	38466	0	0
대전광역시	3000	대덕구	159054	77151	76064	1087	81903	14401	8475	0	0	19968	33220	0	0
울산광역시	3100	중구	175337	88547	87450	1097	86790	0	20916	0	0	11516	55018	0	0
울산광역시	3100	남구	250864	123848	122573	1275	127016	0	26115	0	0	17353	79105	0	0
울산광역시	3100	동구	136957	75740	74547	1193	61217	0	26853	0	0	12311	35383	0	0
울산광역시	3100	북구	99489	55383	54662	721	44106	0	23194	0	0	5444	26024	0	0
울산광역시	3100	울주군	127642	73690	71860	1830	53952	0	13094	0	0	13658	45108	0	0
경기도	4100	수원시장안구	206015	98090	97175	915	107925	668	12821	5715	0	20800	56733	0	438
경기도	4100	수원시권선구	217455	97488	96538	950	119967	830	12167	4924	0	21113	56977	0	527
경기도	4100	수원시팔달구	166662	72027	71191	836	94635	446	7832	4066	0	15015	43445	0	387
경기도	4100	수원시영통구	173454	82010	81414	596	91444	442	10549	3560	0	18738	47824	0	301
경기도	4100	성남시수정구	206678	84874	83764	1110	121804	950	11594	10380	0	20397	39991	0	452
경기도	4100	성남시중원구	207205	82653	81621	1032	124552	535	11984	10742	0	18513	39393	0	454
경기도	4100	성남시분당구	330404	164185	162962	1223	166219	634	13623	9017	0	27769	111428	0	491
경기도	4100	의정부시	299556	130371	129037	1334	169185	588	13834	6139	0	31967	75880	0	629
경기도	4100	안양시만안구	204688	95585	94575	1010	109103	788	10488	7011	0	22268	53501	0	519
경기도	4100	안양시동안구	259321	134640	133417	1223	124681	1021	14537	8676	0	30426	78248	0	509
경기도	4100	부천시원미구	327003	143405	142116	1289	183598	1454	15602	10023	0	33984	80384	0	669
경기도	4100	부천시소사구	170625	78652	77743	909	91973	981	8484	6038	0	16967	44906	0	367
경기도	4100	부천시오정구	137195	53685	53012	673	83510	565	5240	6334	0	13040	27587	0	246
경기도	4100	광명시	239187	112868	111643	1225	126319	1469	12405	11883	0	25743	59644	0	499
경기도	4100	평택시	284458	139664	137554	2110	144794	2702	21634	5608	0	28513	78068	0	1029
경기도	4100	양주시	121097	61139	59965	1174	59958	372	5443	3583	0	14069	35568	0	930
경기도	4100	동두천시	63655	33133	32404	729	30522	180	2399	1512	0	8459	19554	0	300
경기도	4100	안산시상록구	253921	102637	101547	1090	151284	985	13847	9088	0	23669	53401	0	557
경기도	4100	안산시단원구	230496	94603	93556	1047	135893	930	12539	8107	0	21682	49869	0	429
경기도	4100	고양시덕양구	287230	130060	128723	1337	157170	596	13617	9314	0	28995	75560	0	641
경기도	4100	고양시일산동구	162750	73918	73277	641	88832	311	7063	4221	0	15638	45737	0	307
경기도	4100	고양시일산서구	201819	95295	94502	793	106524	447	9316	5420	0	20875	58066	0	378
경기도	4100	과천시	43524	25788	25539	249	17736	127	2776	1243	0	5607	15716	0	70
경기도	4100	의왕시	105917	53779	53256	523	52138	543	5304	3701	0	12469	30967	0	272
경기도	4100	구리시	140385	68673	67909	764	71712	337	7024	4409	0	16536	39232	0	371
경기도	4100	남양주시	336528	148531	146688	1843	187997	888	16461	9866	0	30796	87757	0	920
경기도	4100	오산시	94380	45851	45176	675	48529	1056	5027	2662	0	10930	25120	0	381
경기도	4100	화성시	223162	100405	98868	1537	122757	678	12046	4049	0	21504	59821	0	770
경기도	4100	시흥시	271413	109489	108318	1171	161924	830	13113	9599	0	26305	57677	0	794
경기도	4100	군포시	203276	103780	102901	879	99496	989	12301	6797	0	25407	57052	0	355
경기도	4100	하남시	103677	52353	51530	823	51324	389	5524	4010	0	10255	30912	0	440
경기도	4100	파주시	206376	98469	96792	1677	107907	546	7678	3760	0	20262	63334	0	1212
경기도	4100	여주군	79881	41534	40500	1034	38347	700	3867	1217	0	8681	25569	0	466
경기도	4100	이천시	140754	66684	65410	1274	74070	530	6158	3275	0	14183	40656	0	608
경기도	4100	용인시처인구	146083	67524	66277	1247	78559	455	5370	3008	0	16547	40429	0	468
경기도	4100	용인시수지구	196871	97192	96546	646	99679	338	7902	4086	0	18401	65572	0	247
경기도	4100	용인시기흥구	175478	84667	83837	830	90811	526	7955	3858	0	18448	52736	0	314
경기도	4100	안성시	119170	64430	63089	1341	54740	776	8153	2098	0	15388	35791	0	883
경기도	4100	김포시	152704	77094	75962	1132	75610	403	5822	4291	0	16989	47883	0	574
경기도	4100	광주시	161569	73074	72028	1046	88495	390	5534	6186	0	15071	44477	0	370
경기도	4100	포천시	117916	59908	58468	1440	58008	457	4330	2245	0	13498	37064	0	874
경기도	4100	연천군	36970	22967	22268	699	14003	268	1560	1258	0	5575	13134	0	473
경기도	4100	양평군	68290	42692	41521	1171	25598	475	3176	1769	0	7341	28034	0	726
경기도	4100	가평군	43630	29655	28641	1014	13975	313	2014	1206	0	6063	18461	0	584
강원도	4200	춘천시	192644	104119	101533	2586	88525	0	18321	0	0	24956	58256	0	0
강원도	4200	원주시	215770	106892	104639	2253	108878	0	14379	0	0	25485	64775	0	0
강원도	4200	강릉시	171138	92505	90609	1896	78633	0	9540	0	0	17196	63873	0	0
강원도	4200	동해시	74884	43269	42133	1136	31615	0	4814	0	0	8403	28916	0	0
강원도	4200	삼척시	57751	39786	38260	1526	17965	0	4523	0	0	8030	25707	0	0
강원도	4200	태백시	41345	27806	27107	699	13539	0	2940	0	0	6923	17244	0	0
강원도	4200	정선군	35948	25156	24431	725	10792	0	2374	0	0	7817	14240	0	0
강원도	4200	속초시	64750	34118	33357	761	30632	0	3802	0	0	7852	21703	0	0
강원도	4200	고성군	25708	18722	17889	833	6986	0	1685	0	0	4942	11262	0	0
강원도	4200	양양군	23582	16898	16158	740	6684	0	1977	0	0	3791	10390	0	0
강원도	4200	인제군	25130	18225	17593	632	6905	0	1730	0	0	5825	10038	0	0
강원도	4200	홍천군	55429	33769	32703	1066	21660	0	3710	0	0	9839	19154	0	0
강원도	4200	횡성군	35200	24117	23240	877	11083	0	3033	0	0	6977	13230	0	0
강원도	4200	영월군	33449	22725	22144	581	10724	0	1951	0	0	7536	12657	0	0
강원도	4200	평창군	36045	23370	22812	558	12675	0	2051	0	0	7515	13246	0	0
강원도	4200	화천군	18404	13078	12530	548	5326	0	2030	0	0	3182	7318	0	0
강원도	4200	양구군	16454	12040	11443	597	4414	0	1859	0	0	2894	6690	0	0
강원도	4200	철원군	37346	24932	24175	757	12414	0	3461	0	0	6622	14092	0	0
충청북도	4300	청주시상당구	188493	89042	87684	1358	99451	3668	11009	0	0	23116	49891	0	0
충청북도	4300	청주시흥덕구	269249	121819	120100	1719	147430	4592	16622	0	0	32863	66023	0	0
충청북도	4300	충주시	155769	83465	81472	1993	72304	2067	8261	0	0	24601	46543	0	0
충청북도	4300	제천시	105920	60203	58766	1437	45717	1588	8569	0	0	15205	33404	0	0
충청북도	4300	단양군	27458	19534	18878	656	7924	670	1665	0	0	5660	10883	0	0
충청북도	4300	청원군	95259	53190	51676	1514	42069	4382	5068	0	0	16569	25657	0	0
충청북도	4300	영동군	41700	29568	28566	1002	12132	887	2687	0	0	9803	15189	0	0
충청북도	4300	보은군	30273	22889	22126	763	7384	1415	1907	0	0	8778	10026	0	0
충청북도	4300	옥천군	44454	31349	30166	1183	13105	1531	3070	0	0	10907	14658	0	0
충청북도	4300	음성군	66010	38459	37155	1304	27551	1407	4982	0	0	10721	20045	0	0
충청북도	4300	진천군	46069	28090	27202	888	17979	811	4863	0	0	7889	13639	0	0
충청북도	4300	괴산군	32511	23934	22706	1228	8577	1272	3766	0	0	6170	11498	0	0
충청북도	4300	증평군	23117	14516	14022	494	8601	565	1834	0	0	3924	7699	0	0
충청남도	4400	천안시	372195	162678	160405	2273	209517	26746	20309	0	0	32342	81008	0	0
충청남도	4400	공주시	100960	61078	59199	1879	39882	25640	4232	0	0	12137	17190	0	0
충청남도	4400	보령시	84236	52538	50820	1718	31698	16244	3822	0	0	10332	20422	0	0
충청남도	4400	아산시	156817	74768	72857	1911	82049	18727	8679	0	0	12705	32746	0	0
충청남도	4400	서산시	112204	61308	59717	1591	50896	18812	6209	0	0	12565	22131	0	0
충청남도	4400	태안군	51770	35082	33706	1376	16688	12482	2059	0	0	7619	11546	0	0
충청남도	4400	금산군	47627	32266	31122	1144	15361	11294	1828	0	0	6170	11830	0	0
충청남도	4400	연기군	65548	39858	38715	1143	25690	12892	2209	0	0	12751	10863	0	0
충청남도	4400	논산시	104305	57833	55884	1949	46472	22602	3631	0	0	12150	17501	0	0
충청남도	4400	계룡시	24442	15356	15116	240	9086	3783	775	0	0	3006	7552	0	0
충청남도	4400	부여군	65087	41902	40139	1763	23185	15523	3312	0	0	6354	14950	0	0
충청남도	4400	서천군	52107	37465	35915	1550	14642	11669	2449	0	0	10302	11495	0	0
충청남도	4400	홍성군	71168	44370	42738	1632	26798	10902	2556	0	0	7282	21998	0	0
충청남도	4400	청양군	28517	21470	20666	804	7047	7632	1573	0	0	2566	8895	0	0
충청남도	4400	예산군	72864	44386	43154	1232	28478	9538	2273	0	0	5786	25557	0	0
충청남도	4400	당진군	93393	55972	54263	1709	37421	17377	4553	0	0	11395	20938	0	0
전라북도	4500	전주시완산구	252082	121289	119334	1955	130793	0	17421	44945	0	48214	8754	0	0
전라북도	4500	전주시덕진구	198612	94134	92615	1519	104478	0	15458	33060	0	37453	6644	0	0
전라북도	4500	군산시	198467	111756	107822	3934	86711	0	15872	41702	0	38635	11613	0	0
전라북도	4500	익산시	235847	123054	119711	3343	112793	0	17431	46065	0	46974	9241	0	0
전라북도	4500	정읍시	99727	62079	60116	1963	37648	0	9905	22520	0	24269	3422	0	0
전라북도	4500	남원시	72197	50208	48577	1631	21989	0	4742	18969	0	21723	3143	0	0
전라북도	4500	김제시	82928	55586	53375	2211	27342	0	8340	19095	0	22023	3917	0	0
전라북도	4500	완주군	66720	41558	40335	1223	25162	0	6533	16072	0	15444	2286	0	0
전라북도	4500	진안군	23432	17524	16780	744	5908	0	2226	4589	0	8399	1566	0	0
전라북도	4500	무주군	21301	16835	16035	800	4466	0	1948	4394	0	7771	1922	0	0
전라북도	4500	장수군	20567	16462	15835	627	4105	0	2961	4441	0	7273	1160	0	0
전라북도	4500	임실군	27747	21428	20639	789	6319	0	2361	7713	0	8967	1598	0	0
전라북도	4500	순창군	25579	19723	18956	767	5856	0	2494	5159	0	10068	1235	0	0
전라북도	4500	고창군	51732	37864	36451	1413	13868	0	6020	16398	0	11845	2188	0	0
전라북도	4500	부안군	52694	37860	35928	1932	14834	0	6059	17251	0	9520	3098	0	0
전라남도	4600	목포시	176932	88357	86587	1770	88575	0	11071	54542	0	17475	3499	0	0
전라남도	4600	여수시	224001	122804	120182	2622	101197	0	13760	62095	0	38139	6188	0	0
전라남도	4600	순천시	194227	105388	102977	2411	88839	0	14416	56313	0	26506	5742	0	0
전라남도	4600	나주시	79340	55199	52858	2341	24141	0	7293	34242	0	8848	2475	0	0
전라남도	4600	광양시	96951	58742	57522	1220	38209	0	9688	26345	0	16367	5122	0	0
전라남도	4600	담양군	41974	29473	28521	952	12501	0	2451	17373	0	7310	1387	0	0
전라남도	4600	장성군	39626	27749	26799	950	11877	0	3007	16965	0	4929	1898	0	0
전라남도	4600	곡성군	28138	21815	20993	822	6323	0	2747	11446	0	5491	1309	0	0
전라남도	4600	구례군	24281	19122	18517	605	5159	0	2203	10122	0	5150	1042	0	0
전라남도	4600	고흥군	69751	52673	50289	2384	17078	0	3964	33152	0	10878	2295	0	0
전라남도	4600	보성군	44024	33390	31790	1600	10634	0	3847	20736	0	4247	2960	0	0
전라남도	4600	화순군	56833	39819	38538	1281	17014	0	9152	22931	0	4596	1859	0	0
전라남도	4600	장흥군	36549	27015	26069	946	9534	0	6078	14659	0	3698	1634	0	0
전라남도	4600	강진군	34405	24112	23170	942	10293	0	2350	13735	0	5235	1850	0	0
전라남도	4600	완도군	47793	35481	34046	1435	12312	0	1982	21211	0	9442	1411	0	0
전라남도	4600	해남군	68768	50578	48148	2430	18190	0	5477	31152	0	9151	2368	0	0
전라남도	4600	진도군	29821	22634	21345	1289	7187	0	2982	12184	0	4635	1544	0	0
전라남도	4600	영암군	48203	32076	30973	1103	16127	0	3600	18284	0	7594	1495	0	0
전라남도	4600	무안군	50427	36604	35331	1273	13823	0	3218	20621	0	10031	1461	0	0
전라남도	4600	영광군	48577	36303	34871	1432	12274	0	4195	20616	0	7750	2310	0	0
전라남도	4600	함평군	33051	24380	23337	1043	8671	0	3225	15161	0	3603	1348	0	0
전라남도	4600	신안군	40240	30072	28331	1741	10168	0	2907	19451	0	4054	1919	0	0
경상북도	4700	포항시북구	190449	105455	103765	1690	84994	811	10455	1684	0	11741	79074	0	0
경상북도	4700	포항시남구	191369	106550	104756	1794	84819	882	12024	1799	0	13941	76110	0	0
경상북도	4700	울릉군	8429	7196	6959	237	1233	81	411	119	0	1349	4999	0	0
경상북도	4700	경주시	210980	126361	123568	2793	84619	1314	13322	2100	0	13487	93345	0	0
경상북도	4700	김천시	110274	75350	73435	1915	34924	1001	4873	2489	0	7395	57677	0	0
경상북도	4700	안동시	134448	86102	83623	2479	48346	1255	8325	1741	0	11936	60366	0	0
경상북도	4700	구미시	269226	132384	130510	1874	136842	1212	11296	1650	0	16526	99826	0	0
경상북도	4700	영주시	93247	63460	61991	1469	29787	700	6278	1150	0	7940	45923	0	0
경상북도	4700	영천시	86235	55409	53798	1611	30826	725	4094	1115	0	9997	37867	0	0
경상북도	4700	상주시	88983	63160	61094	2066	25823	1199	6065	1709	0	7063	45058	0	0
경상북도	4700	문경시	62743	45415	44071	1344	17328	823	2122	846	0	4367	35913	0	0
경상북도	4700	예천군	42780	33331	32106	1225	9449	1072	2173	842	0	3595	24424	0	0
경상북도	4700	경산시	175092	86528	84840	1688	88564	743	7551	1107	0	10198	65241	0	0
경상북도	4700	청도군	39951	29829	28839	990	10122	460	1765	656	0	3422	22536	0	0
경상북도	4700	고령군	28906	20682	19864	818	8224	345	1945	501	0	2450	14623	0	0
경상북도	4700	성주군	38867	27064	26071	993	11803	336	1614	581	0	3487	20053	0	0
경상북도	4700	칠곡군	82468	44219	43081	1138	38249	603	3641	848	0	5930	32059	0	0
경상북도	4700	군위군	23767	18446	17590	856	5321	360	1396	540	0	2219	13075	0	0
경상북도	4700	의성군	55083	41615	40184	1431	13468	735	3275	977	0	5750	29447	0	0
경상북도	4700	청송군	24481	18777	18018	759	5704	359	1669	516	0	2957	12517	0	0
경상북도	4700	영양군	17011	13680	12985	695	3331	349	1145	456	0	2551	8484	0	0
경상북도	4700	영덕군	37578	27226	26359	867	10352	458	1459	612	0	3596	20234	0	0
경상북도	4700	봉화군	30652	23132	22401	731	7520	551	2033	722	0	3063	16032	0	0
경상북도	4700	울진군	44690	32976	31771	1205	11714	446	1941	671	0	6492	22221	0	0
경상남도	4800	창원시	356493	184107	181813	2294	172386	0	47045	0	0	26878	107890	0	0
경상남도	4800	마산시	326663	171759	168863	2896	154904	0	25601	0	0	23426	119836	0	0
경상남도	4800	진주시	252537	145222	142520	2702	107315	0	25816	0	0	21021	95683	0	0
경상남도	4800	진해시	118111	70222	68742	1480	47889	0	11006	0	0	12107	45629	0	0
경상남도	4800	통영시	102469	60723	59037	1686	41746	0	6700	0	0	9891	42446	0	0
경상남도	4800	고성군	46167	33461	32265	1196	12706	0	6662	0	0	4864	20739	0	0
경상남도	4800	사천시	86136	57391	55796	1595	28745	0	10333	0	0	8642	36821	0	0
경상남도	4800	김해시	315263	150973	148543	2430	164290	0	21067	0	0	41598	85878	0	0
경상남도	4800	밀양시	90362	58411	56745	1666	31951	0	7793	0	0	13909	35043	0	0
경상남도	4800	거제시	142095	75621	73971	1650	66474	0	21132	0	0	12474	40365	0	0
경상남도	4800	의령군	26675	21737	20489	1248	4938	0	5222	0	0	3110	12157	0	0
경상남도	4800	함안군	48706	34249	32892	1357	14457	0	6725	0	0	4813	21354	0	0
경상남도	4800	창녕군	52848	37278	35796	1482	15570	0	5237	0	0	6366	24193	0	0
경상남도	4800	양산시	162544	86359	84460	1899	76185	0	12562	0	0	17123	54775	0	0
경상남도	4800	하동군	42978	31435	30074	1361	11543	0	5163	0	0	7580	17331	0	0
경상남도	4800	남해군	42965	32993	31643	1350	9972	0	3747	0	0	9562	18334	0	0
경상남도	4800	함양군	34178	27658	26630	1028	6520	0	3830	0	0	6439	16361	0	0
경상남도	4800	산청군	30952	23786	22829	957	7166	0	4195	0	0	3312	15322	0	0
경상남도	4800	거창군	50916	35361	33876	1485	15555	0	5212	0	0	4843	23821	0	0
경상남도	4800	합천군	46207	34994	33658	1336	11213	0	6829	0	0	5030	21799	0	0
제주특별자치도	4900	제주시	218768	138709	136192	2517	80059	0	25982	10408	0	35701	64101	0	0
제주특별자치도	4900	북제주군	74387	51649	50221	1428	22738	0	9437	4860	0	14654	21270	0	0
제주특별자치도	4900	서귀포시	62209	43562	42556	1006	18647	0	7685	3747	0	11570	19554	0	0
제주특별자치도	4900	남제주군	56498	43076	41946	1130	13422	0	11226	2775	0	10157	17788	0	0
