광역	광역코드	시군구	선거인수	투표수	유효투표수	무효투표수	기권수	득표수	후보명	정당
서울특별시	1100	종로구	133946	85480	85157	323	48466	21515	정동영	대통합민주신당
서울특별시	1100	중구	106837	66496	66285	211	40341	17299	정동영	대통합민주신당
서울특별시	1100	용산구	190910	117051	116704	347	73859	25967	정동영	대통합민주신당
서울특별시	1100	성동구	266124	165391	164911	480	100733	41902	정동영	대통합민주신당
서울특별시	1100	광진구	297332	183412	182988	424	113920	46597	정동영	대통합민주신당
서울특별시	1100	동대문구	304410	190407	189801	606	114003	49064	정동영	대통합민주신당
서울특별시	1100	중랑구	337898	204119	203489	630	133779	54085	정동영	대통합민주신당
서울특별시	1100	성북구	373761	235180	234542	638	138581	60790	정동영	대통합민주신당
서울특별시	1100	강북구	277954	168236	167702	534	109718	47290	정동영	대통합민주신당
서울특별시	1100	도봉구	293138	188015	187475	540	105123	46515	정동영	대통합민주신당
서울특별시	1100	노원구	466884	306503	305585	918	160381	76021	정동영	대통합민주신당
서울특별시	1100	은평구	362685	218004	217241	763	144681	59909	정동영	대통합민주신당
서울특별시	1100	서대문구	278848	174263	173769	494	104585	46522	정동영	대통합민주신당
서울특별시	1100	마포구	315333	194947	194415	532	120386	49343	정동영	대통합민주신당
서울특별시	1100	양천구	378841	241697	241065	632	137144	59636	정동영	대통합민주신당
서울특별시	1100	강서구	436622	272240	271059	1181	164382	68471	정동영	대통합민주신당
서울특별시	1100	구로구	333323	211497	210897	600	121826	55683	정동영	대통합민주신당
서울특별시	1100	금천구	196513	118869	118454	415	77644	34966	정동영	대통합민주신당
서울특별시	1100	영등포구	325884	206002	205371	631	119882	51008	정동영	대통합민주신당
서울특별시	1100	동작구	326851	209902	209350	552	116949	53613	정동영	대통합민주신당
서울특별시	1100	관악구	439707	268101	267400	701	171606	77804	정동영	대통합민주신당
서울특별시	1100	서초구	320018	212282	211836	446	107736	34112	정동영	대통합민주신당
서울특별시	1100	강남구	442286	283231	282618	613	159055	41493	정동영	대통합민주신당
서울특별시	1100	송파구	483567	313620	312799	821	169947	66697	정동영	대통합민주신당
서울특별시	1100	강동구	362024	231077	230456	621	130947	51510	정동영	대통합민주신당
서울특별시	1100	종로구	133946	85480	85157	323	48466	45172	이명박	한나라당
서울특별시	1100	중구	106837	66496	66285	211	40341	35335	이명박	한나라당
서울특별시	1100	용산구	190910	117051	116704	347	73859	66096	이명박	한나라당
서울특별시	1100	성동구	266124	165391	164911	480	100733	88602	이명박	한나라당
서울특별시	1100	광진구	297332	183412	182988	424	113920	94864	이명박	한나라당
서울특별시	1100	동대문구	304410	190407	189801	606	114003	100709	이명박	한나라당
서울특별시	1100	중랑구	337898	204119	203489	630	133779	105608	이명박	한나라당
서울특별시	1100	성북구	373761	235180	234542	638	138581	123186	이명박	한나라당
서울특별시	1100	강북구	277954	168236	167702	534	109718	85791	이명박	한나라당
서울특별시	1100	도봉구	293138	188015	187475	540	105123	99596	이명박	한나라당
서울특별시	1100	노원구	466884	306503	305585	918	160381	157439	이명박	한나라당
서울특별시	1100	은평구	362685	218004	217241	763	144681	108240	이명박	한나라당
서울특별시	1100	서대문구	278848	174263	173769	494	104585	87645	이명박	한나라당
서울특별시	1100	마포구	315333	194947	194415	532	120386	97347	이명박	한나라당
서울특별시	1100	양천구	378841	241697	241065	632	137144	127919	이명박	한나라당
서울특별시	1100	강서구	436622	272240	271059	1181	164382	138876	이명박	한나라당
서울특별시	1100	구로구	333323	211497	210897	600	121826	102968	이명박	한나라당
서울특별시	1100	금천구	196513	118869	118454	415	77644	55968	이명박	한나라당
서울특별시	1100	영등포구	325884	206002	205371	631	119882	106558	이명박	한나라당
서울특별시	1100	동작구	326851	209902	209350	552	116949	106067	이명박	한나라당
서울특별시	1100	관악구	439707	268101	267400	701	171606	121270	이명박	한나라당
서울특별시	1100	서초구	320018	212282	211836	446	107736	136443	이명박	한나라당
서울특별시	1100	강남구	442286	283231	282618	613	159055	187778	이명박	한나라당
서울특별시	1100	송파구	483567	313620	312799	821	169947	180704	이명박	한나라당
서울특별시	1100	강동구	362024	231077	230456	621	130947	128981	이명박	한나라당
서울특별시	1100	종로구	133946	85480	85157	323	48466	1889	권영길	민주노동당
서울특별시	1100	중구	106837	66496	66285	211	40341	1387	권영길	민주노동당
서울특별시	1100	용산구	190910	117051	116704	347	73859	2358	권영길	민주노동당
서울특별시	1100	성동구	266124	165391	164911	480	100733	3811	권영길	민주노동당
서울특별시	1100	광진구	297332	183412	182988	424	113920	4159	권영길	민주노동당
서울특별시	1100	동대문구	304410	190407	189801	606	114003	4443	권영길	민주노동당
서울특별시	1100	중랑구	337898	204119	203489	630	133779	4913	권영길	민주노동당
서울특별시	1100	성북구	373761	235180	234542	638	138581	5597	권영길	민주노동당
서울특별시	1100	강북구	277954	168236	167702	534	109718	4278	권영길	민주노동당
서울특별시	1100	도봉구	293138	188015	187475	540	105123	4563	권영길	민주노동당
서울특별시	1100	노원구	466884	306503	305585	918	160381	8445	권영길	민주노동당
서울특별시	1100	은평구	362685	218004	217241	763	144681	5069	권영길	민주노동당
서울특별시	1100	서대문구	278848	174263	173769	494	104585	4364	권영길	민주노동당
서울특별시	1100	마포구	315333	194947	194415	532	120386	5627	권영길	민주노동당
서울특별시	1100	양천구	378841	241697	241065	632	137144	5232	권영길	민주노동당
서울특별시	1100	강서구	436622	272240	271059	1181	164382	6363	권영길	민주노동당
서울특별시	1100	구로구	333323	211497	210897	600	121826	5587	권영길	민주노동당
서울특별시	1100	금천구	196513	118869	118454	415	77644	3289	권영길	민주노동당
서울특별시	1100	영등포구	325884	206002	205371	631	119882	4716	권영길	민주노동당
서울특별시	1100	동작구	326851	209902	209350	552	116949	4988	권영길	민주노동당
서울특별시	1100	관악구	439707	268101	267400	701	171606	8362	권영길	민주노동당
서울특별시	1100	서초구	320018	212282	211836	446	107736	2969	권영길	민주노동당
서울특별시	1100	강남구	442286	283231	282618	613	159055	3806	권영길	민주노동당
서울특별시	1100	송파구	483567	313620	312799	821	169947	5499	권영길	민주노동당
서울특별시	1100	강동구	362024	231077	230456	621	130947	4630	권영길	민주노동당
서울특별시	1100	종로구	133946	85480	85157	323	48466	398	이인제	민주당
서울특별시	1100	중구	106837	66496	66285	211	40341	328	이인제	민주당
서울특별시	1100	용산구	190910	117051	116704	347	73859	532	이인제	민주당
서울특별시	1100	성동구	266124	165391	164911	480	100733	894	이인제	민주당
서울특별시	1100	광진구	297332	183412	182988	424	113920	845	이인제	민주당
서울특별시	1100	동대문구	304410	190407	189801	606	114003	910	이인제	민주당
서울특별시	1100	중랑구	337898	204119	203489	630	133779	961	이인제	민주당
서울특별시	1100	성북구	373761	235180	234542	638	138581	1062	이인제	민주당
서울특별시	1100	강북구	277954	168236	167702	534	109718	1039	이인제	민주당
서울특별시	1100	도봉구	293138	188015	187475	540	105123	842	이인제	민주당
서울특별시	1100	노원구	466884	306503	305585	918	160381	1351	이인제	민주당
서울특별시	1100	은평구	362685	218004	217241	763	144681	1127	이인제	민주당
서울특별시	1100	서대문구	278848	174263	173769	494	104585	828	이인제	민주당
서울특별시	1100	마포구	315333	194947	194415	532	120386	863	이인제	민주당
서울특별시	1100	양천구	378841	241697	241065	632	137144	966	이인제	민주당
서울특별시	1100	강서구	436622	272240	271059	1181	164382	1335	이인제	민주당
서울특별시	1100	구로구	333323	211497	210897	600	121826	1169	이인제	민주당
서울특별시	1100	금천구	196513	118869	118454	415	77644	767	이인제	민주당
서울특별시	1100	영등포구	325884	206002	205371	631	119882	962	이인제	민주당
서울특별시	1100	동작구	326851	209902	209350	552	116949	1010	이인제	민주당
서울특별시	1100	관악구	439707	268101	267400	701	171606	1695	이인제	민주당
서울특별시	1100	서초구	320018	212282	211836	446	107736	582	이인제	민주당
서울특별시	1100	강남구	442286	283231	282618	613	159055	722	이인제	민주당
서울특별시	1100	송파구	483567	313620	312799	821	169947	1100	이인제	민주당
서울특별시	1100	강동구	362024	231077	230456	621	130947	926	이인제	민주당
서울특별시	1100	종로구	133946	85480	85157	323	48466	5722	문국현	창조한국당
서울특별시	1100	중구	106837	66496	66285	211	40341	4324	문국현	창조한국당
서울특별시	1100	용산구	190910	117051	116704	347	73859	7544	문국현	창조한국당
서울특별시	1100	성동구	266124	165391	164911	480	100733	11330	문국현	창조한국당
서울특별시	1100	광진구	297332	183412	182988	424	113920	14052	문국현	창조한국당
서울특별시	1100	동대문구	304410	190407	189801	606	114003	12660	문국현	창조한국당
서울특별시	1100	중랑구	337898	204119	203489	630	133779	13083	문국현	창조한국당
서울특별시	1100	성북구	373761	235180	234542	638	138581	17007	문국현	창조한국당
서울특별시	1100	강북구	277954	168236	167702	534	109718	10913	문국현	창조한국당
서울특별시	1100	도봉구	293138	188015	187475	540	105123	13355	문국현	창조한국당
서울특별시	1100	노원구	466884	306503	305585	918	160381	22951	문국현	창조한국당
서울특별시	1100	은평구	362685	218004	217241	763	144681	15139	문국현	창조한국당
서울특별시	1100	서대문구	278848	174263	173769	494	104585	12833	문국현	창조한국당
서울특별시	1100	마포구	315333	194947	194415	532	120386	16037	문국현	창조한국당
서울특별시	1100	양천구	378841	241697	241065	632	137144	16751	문국현	창조한국당
서울특별시	1100	강서구	436622	272240	271059	1181	164382	20464	문국현	창조한국당
서울특별시	1100	구로구	333323	211497	210897	600	121826	16083	문국현	창조한국당
서울특별시	1100	금천구	196513	118869	118454	415	77644	7597	문국현	창조한국당
서울특별시	1100	영등포구	325884	206002	205371	631	119882	14819	문국현	창조한국당
서울특별시	1100	동작구	326851	209902	209350	552	116949	16943	문국현	창조한국당
서울특별시	1100	관악구	439707	268101	267400	701	171606	23536	문국현	창조한국당
서울특별시	1100	서초구	320018	212282	211836	446	107736	13223	문국현	창조한국당
서울특별시	1100	강남구	442286	283231	282618	613	159055	16465	문국현	창조한국당
서울특별시	1100	송파구	483567	313620	312799	821	169947	20642	문국현	창조한국당
서울특별시	1100	강동구	362024	231077	230456	621	130947	15308	문국현	창조한국당
서울특별시	1100	종로구	133946	85480	85157	323	48466	56	정근모	참주인연합
서울특별시	1100	중구	106837	66496	66285	211	40341	33	정근모	참주인연합
서울특별시	1100	용산구	190910	117051	116704	347	73859	78	정근모	참주인연합
서울특별시	1100	성동구	266124	165391	164911	480	100733	100	정근모	참주인연합
서울특별시	1100	광진구	297332	183412	182988	424	113920	106	정근모	참주인연합
서울특별시	1100	동대문구	304410	190407	189801	606	114003	79	정근모	참주인연합
서울특별시	1100	중랑구	337898	204119	203489	630	133779	89	정근모	참주인연합
서울특별시	1100	성북구	373761	235180	234542	638	138581	147	정근모	참주인연합
서울특별시	1100	강북구	277954	168236	167702	534	109718	91	정근모	참주인연합
서울특별시	1100	도봉구	293138	188015	187475	540	105123	88	정근모	참주인연합
서울특별시	1100	노원구	466884	306503	305585	918	160381	207	정근모	참주인연합
서울특별시	1100	은평구	362685	218004	217241	763	144681	127	정근모	참주인연합
서울특별시	1100	서대문구	278848	174263	173769	494	104585	118	정근모	참주인연합
서울특별시	1100	마포구	315333	194947	194415	532	120386	120	정근모	참주인연합
서울특별시	1100	양천구	378841	241697	241065	632	137144	156	정근모	참주인연합
서울특별시	1100	강서구	436622	272240	271059	1181	164382	189	정근모	참주인연합
서울특별시	1100	구로구	333323	211497	210897	600	121826	110	정근모	참주인연합
서울특별시	1100	금천구	196513	118869	118454	415	77644	64	정근모	참주인연합
서울특별시	1100	영등포구	325884	206002	205371	631	119882	124	정근모	참주인연합
서울특별시	1100	동작구	326851	209902	209350	552	116949	144	정근모	참주인연합
서울특별시	1100	관악구	439707	268101	267400	701	171606	167	정근모	참주인연합
서울특별시	1100	서초구	320018	212282	211836	446	107736	133	정근모	참주인연합
서울특별시	1100	강남구	442286	283231	282618	613	159055	177	정근모	참주인연합
서울특별시	1100	송파구	483567	313620	312799	821	169947	162	정근모	참주인연합
서울특별시	1100	강동구	362024	231077	230456	621	130947	148	정근모	참주인연합
서울특별시	1100	종로구	133946	85480	85157	323	48466	331	허경영	경제공화당
서울특별시	1100	중구	106837	66496	66285	211	40341	240	허경영	경제공화당
서울특별시	1100	용산구	190910	117051	116704	347	73859	486	허경영	경제공화당
서울특별시	1100	성동구	266124	165391	164911	480	100733	727	허경영	경제공화당
서울특별시	1100	광진구	297332	183412	182988	424	113920	943	허경영	경제공화당
서울특별시	1100	동대문구	304410	190407	189801	606	114003	826	허경영	경제공화당
서울특별시	1100	중랑구	337898	204119	203489	630	133779	1066	허경영	경제공화당
서울특별시	1100	성북구	373761	235180	234542	638	138581	958	허경영	경제공화당
서울특별시	1100	강북구	277954	168236	167702	534	109718	770	허경영	경제공화당
서울특별시	1100	도봉구	293138	188015	187475	540	105123	795	허경영	경제공화당
서울특별시	1100	노원구	466884	306503	305585	918	160381	1274	허경영	경제공화당
서울특별시	1100	은평구	362685	218004	217241	763	144681	1020	허경영	경제공화당
서울특별시	1100	서대문구	278848	174263	173769	494	104585	752	허경영	경제공화당
서울특별시	1100	마포구	315333	194947	194415	532	120386	889	허경영	경제공화당
서울특별시	1100	양천구	378841	241697	241065	632	137144	1011	허경영	경제공화당
서울특별시	1100	강서구	436622	272240	271059	1181	164382	1440	허경영	경제공화당
서울특별시	1100	구로구	333323	211497	210897	600	121826	1021	허경영	경제공화당
서울특별시	1100	금천구	196513	118869	118454	415	77644	545	허경영	경제공화당
서울특별시	1100	영등포구	325884	206002	205371	631	119882	873	허경영	경제공화당
서울특별시	1100	동작구	326851	209902	209350	552	116949	980	허경영	경제공화당
서울특별시	1100	관악구	439707	268101	267400	701	171606	1321	허경영	경제공화당
서울특별시	1100	서초구	320018	212282	211836	446	107736	700	허경영	경제공화당
서울특별시	1100	강남구	442286	283231	282618	613	159055	989	허경영	경제공화당
서울특별시	1100	송파구	483567	313620	312799	821	169947	1344	허경영	경제공화당
서울특별시	1100	강동구	362024	231077	230456	621	130947	1104	허경영	경제공화당
서울특별시	1100	종로구	133946	85480	85157	323	48466	13	전관	새시대참사람연합
서울특별시	1100	중구	106837	66496	66285	211	40341	9	전관	새시대참사람연합
서울특별시	1100	용산구	190910	117051	116704	347	73859	12	전관	새시대참사람연합
서울특별시	1100	성동구	266124	165391	164911	480	100733	38	전관	새시대참사람연합
서울특별시	1100	광진구	297332	183412	182988	424	113920	33	전관	새시대참사람연합
서울특별시	1100	동대문구	304410	190407	189801	606	114003	41	전관	새시대참사람연합
서울특별시	1100	중랑구	337898	204119	203489	630	133779	31	전관	새시대참사람연합
서울특별시	1100	성북구	373761	235180	234542	638	138581	30	전관	새시대참사람연합
서울특별시	1100	강북구	277954	168236	167702	534	109718	36	전관	새시대참사람연합
서울특별시	1100	도봉구	293138	188015	187475	540	105123	42	전관	새시대참사람연합
서울특별시	1100	노원구	466884	306503	305585	918	160381	77	전관	새시대참사람연합
서울특별시	1100	은평구	362685	218004	217241	763	144681	51	전관	새시대참사람연합
서울특별시	1100	서대문구	278848	174263	173769	494	104585	24	전관	새시대참사람연합
서울특별시	1100	마포구	315333	194947	194415	532	120386	35	전관	새시대참사람연합
서울특별시	1100	양천구	378841	241697	241065	632	137144	46	전관	새시대참사람연합
서울특별시	1100	강서구	436622	272240	271059	1181	164382	51	전관	새시대참사람연합
서울특별시	1100	구로구	333323	211497	210897	600	121826	31	전관	새시대참사람연합
서울특별시	1100	금천구	196513	118869	118454	415	77644	28	전관	새시대참사람연합
서울특별시	1100	영등포구	325884	206002	205371	631	119882	44	전관	새시대참사람연합
서울특별시	1100	동작구	326851	209902	209350	552	116949	49	전관	새시대참사람연합
서울특별시	1100	관악구	439707	268101	267400	701	171606	56	전관	새시대참사람연합
서울특별시	1100	서초구	320018	212282	211836	446	107736	15	전관	새시대참사람연합
서울특별시	1100	강남구	442286	283231	282618	613	159055	23	전관	새시대참사람연합
서울특별시	1100	송파구	483567	313620	312799	821	169947	53	전관	새시대참사람연합
서울특별시	1100	강동구	362024	231077	230456	621	130947	43	전관	새시대참사람연합
서울특별시	1100	종로구	133946	85480	85157	323	48466	77	금민	한국사회당
서울특별시	1100	중구	106837	66496	66285	211	40341	52	금민	한국사회당
서울특별시	1100	용산구	190910	117051	116704	347	73859	77	금민	한국사회당
서울특별시	1100	성동구	266124	165391	164911	480	100733	118	금민	한국사회당
서울특별시	1100	광진구	297332	183412	182988	424	113920	114	금민	한국사회당
서울특별시	1100	동대문구	304410	190407	189801	606	114003	138	금민	한국사회당
서울특별시	1100	중랑구	337898	204119	203489	630	133779	150	금민	한국사회당
서울특별시	1100	성북구	373761	235180	234542	638	138581	193	금민	한국사회당
서울특별시	1100	강북구	277954	168236	167702	534	109718	121	금민	한국사회당
서울특별시	1100	도봉구	293138	188015	187475	540	105123	101	금민	한국사회당
서울특별시	1100	노원구	466884	306503	305585	918	160381	213	금민	한국사회당
서울특별시	1100	은평구	362685	218004	217241	763	144681	183	금민	한국사회당
서울특별시	1100	서대문구	278848	174263	173769	494	104585	135	금민	한국사회당
서울특별시	1100	마포구	315333	194947	194415	532	120386	218	금민	한국사회당
서울특별시	1100	양천구	378841	241697	241065	632	137144	137	금민	한국사회당
서울특별시	1100	강서구	436622	272240	271059	1181	164382	169	금민	한국사회당
서울특별시	1100	구로구	333323	211497	210897	600	121826	143	금민	한국사회당
서울특별시	1100	금천구	196513	118869	118454	415	77644	90	금민	한국사회당
서울특별시	1100	영등포구	325884	206002	205371	631	119882	138	금민	한국사회당
서울특별시	1100	동작구	326851	209902	209350	552	116949	145	금민	한국사회당
서울특별시	1100	관악구	439707	268101	267400	701	171606	247	금민	한국사회당
서울특별시	1100	서초구	320018	212282	211836	446	107736	124	금민	한국사회당
서울특별시	1100	강남구	442286	283231	282618	613	159055	142	금민	한국사회당
서울특별시	1100	송파구	483567	313620	312799	821	169947	162	금민	한국사회당
서울특별시	1100	강동구	362024	231077	230456	621	130947	114	금민	한국사회당
서울특별시	1100	종로구	133946	85480	85157	323	48466	9984	이회창	무소속
서울특별시	1100	중구	106837	66496	66285	211	40341	7278	이회창	무소속
서울특별시	1100	용산구	190910	117051	116704	347	73859	13554	이회창	무소속
서울특별시	1100	성동구	266124	165391	164911	480	100733	17389	이회창	무소속
서울특별시	1100	광진구	297332	183412	182988	424	113920	21275	이회창	무소속
서울특별시	1100	동대문구	304410	190407	189801	606	114003	20931	이회창	무소속
서울특별시	1100	중랑구	337898	204119	203489	630	133779	23503	이회창	무소속
서울특별시	1100	성북구	373761	235180	234542	638	138581	25572	이회창	무소속
서울특별시	1100	강북구	277954	168236	167702	534	109718	17373	이회창	무소속
서울특별시	1100	도봉구	293138	188015	187475	540	105123	21578	이회창	무소속
서울특별시	1100	노원구	466884	306503	305585	918	160381	37607	이회창	무소속
서울특별시	1100	은평구	362685	218004	217241	763	144681	26376	이회창	무소속
서울특별시	1100	서대문구	278848	174263	173769	494	104585	20548	이회창	무소속
서울특별시	1100	마포구	315333	194947	194415	532	120386	23936	이회창	무소속
서울특별시	1100	양천구	378841	241697	241065	632	137144	29211	이회창	무소속
서울특별시	1100	강서구	436622	272240	271059	1181	164382	33701	이회창	무소속
서울특별시	1100	구로구	333323	211497	210897	600	121826	28102	이회창	무소속
서울특별시	1100	금천구	196513	118869	118454	415	77644	15140	이회창	무소속
서울특별시	1100	영등포구	325884	206002	205371	631	119882	26129	이회창	무소속
서울특별시	1100	동작구	326851	209902	209350	552	116949	25411	이회창	무소속
서울특별시	1100	관악구	439707	268101	267400	701	171606	32942	이회창	무소속
서울특별시	1100	서초구	320018	212282	211836	446	107736	23535	이회창	무소속
서울특별시	1100	강남구	442286	283231	282618	613	159055	31023	이회창	무소속
서울특별시	1100	송파구	483567	313620	312799	821	169947	36436	이회창	무소속
서울특별시	1100	강동구	362024	231077	230456	621	130947	27692	이회창	무소속
부산광역시	2600	중구	42111	25584	25464	120	16527	3226	정동영	대통합민주신당
부산광역시	2600	서구	109489	65288	65010	278	44201	8314	정동영	대통합민주신당
부산광역시	2600	동구	87511	54017	53798	219	33494	6780	정동영	대통합민주신당
부산광역시	2600	영도구	127967	75664	75326	338	52303	13008	정동영	대통합민주신당
부산광역시	2600	부산진구	324855	200613	199973	640	124242	26287	정동영	대통합민주신당
부산광역시	2600	동래구	225283	144883	144475	408	80400	16957	정동영	대통합민주신당
부산광역시	2600	남구	237462	148749	148321	428	88713	19494	정동영	대통합민주신당
부산광역시	2600	북구	247521	154739	154195	544	92782	22441	정동영	대통합민주신당
부산광역시	2600	해운대구	322575	202750	202202	548	119825	26921	정동영	대통합민주신당
부산광역시	2600	기장군	62272	38759	38575	184	23513	4951	정동영	대통합민주신당
부산광역시	2600	사하구	283276	171149	170518	631	112127	24215	정동영	대통합민주신당
부산광역시	2600	금정구	206527	131508	131092	416	75019	15925	정동영	대통합민주신당
부산광역시	2600	강서구	43825	25623	25435	188	18202	3700	정동영	대통합민주신당
부산광역시	2600	연제구	169739	108433	108080	353	61306	13445	정동영	대통합민주신당
부산광역시	2600	수영구	144300	91170	90948	222	53130	10807	정동영	대통합민주신당
부산광역시	2600	사상구	208350	126302	125840	462	82048	20237	정동영	대통합민주신당
부산광역시	2600	중구	42111	25584	25464	120	16527	15672	이명박	한나라당
부산광역시	2600	서구	109489	65288	65010	278	44201	39620	이명박	한나라당
부산광역시	2600	동구	87511	54017	53798	219	33494	31708	이명박	한나라당
부산광역시	2600	영도구	127967	75664	75326	338	52303	41811	이명박	한나라당
부산광역시	2600	부산진구	324855	200613	199973	640	124242	115334	이명박	한나라당
부산광역시	2600	동래구	225283	144883	144475	408	80400	86308	이명박	한나라당
부산광역시	2600	남구	237462	148749	148321	428	88713	86574	이명박	한나라당
부산광역시	2600	북구	247521	154739	154195	544	92782	84137	이명박	한나라당
부산광역시	2600	해운대구	322575	202750	202202	548	119825	118502	이명박	한나라당
부산광역시	2600	기장군	62272	38759	38575	184	23513	22799	이명박	한나라당
부산광역시	2600	사하구	283276	171149	170518	631	112127	98782	이명박	한나라당
부산광역시	2600	금정구	206527	131508	131092	416	75019	77336	이명박	한나라당
부산광역시	2600	강서구	43825	25623	25435	188	18202	14549	이명박	한나라당
부산광역시	2600	연제구	169739	108433	108080	353	61306	63080	이명박	한나라당
부산광역시	2600	수영구	144300	91170	90948	222	53130	54832	이명박	한나라당
부산광역시	2600	사상구	208350	126302	125840	462	82048	67671	이명박	한나라당
부산광역시	2600	중구	42111	25584	25464	120	16527	516	권영길	민주노동당
부산광역시	2600	서구	109489	65288	65010	278	44201	1566	권영길	민주노동당
부산광역시	2600	동구	87511	54017	53798	219	33494	1384	권영길	민주노동당
부산광역시	2600	영도구	127967	75664	75326	338	52303	2481	권영길	민주노동당
부산광역시	2600	부산진구	324855	200613	199973	640	124242	5511	권영길	민주노동당
부산광역시	2600	동래구	225283	144883	144475	408	80400	3669	권영길	민주노동당
부산광역시	2600	남구	237462	148749	148321	428	88713	4181	권영길	민주노동당
부산광역시	2600	북구	247521	154739	154195	544	92782	4895	권영길	민주노동당
부산광역시	2600	해운대구	322575	202750	202202	548	119825	5531	권영길	민주노동당
부산광역시	2600	기장군	62272	38759	38575	184	23513	1311	권영길	민주노동당
부산광역시	2600	사하구	283276	171149	170518	631	112127	4806	권영길	민주노동당
부산광역시	2600	금정구	206527	131508	131092	416	75019	3704	권영길	민주노동당
부산광역시	2600	강서구	43825	25623	25435	188	18202	722	권영길	민주노동당
부산광역시	2600	연제구	169739	108433	108080	353	61306	2905	권영길	민주노동당
부산광역시	2600	수영구	144300	91170	90948	222	53130	2069	권영길	민주노동당
부산광역시	2600	사상구	208350	126302	125840	462	82048	3650	권영길	민주노동당
부산광역시	2600	중구	42111	25584	25464	120	16527	65	이인제	민주당
부산광역시	2600	서구	109489	65288	65010	278	44201	169	이인제	민주당
부산광역시	2600	동구	87511	54017	53798	219	33494	150	이인제	민주당
부산광역시	2600	영도구	127967	75664	75326	338	52303	221	이인제	민주당
부산광역시	2600	부산진구	324855	200613	199973	640	124242	558	이인제	민주당
부산광역시	2600	동래구	225283	144883	144475	408	80400	313	이인제	민주당
부산광역시	2600	남구	237462	148749	148321	428	88713	367	이인제	민주당
부산광역시	2600	북구	247521	154739	154195	544	92782	433	이인제	민주당
부산광역시	2600	해운대구	322575	202750	202202	548	119825	441	이인제	민주당
부산광역시	2600	기장군	62272	38759	38575	184	23513	99	이인제	민주당
부산광역시	2600	사하구	283276	171149	170518	631	112127	446	이인제	민주당
부산광역시	2600	금정구	206527	131508	131092	416	75019	329	이인제	민주당
부산광역시	2600	강서구	43825	25623	25435	188	18202	99	이인제	민주당
부산광역시	2600	연제구	169739	108433	108080	353	61306	244	이인제	민주당
부산광역시	2600	수영구	144300	91170	90948	222	53130	206	이인제	민주당
부산광역시	2600	사상구	208350	126302	125840	462	82048	459	이인제	민주당
부산광역시	2600	중구	42111	25584	25464	120	16527	1208	문국현	창조한국당
부산광역시	2600	서구	109489	65288	65010	278	44201	3025	문국현	창조한국당
부산광역시	2600	동구	87511	54017	53798	219	33494	2402	문국현	창조한국당
부산광역시	2600	영도구	127967	75664	75326	338	52303	3613	문국현	창조한국당
부산광역시	2600	부산진구	324855	200613	199973	640	124242	10608	문국현	창조한국당
부산광역시	2600	동래구	225283	144883	144475	408	80400	7919	문국현	창조한국당
부산광역시	2600	남구	237462	148749	148321	428	88713	7962	문국현	창조한국당
부산광역시	2600	북구	247521	154739	154195	544	92782	8836	문국현	창조한국당
부산광역시	2600	해운대구	322575	202750	202202	548	119825	11234	문국현	창조한국당
부산광역시	2600	기장군	62272	38759	38575	184	23513	1684	문국현	창조한국당
부산광역시	2600	사하구	283276	171149	170518	631	112127	9619	문국현	창조한국당
부산광역시	2600	금정구	206527	131508	131092	416	75019	7393	문국현	창조한국당
부산광역시	2600	강서구	43825	25623	25435	188	18202	994	문국현	창조한국당
부산광역시	2600	연제구	169739	108433	108080	353	61306	6072	문국현	창조한국당
부산광역시	2600	수영구	144300	91170	90948	222	53130	4961	문국현	창조한국당
부산광역시	2600	사상구	208350	126302	125840	462	82048	6755	문국현	창조한국당
부산광역시	2600	중구	42111	25584	25464	120	16527	9	정근모	참주인연합
부산광역시	2600	서구	109489	65288	65010	278	44201	31	정근모	참주인연합
부산광역시	2600	동구	87511	54017	53798	219	33494	21	정근모	참주인연합
부산광역시	2600	영도구	127967	75664	75326	338	52303	40	정근모	참주인연합
부산광역시	2600	부산진구	324855	200613	199973	640	124242	81	정근모	참주인연합
부산광역시	2600	동래구	225283	144883	144475	408	80400	53	정근모	참주인연합
부산광역시	2600	남구	237462	148749	148321	428	88713	50	정근모	참주인연합
부산광역시	2600	북구	247521	154739	154195	544	92782	81	정근모	참주인연합
부산광역시	2600	해운대구	322575	202750	202202	548	119825	106	정근모	참주인연합
부산광역시	2600	기장군	62272	38759	38575	184	23513	25	정근모	참주인연합
부산광역시	2600	사하구	283276	171149	170518	631	112127	63	정근모	참주인연합
부산광역시	2600	금정구	206527	131508	131092	416	75019	63	정근모	참주인연합
부산광역시	2600	강서구	43825	25623	25435	188	18202	20	정근모	참주인연합
부산광역시	2600	연제구	169739	108433	108080	353	61306	37	정근모	참주인연합
부산광역시	2600	수영구	144300	91170	90948	222	53130	32	정근모	참주인연합
부산광역시	2600	사상구	208350	126302	125840	462	82048	58	정근모	참주인연합
부산광역시	2600	중구	42111	25584	25464	120	16527	89	허경영	경제공화당
부산광역시	2600	서구	109489	65288	65010	278	44201	251	허경영	경제공화당
부산광역시	2600	동구	87511	54017	53798	219	33494	242	허경영	경제공화당
부산광역시	2600	영도구	127967	75664	75326	338	52303	284	허경영	경제공화당
부산광역시	2600	부산진구	324855	200613	199973	640	124242	834	허경영	경제공화당
부산광역시	2600	동래구	225283	144883	144475	408	80400	630	허경영	경제공화당
부산광역시	2600	남구	237462	148749	148321	428	88713	576	허경영	경제공화당
부산광역시	2600	북구	247521	154739	154195	544	92782	709	허경영	경제공화당
부산광역시	2600	해운대구	322575	202750	202202	548	119825	747	허경영	경제공화당
부산광역시	2600	기장군	62272	38759	38575	184	23513	165	허경영	경제공화당
부산광역시	2600	사하구	283276	171149	170518	631	112127	699	허경영	경제공화당
부산광역시	2600	금정구	206527	131508	131092	416	75019	585	허경영	경제공화당
부산광역시	2600	강서구	43825	25623	25435	188	18202	95	허경영	경제공화당
부산광역시	2600	연제구	169739	108433	108080	353	61306	504	허경영	경제공화당
부산광역시	2600	수영구	144300	91170	90948	222	53130	395	허경영	경제공화당
부산광역시	2600	사상구	208350	126302	125840	462	82048	546	허경영	경제공화당
부산광역시	2600	중구	42111	25584	25464	120	16527	6	전관	새시대참사람연합
부산광역시	2600	서구	109489	65288	65010	278	44201	19	전관	새시대참사람연합
부산광역시	2600	동구	87511	54017	53798	219	33494	11	전관	새시대참사람연합
부산광역시	2600	영도구	127967	75664	75326	338	52303	23	전관	새시대참사람연합
부산광역시	2600	부산진구	324855	200613	199973	640	124242	40	전관	새시대참사람연합
부산광역시	2600	동래구	225283	144883	144475	408	80400	23	전관	새시대참사람연합
부산광역시	2600	남구	237462	148749	148321	428	88713	34	전관	새시대참사람연합
부산광역시	2600	북구	247521	154739	154195	544	92782	36	전관	새시대참사람연합
부산광역시	2600	해운대구	322575	202750	202202	548	119825	44	전관	새시대참사람연합
부산광역시	2600	기장군	62272	38759	38575	184	23513	12	전관	새시대참사람연합
부산광역시	2600	사하구	283276	171149	170518	631	112127	43	전관	새시대참사람연합
부산광역시	2600	금정구	206527	131508	131092	416	75019	35	전관	새시대참사람연합
부산광역시	2600	강서구	43825	25623	25435	188	18202	5	전관	새시대참사람연합
부산광역시	2600	연제구	169739	108433	108080	353	61306	21	전관	새시대참사람연합
부산광역시	2600	수영구	144300	91170	90948	222	53130	18	전관	새시대참사람연합
부산광역시	2600	사상구	208350	126302	125840	462	82048	36	전관	새시대참사람연합
부산광역시	2600	중구	42111	25584	25464	120	16527	15	금민	한국사회당
부산광역시	2600	서구	109489	65288	65010	278	44201	48	금민	한국사회당
부산광역시	2600	동구	87511	54017	53798	219	33494	33	금민	한국사회당
부산광역시	2600	영도구	127967	75664	75326	338	52303	38	금민	한국사회당
부산광역시	2600	부산진구	324855	200613	199973	640	124242	133	금민	한국사회당
부산광역시	2600	동래구	225283	144883	144475	408	80400	123	금민	한국사회당
부산광역시	2600	남구	237462	148749	148321	428	88713	89	금민	한국사회당
부산광역시	2600	북구	247521	154739	154195	544	92782	116	금민	한국사회당
부산광역시	2600	해운대구	322575	202750	202202	548	119825	125	금민	한국사회당
부산광역시	2600	기장군	62272	38759	38575	184	23513	16	금민	한국사회당
부산광역시	2600	사하구	283276	171149	170518	631	112127	122	금민	한국사회당
부산광역시	2600	금정구	206527	131508	131092	416	75019	91	금민	한국사회당
부산광역시	2600	강서구	43825	25623	25435	188	18202	14	금민	한국사회당
부산광역시	2600	연제구	169739	108433	108080	353	61306	84	금민	한국사회당
부산광역시	2600	수영구	144300	91170	90948	222	53130	54	금민	한국사회당
부산광역시	2600	사상구	208350	126302	125840	462	82048	97	금민	한국사회당
부산광역시	2600	중구	42111	25584	25464	120	16527	4658	이회창	무소속
부산광역시	2600	서구	109489	65288	65010	278	44201	11967	이회창	무소속
부산광역시	2600	동구	87511	54017	53798	219	33494	11067	이회창	무소속
부산광역시	2600	영도구	127967	75664	75326	338	52303	13807	이회창	무소속
부산광역시	2600	부산진구	324855	200613	199973	640	124242	40587	이회창	무소속
부산광역시	2600	동래구	225283	144883	144475	408	80400	28480	이회창	무소속
부산광역시	2600	남구	237462	148749	148321	428	88713	28994	이회창	무소속
부산광역시	2600	북구	247521	154739	154195	544	92782	32511	이회창	무소속
부산광역시	2600	해운대구	322575	202750	202202	548	119825	38551	이회창	무소속
부산광역시	2600	기장군	62272	38759	38575	184	23513	7513	이회창	무소속
부산광역시	2600	사하구	283276	171149	170518	631	112127	31723	이회창	무소속
부산광역시	2600	금정구	206527	131508	131092	416	75019	25631	이회창	무소속
부산광역시	2600	강서구	43825	25623	25435	188	18202	5237	이회창	무소속
부산광역시	2600	연제구	169739	108433	108080	353	61306	21688	이회창	무소속
부산광역시	2600	수영구	144300	91170	90948	222	53130	17574	이회창	무소속
부산광역시	2600	사상구	208350	126302	125840	462	82048	26331	이회창	무소속
대구광역시	2700	중구	66234	43459	43302	157	22775	2502	정동영	대통합민주신당
대구광역시	2700	동구	265762	176279	175576	703	89483	11357	정동영	대통합민주신당
대구광역시	2700	서구	190185	120295	119804	491	69890	6600	정동영	대통합민주신당
대구광역시	2700	남구	146210	92611	92260	351	53599	5457	정동영	대통합민주신당
대구광역시	2700	북구	341870	229360	228635	725	112510	14386	정동영	대통합민주신당
대구광역시	2700	수성구	330137	230474	229920	554	99663	12665	정동영	대통합민주신당
대구광역시	2700	달서구	437650	296170	295341	829	141480	17634	정동영	대통합민주신당
대구광역시	2700	달성군	118818	79321	78840	481	39497	5331	정동영	대통합민주신당
대구광역시	2700	중구	66234	43459	43302	157	22775	30882	이명박	한나라당
대구광역시	2700	동구	265762	176279	175576	703	89483	120170	이명박	한나라당
대구광역시	2700	서구	190185	120295	119804	491	69890	83998	이명박	한나라당
대구광역시	2700	남구	146210	92611	92260	351	53599	63764	이명박	한나라당
대구광역시	2700	북구	341870	229360	228635	725	112510	156772	이명박	한나라당
대구광역시	2700	수성구	330137	230474	229920	554	99663	164557	이명박	한나라당
대구광역시	2700	달서구	437650	296170	295341	829	141480	203226	이명박	한나라당
대구광역시	2700	달성군	118818	79321	78840	481	39497	53350	이명박	한나라당
대구광역시	2700	중구	66234	43459	43302	157	22775	706	권영길	민주노동당
대구광역시	2700	동구	265762	176279	175576	703	89483	3560	권영길	민주노동당
대구광역시	2700	서구	190185	120295	119804	491	69890	2087	권영길	민주노동당
대구광역시	2700	남구	146210	92611	92260	351	53599	1661	권영길	민주노동당
대구광역시	2700	북구	341870	229360	228635	725	112510	4868	권영길	민주노동당
대구광역시	2700	수성구	330137	230474	229920	554	99663	3851	권영길	민주노동당
대구광역시	2700	달서구	437650	296170	295341	829	141480	6227	권영길	민주노동당
대구광역시	2700	달성군	118818	79321	78840	481	39497	2817	권영길	민주노동당
대구광역시	2700	중구	66234	43459	43302	157	22775	57	이인제	민주당
대구광역시	2700	동구	265762	176279	175576	703	89483	299	이인제	민주당
대구광역시	2700	서구	190185	120295	119804	491	69890	188	이인제	민주당
대구광역시	2700	남구	146210	92611	92260	351	53599	138	이인제	민주당
대구광역시	2700	북구	341870	229360	228635	725	112510	330	이인제	민주당
대구광역시	2700	수성구	330137	230474	229920	554	99663	241	이인제	민주당
대구광역시	2700	달서구	437650	296170	295341	829	141480	413	이인제	민주당
대구광역시	2700	달성군	118818	79321	78840	481	39497	181	이인제	민주당
대구광역시	2700	중구	66234	43459	43302	157	22775	1525	문국현	창조한국당
대구광역시	2700	동구	265762	176279	175576	703	89483	7046	문국현	창조한국당
대구광역시	2700	서구	190185	120295	119804	491	69890	3907	문국현	창조한국당
대구광역시	2700	남구	146210	92611	92260	351	53599	3455	문국현	창조한국당
대구광역시	2700	북구	341870	229360	228635	725	112510	9990	문국현	창조한국당
대구광역시	2700	수성구	330137	230474	229920	554	99663	9423	문국현	창조한국당
대구광역시	2700	달서구	437650	296170	295341	829	141480	12318	문국현	창조한국당
대구광역시	2700	달성군	118818	79321	78840	481	39497	2850	문국현	창조한국당
대구광역시	2700	중구	66234	43459	43302	157	22775	22	정근모	참주인연합
대구광역시	2700	동구	265762	176279	175576	703	89483	70	정근모	참주인연합
대구광역시	2700	서구	190185	120295	119804	491	69890	31	정근모	참주인연합
대구광역시	2700	남구	146210	92611	92260	351	53599	24	정근모	참주인연합
대구광역시	2700	북구	341870	229360	228635	725	112510	46	정근모	참주인연합
대구광역시	2700	수성구	330137	230474	229920	554	99663	62	정근모	참주인연합
대구광역시	2700	달서구	437650	296170	295341	829	141480	83	정근모	참주인연합
대구광역시	2700	달성군	118818	79321	78840	481	39497	29	정근모	참주인연합
대구광역시	2700	중구	66234	43459	43302	157	22775	104	허경영	경제공화당
대구광역시	2700	동구	265762	176279	175576	703	89483	486	허경영	경제공화당
대구광역시	2700	서구	190185	120295	119804	491	69890	302	허경영	경제공화당
대구광역시	2700	남구	146210	92611	92260	351	53599	281	허경영	경제공화당
대구광역시	2700	북구	341870	229360	228635	725	112510	629	허경영	경제공화당
대구광역시	2700	수성구	330137	230474	229920	554	99663	562	허경영	경제공화당
대구광역시	2700	달서구	437650	296170	295341	829	141480	796	허경영	경제공화당
대구광역시	2700	달성군	118818	79321	78840	481	39497	215	허경영	경제공화당
대구광역시	2700	중구	66234	43459	43302	157	22775	4	전관	새시대참사람연합
대구광역시	2700	동구	265762	176279	175576	703	89483	38	전관	새시대참사람연합
대구광역시	2700	서구	190185	120295	119804	491	69890	26	전관	새시대참사람연합
대구광역시	2700	남구	146210	92611	92260	351	53599	14	전관	새시대참사람연합
대구광역시	2700	북구	341870	229360	228635	725	112510	31	전관	새시대참사람연합
대구광역시	2700	수성구	330137	230474	229920	554	99663	35	전관	새시대참사람연합
대구광역시	2700	달서구	437650	296170	295341	829	141480	48	전관	새시대참사람연합
대구광역시	2700	달성군	118818	79321	78840	481	39497	25	전관	새시대참사람연합
대구광역시	2700	중구	66234	43459	43302	157	22775	31	금민	한국사회당
대구광역시	2700	동구	265762	176279	175576	703	89483	102	금민	한국사회당
대구광역시	2700	서구	190185	120295	119804	491	69890	86	금민	한국사회당
대구광역시	2700	남구	146210	92611	92260	351	53599	71	금민	한국사회당
대구광역시	2700	북구	341870	229360	228635	725	112510	113	금민	한국사회당
대구광역시	2700	수성구	330137	230474	229920	554	99663	116	금민	한국사회당
대구광역시	2700	달서구	437650	296170	295341	829	141480	162	금민	한국사회당
대구광역시	2700	달성군	118818	79321	78840	481	39497	46	금민	한국사회당
대구광역시	2700	중구	66234	43459	43302	157	22775	7469	이회창	무소속
대구광역시	2700	동구	265762	176279	175576	703	89483	32448	이회창	무소속
대구광역시	2700	서구	190185	120295	119804	491	69890	22579	이회창	무소속
대구광역시	2700	남구	146210	92611	92260	351	53599	17395	이회창	무소속
대구광역시	2700	북구	341870	229360	228635	725	112510	41470	이회창	무소속
대구광역시	2700	수성구	330137	230474	229920	554	99663	38408	이회창	무소속
대구광역시	2700	달서구	437650	296170	295341	829	141480	54434	이회창	무소속
대구광역시	2700	달성군	118818	79321	78840	481	39497	13996	이회창	무소속
인천광역시	2800	중구	71324	41139	40930	209	30185	8755	정동영	대통합민주신당
인천광역시	2800	동구	59570	37098	36885	213	22472	8265	정동영	대통합민주신당
인천광역시	2800	남구	326395	190852	190106	746	135543	41666	정동영	대통합민주신당
인천광역시	2800	연수구	195285	125814	125435	379	69471	25170	정동영	대통합민주신당
인천광역시	2800	남동구	317999	192315	191595	720	125684	45763	정동영	대통합민주신당
인천광역시	2800	부평구	430072	258527	257544	983	171545	65803	정동영	대통합민주신당
인천광역시	2800	계양구	248876	147573	147038	535	101303	39757	정동영	대통합민주신당
인천광역시	2800	서구	286985	170454	169815	639	116531	43355	정동영	대통합민주신당
인천광역시	2800	강화군	55196	36766	36478	288	18430	6166	정동영	대통합민주신당
인천광역시	2800	옹진군	14172	9682	9531	151	4490	1865	정동영	대통합민주신당
인천광역시	2800	중구	71324	41139	40930	209	30185	21199	이명박	한나라당
인천광역시	2800	동구	59570	37098	36885	213	22472	17655	이명박	한나라당
인천광역시	2800	남구	326395	190852	190106	746	135543	95605	이명박	한나라당
인천광역시	2800	연수구	195285	125814	125435	379	69471	66280	이명박	한나라당
인천광역시	2800	남동구	317999	192315	191595	720	125684	93371	이명박	한나라당
인천광역시	2800	부평구	430072	258527	257544	983	171545	122367	이명박	한나라당
인천광역시	2800	계양구	248876	147573	147038	535	101303	67374	이명박	한나라당
인천광역시	2800	서구	286985	170454	169815	639	116531	81884	이명박	한나라당
인천광역시	2800	강화군	55196	36766	36478	288	18430	22075	이명박	한나라당
인천광역시	2800	옹진군	14172	9682	9531	151	4490	5473	이명박	한나라당
인천광역시	2800	중구	71324	41139	40930	209	30185	1381	권영길	민주노동당
인천광역시	2800	동구	59570	37098	36885	213	22472	1597	권영길	민주노동당
인천광역시	2800	남구	326395	190852	190106	746	135543	6032	권영길	민주노동당
인천광역시	2800	연수구	195285	125814	125435	379	69471	4230	권영길	민주노동당
인천광역시	2800	남동구	317999	192315	191595	720	125684	6486	권영길	민주노동당
인천광역시	2800	부평구	430072	258527	257544	983	171545	9702	권영길	민주노동당
인천광역시	2800	계양구	248876	147573	147038	535	101303	5112	권영길	민주노동당
인천광역시	2800	서구	286985	170454	169815	639	116531	6216	권영길	민주노동당
인천광역시	2800	강화군	55196	36766	36478	288	18430	1070	권영길	민주노동당
인천광역시	2800	옹진군	14172	9682	9531	151	4490	243	권영길	민주노동당
인천광역시	2800	중구	71324	41139	40930	209	30185	256	이인제	민주당
인천광역시	2800	동구	59570	37098	36885	213	22472	269	이인제	민주당
인천광역시	2800	남구	326395	190852	190106	746	135543	1174	이인제	민주당
인천광역시	2800	연수구	195285	125814	125435	379	69471	578	이인제	민주당
인천광역시	2800	남동구	317999	192315	191595	720	125684	1225	이인제	민주당
인천광역시	2800	부평구	430072	258527	257544	983	171545	1578	이인제	민주당
인천광역시	2800	계양구	248876	147573	147038	535	101303	897	이인제	민주당
인천광역시	2800	서구	286985	170454	169815	639	116531	1157	이인제	민주당
인천광역시	2800	강화군	55196	36766	36478	288	18430	388	이인제	민주당
인천광역시	2800	옹진군	14172	9682	9531	151	4490	90	이인제	민주당
인천광역시	2800	중구	71324	41139	40930	209	30185	2726	문국현	창조한국당
인천광역시	2800	동구	59570	37098	36885	213	22472	2497	문국현	창조한국당
인천광역시	2800	남구	326395	190852	190106	746	135543	13493	문국현	창조한국당
인천광역시	2800	연수구	195285	125814	125435	379	69471	9380	문국현	창조한국당
인천광역시	2800	남동구	317999	192315	191595	720	125684	13906	문국현	창조한국당
인천광역시	2800	부평구	430072	258527	257544	983	171545	18371	문국현	창조한국당
인천광역시	2800	계양구	248876	147573	147038	535	101303	10932	문국현	창조한국당
인천광역시	2800	서구	286985	170454	169815	639	116531	11638	문국현	창조한국당
인천광역시	2800	강화군	55196	36766	36478	288	18430	1488	문국현	창조한국당
인천광역시	2800	옹진군	14172	9682	9531	151	4490	383	문국현	창조한국당
인천광역시	2800	중구	71324	41139	40930	209	30185	33	정근모	참주인연합
인천광역시	2800	동구	59570	37098	36885	213	22472	28	정근모	참주인연합
인천광역시	2800	남구	326395	190852	190106	746	135543	96	정근모	참주인연합
인천광역시	2800	연수구	195285	125814	125435	379	69471	88	정근모	참주인연합
인천광역시	2800	남동구	317999	192315	191595	720	125684	128	정근모	참주인연합
인천광역시	2800	부평구	430072	258527	257544	983	171545	181	정근모	참주인연합
인천광역시	2800	계양구	248876	147573	147038	535	101303	98	정근모	참주인연합
인천광역시	2800	서구	286985	170454	169815	639	116531	96	정근모	참주인연합
인천광역시	2800	강화군	55196	36766	36478	288	18430	40	정근모	참주인연합
인천광역시	2800	옹진군	14172	9682	9531	151	4490	9	정근모	참주인연합
인천광역시	2800	중구	71324	41139	40930	209	30185	194	허경영	경제공화당
인천광역시	2800	동구	59570	37098	36885	213	22472	179	허경영	경제공화당
인천광역시	2800	남구	326395	190852	190106	746	135543	919	허경영	경제공화당
인천광역시	2800	연수구	195285	125814	125435	379	69471	512	허경영	경제공화당
인천광역시	2800	남동구	317999	192315	191595	720	125684	921	허경영	경제공화당
인천광역시	2800	부평구	430072	258527	257544	983	171545	1198	허경영	경제공화당
인천광역시	2800	계양구	248876	147573	147038	535	101303	739	허경영	경제공화당
인천광역시	2800	서구	286985	170454	169815	639	116531	807	허경영	경제공화당
인천광역시	2800	강화군	55196	36766	36478	288	18430	219	허경영	경제공화당
인천광역시	2800	옹진군	14172	9682	9531	151	4490	81	허경영	경제공화당
인천광역시	2800	중구	71324	41139	40930	209	30185	10	전관	새시대참사람연합
인천광역시	2800	동구	59570	37098	36885	213	22472	16	전관	새시대참사람연합
인천광역시	2800	남구	326395	190852	190106	746	135543	39	전관	새시대참사람연합
인천광역시	2800	연수구	195285	125814	125435	379	69471	23	전관	새시대참사람연합
인천광역시	2800	남동구	317999	192315	191595	720	125684	54	전관	새시대참사람연합
인천광역시	2800	부평구	430072	258527	257544	983	171545	64	전관	새시대참사람연합
인천광역시	2800	계양구	248876	147573	147038	535	101303	41	전관	새시대참사람연합
인천광역시	2800	서구	286985	170454	169815	639	116531	41	전관	새시대참사람연합
인천광역시	2800	강화군	55196	36766	36478	288	18430	26	전관	새시대참사람연합
인천광역시	2800	옹진군	14172	9682	9531	151	4490	9	전관	새시대참사람연합
인천광역시	2800	중구	71324	41139	40930	209	30185	29	금민	한국사회당
인천광역시	2800	동구	59570	37098	36885	213	22472	36	금민	한국사회당
인천광역시	2800	남구	326395	190852	190106	746	135543	176	금민	한국사회당
인천광역시	2800	연수구	195285	125814	125435	379	69471	93	금민	한국사회당
인천광역시	2800	남동구	317999	192315	191595	720	125684	179	금민	한국사회당
인천광역시	2800	부평구	430072	258527	257544	983	171545	208	금민	한국사회당
인천광역시	2800	계양구	248876	147573	147038	535	101303	146	금민	한국사회당
인천광역시	2800	서구	286985	170454	169815	639	116531	159	금민	한국사회당
인천광역시	2800	강화군	55196	36766	36478	288	18430	31	금민	한국사회당
인천광역시	2800	옹진군	14172	9682	9531	151	4490	11	금민	한국사회당
인천광역시	2800	중구	71324	41139	40930	209	30185	6347	이회창	무소속
인천광역시	2800	동구	59570	37098	36885	213	22472	6343	이회창	무소속
인천광역시	2800	남구	326395	190852	190106	746	135543	30906	이회창	무소속
인천광역시	2800	연수구	195285	125814	125435	379	69471	19081	이회창	무소속
인천광역시	2800	남동구	317999	192315	191595	720	125684	29562	이회창	무소속
인천광역시	2800	부평구	430072	258527	257544	983	171545	38072	이회창	무소속
인천광역시	2800	계양구	248876	147573	147038	535	101303	21942	이회창	무소속
인천광역시	2800	서구	286985	170454	169815	639	116531	24462	이회창	무소속
인천광역시	2800	강화군	55196	36766	36478	288	18430	4975	이회창	무소속
인천광역시	2800	옹진군	14172	9682	9531	151	4490	1367	이회창	무소속
광주광역시	2900	동구	90124	55737	55522	215	34387	43391	정동영	대통합민주신당
광주광역시	2900	서구	222662	144859	144505	354	77803	114717	정동영	대통합민주신당
광주광역시	2900	남구	158988	101716	101487	229	57272	80271	정동영	대통합민주신당
광주광역시	2900	북구	344625	220888	220333	555	123737	176435	정동영	대통합민주신당
광주광역시	2900	광산구	214934	140138	139705	433	74796	112774	정동영	대통합민주신당
광주광역시	2900	동구	90124	55737	55522	215	34387	5450	이명박	한나라당
광주광역시	2900	서구	222662	144859	144505	354	77803	13004	이명박	한나라당
광주광역시	2900	남구	158988	101716	101487	229	57272	9616	이명박	한나라당
광주광역시	2900	북구	344625	220888	220333	555	123737	18291	이명박	한나라당
광주광역시	2900	광산구	214934	140138	139705	433	74796	10514	이명박	한나라당
광주광역시	2900	동구	90124	55737	55522	215	34387	834	권영길	민주노동당
광주광역시	2900	서구	222662	144859	144505	354	77803	2882	권영길	민주노동당
광주광역시	2900	남구	158988	101716	101487	229	57272	1555	권영길	민주노동당
광주광역시	2900	북구	344625	220888	220333	555	123737	4149	권영길	민주노동당
광주광역시	2900	광산구	214934	140138	139705	433	74796	4177	권영길	민주노동당
광주광역시	2900	동구	90124	55737	55522	215	34387	839	이인제	민주당
광주광역시	2900	서구	222662	144859	144505	354	77803	1374	이인제	민주당
광주광역시	2900	남구	158988	101716	101487	229	57272	1318	이인제	민주당
광주광역시	2900	북구	344625	220888	220333	555	123737	2236	이인제	민주당
광주광역시	2900	광산구	214934	140138	139705	433	74796	1351	이인제	민주당
광주광역시	2900	동구	90124	55737	55522	215	34387	2596	문국현	창조한국당
광주광역시	2900	서구	222662	144859	144505	354	77803	7057	문국현	창조한국당
광주광역시	2900	남구	158988	101716	101487	229	57272	4779	문국현	창조한국당
광주광역시	2900	북구	344625	220888	220333	555	123737	10931	문국현	창조한국당
광주광역시	2900	광산구	214934	140138	139705	433	74796	6161	문국현	창조한국당
광주광역시	2900	동구	90124	55737	55522	215	34387	30	정근모	참주인연합
광주광역시	2900	서구	222662	144859	144505	354	77803	76	정근모	참주인연합
광주광역시	2900	남구	158988	101716	101487	229	57272	51	정근모	참주인연합
광주광역시	2900	북구	344625	220888	220333	555	123737	146	정근모	참주인연합
광주광역시	2900	광산구	214934	140138	139705	433	74796	95	정근모	참주인연합
광주광역시	2900	동구	90124	55737	55522	215	34387	142	허경영	경제공화당
광주광역시	2900	서구	222662	144859	144505	354	77803	329	허경영	경제공화당
광주광역시	2900	남구	158988	101716	101487	229	57272	235	허경영	경제공화당
광주광역시	2900	북구	344625	220888	220333	555	123737	512	허경영	경제공화당
광주광역시	2900	광산구	214934	140138	139705	433	74796	329	허경영	경제공화당
광주광역시	2900	동구	90124	55737	55522	215	34387	15	전관	새시대참사람연합
광주광역시	2900	서구	222662	144859	144505	354	77803	14	전관	새시대참사람연합
광주광역시	2900	남구	158988	101716	101487	229	57272	14	전관	새시대참사람연합
광주광역시	2900	북구	344625	220888	220333	555	123737	25	전관	새시대참사람연합
광주광역시	2900	광산구	214934	140138	139705	433	74796	28	전관	새시대참사람연합
광주광역시	2900	동구	90124	55737	55522	215	34387	19	금민	한국사회당
광주광역시	2900	서구	222662	144859	144505	354	77803	59	금민	한국사회당
광주광역시	2900	남구	158988	101716	101487	229	57272	39	금민	한국사회당
광주광역시	2900	북구	344625	220888	220333	555	123737	106	금민	한국사회당
광주광역시	2900	광산구	214934	140138	139705	433	74796	66	금민	한국사회당
광주광역시	2900	동구	90124	55737	55522	215	34387	2206	이회창	무소속
광주광역시	2900	서구	222662	144859	144505	354	77803	4993	이회창	무소속
광주광역시	2900	남구	158988	101716	101487	229	57272	3609	이회창	무소속
광주광역시	2900	북구	344625	220888	220333	555	123737	7502	이회창	무소속
광주광역시	2900	광산구	214934	140138	139705	433	74796	4210	이회창	무소속
대전광역시	3000	동구	191518	113405	112861	544	78113	29102	정동영	대통합민주신당
대전광역시	3000	중구	204994	126057	125644	413	78937	28964	정동영	대통합민주신당
대전광역시	3000	서구	368547	230752	230100	652	137795	51476	정동영	대통합민주신당
대전광역시	3000	유성구	176526	114086	113747	339	62440	26382	정동영	대통합민주신당
대전광역시	3000	대덕구	157392	95964	95596	368	61428	23776	정동영	대통합민주신당
대전광역시	3000	동구	191518	113405	112861	544	78113	37863	이명박	한나라당
대전광역시	3000	중구	204994	126057	125644	413	78937	46023	이명박	한나라당
대전광역시	3000	서구	368547	230752	230100	652	137795	86050	이명박	한나라당
대전광역시	3000	유성구	176526	114086	113747	339	62440	43017	이명박	한나라당
대전광역시	3000	대덕구	157392	95964	95596	368	61428	33055	이명박	한나라당
대전광역시	3000	동구	191518	113405	112861	544	78113	2853	권영길	민주노동당
대전광역시	3000	중구	204994	126057	125644	413	78937	2774	권영길	민주노동당
대전광역시	3000	서구	368547	230752	230100	652	137795	5088	권영길	민주노동당
대전광역시	3000	유성구	176526	114086	113747	339	62440	3264	권영길	민주노동당
대전광역시	3000	대덕구	157392	95964	95596	368	61428	3228	권영길	민주노동당
대전광역시	3000	동구	191518	113405	112861	544	78113	1464	이인제	민주당
대전광역시	3000	중구	204994	126057	125644	413	78937	1445	이인제	민주당
대전광역시	3000	서구	368547	230752	230100	652	137795	2309	이인제	민주당
대전광역시	3000	유성구	176526	114086	113747	339	62440	874	이인제	민주당
대전광역시	3000	대덕구	157392	95964	95596	368	61428	1131	이인제	민주당
대전광역시	3000	동구	191518	113405	112861	544	78113	6921	문국현	창조한국당
대전광역시	3000	중구	204994	126057	125644	413	78937	7841	문국현	창조한국당
대전광역시	3000	서구	368547	230752	230100	652	137795	16487	문국현	창조한국당
대전광역시	3000	유성구	176526	114086	113747	339	62440	10644	문국현	창조한국당
대전광역시	3000	대덕구	157392	95964	95596	368	61428	6250	문국현	창조한국당
대전광역시	3000	동구	191518	113405	112861	544	78113	88	정근모	참주인연합
대전광역시	3000	중구	204994	126057	125644	413	78937	81	정근모	참주인연합
대전광역시	3000	서구	368547	230752	230100	652	137795	132	정근모	참주인연합
대전광역시	3000	유성구	176526	114086	113747	339	62440	91	정근모	참주인연합
대전광역시	3000	대덕구	157392	95964	95596	368	61428	75	정근모	참주인연합
대전광역시	3000	동구	191518	113405	112861	544	78113	426	허경영	경제공화당
대전광역시	3000	중구	204994	126057	125644	413	78937	457	허경영	경제공화당
대전광역시	3000	서구	368547	230752	230100	652	137795	744	허경영	경제공화당
대전광역시	3000	유성구	176526	114086	113747	339	62440	372	허경영	경제공화당
대전광역시	3000	대덕구	157392	95964	95596	368	61428	357	허경영	경제공화당
대전광역시	3000	동구	191518	113405	112861	544	78113	44	전관	새시대참사람연합
대전광역시	3000	중구	204994	126057	125644	413	78937	34	전관	새시대참사람연합
대전광역시	3000	서구	368547	230752	230100	652	137795	57	전관	새시대참사람연합
대전광역시	3000	유성구	176526	114086	113747	339	62440	26	전관	새시대참사람연합
대전광역시	3000	대덕구	157392	95964	95596	368	61428	43	전관	새시대참사람연합
대전광역시	3000	동구	191518	113405	112861	544	78113	130	금민	한국사회당
대전광역시	3000	중구	204994	126057	125644	413	78937	110	금민	한국사회당
대전광역시	3000	서구	368547	230752	230100	652	137795	235	금민	한국사회당
대전광역시	3000	유성구	176526	114086	113747	339	62440	103	금민	한국사회당
대전광역시	3000	대덕구	157392	95964	95596	368	61428	105	금민	한국사회당
대전광역시	3000	동구	191518	113405	112861	544	78113	33970	이회창	무소속
대전광역시	3000	중구	204994	126057	125644	413	78937	37915	이회창	무소속
대전광역시	3000	서구	368547	230752	230100	652	137795	67522	이회창	무소속
대전광역시	3000	유성구	176526	114086	113747	339	62440	28974	이회창	무소속
대전광역시	3000	대덕구	157392	95964	95596	368	61428	27576	이회창	무소속
울산광역시	3100	중구	177386	112934	112429	505	64452	13670	정동영	대통합민주신당
울산광역시	3100	남구	252020	163310	162678	632	88710	19581	정동영	대통합민주신당
울산광역시	3100	동구	136997	87909	87512	397	49088	16129	정동영	대통합민주신당
울산광역시	3100	북구	106264	71100	70739	361	35164	10201	정동영	대통합민주신당
울산광역시	3100	울주군	133756	85963	85228	735	47793	11155	정동영	대통합민주신당
울산광역시	3100	중구	177386	112934	112429	505	64452	63101	이명박	한나라당
울산광역시	3100	남구	252020	163310	162678	632	88710	92717	이명박	한나라당
울산광역시	3100	동구	136997	87909	87512	397	49088	43337	이명박	한나라당
울산광역시	3100	북구	106264	71100	70739	361	35164	33363	이명박	한나라당
울산광역시	3100	울주군	133756	85963	85228	735	47793	47373	이명박	한나라당
울산광역시	3100	중구	177386	112934	112429	505	64452	8371	권영길	민주노동당
울산광역시	3100	남구	252020	163310	162678	632	88710	9549	권영길	민주노동당
울산광역시	3100	동구	136997	87909	87512	397	49088	9098	권영길	민주노동당
울산광역시	3100	북구	106264	71100	70739	361	35164	11797	권영길	민주노동당
울산광역시	3100	울주군	133756	85963	85228	735	47793	4792	권영길	민주노동당
울산광역시	3100	중구	177386	112934	112429	505	64452	414	이인제	민주당
울산광역시	3100	남구	252020	163310	162678	632	88710	459	이인제	민주당
울산광역시	3100	동구	136997	87909	87512	397	49088	399	이인제	민주당
울산광역시	3100	북구	106264	71100	70739	361	35164	239	이인제	민주당
울산광역시	3100	울주군	133756	85963	85228	735	47793	373	이인제	민주당
울산광역시	3100	중구	177386	112934	112429	505	64452	5849	문국현	창조한국당
울산광역시	3100	남구	252020	163310	162678	632	88710	9279	문국현	창조한국당
울산광역시	3100	동구	136997	87909	87512	397	49088	5344	문국현	창조한국당
울산광역시	3100	북구	106264	71100	70739	361	35164	3818	문국현	창조한국당
울산광역시	3100	울주군	133756	85963	85228	735	47793	4315	문국현	창조한국당
울산광역시	3100	중구	177386	112934	112429	505	64452	57	정근모	참주인연합
울산광역시	3100	남구	252020	163310	162678	632	88710	67	정근모	참주인연합
울산광역시	3100	동구	136997	87909	87512	397	49088	58	정근모	참주인연합
울산광역시	3100	북구	106264	71100	70739	361	35164	31	정근모	참주인연합
울산광역시	3100	울주군	133756	85963	85228	735	47793	58	정근모	참주인연합
울산광역시	3100	중구	177386	112934	112429	505	64452	426	허경영	경제공화당
울산광역시	3100	남구	252020	163310	162678	632	88710	630	허경영	경제공화당
울산광역시	3100	동구	136997	87909	87512	397	49088	408	허경영	경제공화당
울산광역시	3100	북구	106264	71100	70739	361	35164	270	허경영	경제공화당
울산광역시	3100	울주군	133756	85963	85228	735	47793	365	허경영	경제공화당
울산광역시	3100	중구	177386	112934	112429	505	64452	19	전관	새시대참사람연합
울산광역시	3100	남구	252020	163310	162678	632	88710	35	전관	새시대참사람연합
울산광역시	3100	동구	136997	87909	87512	397	49088	27	전관	새시대참사람연합
울산광역시	3100	북구	106264	71100	70739	361	35164	15	전관	새시대참사람연합
울산광역시	3100	울주군	133756	85963	85228	735	47793	25	전관	새시대참사람연합
울산광역시	3100	중구	177386	112934	112429	505	64452	95	금민	한국사회당
울산광역시	3100	남구	252020	163310	162678	632	88710	117	금민	한국사회당
울산광역시	3100	동구	136997	87909	87512	397	49088	91	금민	한국사회당
울산광역시	3100	북구	106264	71100	70739	361	35164	79	금민	한국사회당
울산광역시	3100	울주군	133756	85963	85228	735	47793	85	금민	한국사회당
울산광역시	3100	중구	177386	112934	112429	505	64452	20427	이회창	무소속
울산광역시	3100	남구	252020	163310	162678	632	88710	30244	이회창	무소속
울산광역시	3100	동구	136997	87909	87512	397	49088	12621	이회창	무소속
울산광역시	3100	북구	106264	71100	70739	361	35164	10926	이회창	무소속
울산광역시	3100	울주군	133756	85963	85228	735	47793	16687	이회창	무소속
경기도	4100	수원시장안구	210171	133783	133407	376	76388	30641	정동영	대통합민주신당
경기도	4100	수원시권선구	227968	135070	134626	444	92898	31545	정동영	대통합민주신당
경기도	4100	수원시팔달구	169529	97064	96690	374	72465	21255	정동영	대통합민주신당
경기도	4100	수원시영통구	175615	111290	111059	231	64325	23571	정동영	대통합민주신당
경기도	4100	성남시수정구	202875	113585	113142	443	89290	34521	정동영	대통합민주신당
경기도	4100	성남시중원구	205596	114597	114215	382	90999	34835	정동영	대통합민주신당
경기도	4100	성남시분당구	321923	218340	217842	498	103583	36746	정동영	대통합민주신당
경기도	4100	의정부시	314746	191670	191042	628	123076	46445	정동영	대통합민주신당
경기도	4100	안양시만안구	205444	127123	126574	549	78321	32071	정동영	대통합민주신당
경기도	4100	안양시동안구	261803	176837	176218	619	84966	40389	정동영	대통합민주신당
경기도	4100	부천시원미구	333326	202315	201769	546	131011	53939	정동영	대통합민주신당
경기도	4100	부천시소사구	174754	106639	106278	361	68115	28322	정동영	대통합민주신당
경기도	4100	부천시오정구	140783	79906	79587	319	60877	24222	정동영	대통합민주신당
경기도	4100	광명시	236416	149929	149494	435	86487	41736	정동영	대통합민주신당
경기도	4100	평택시	296098	176789	176037	752	119309	37120	정동영	대통합민주신당
경기도	4100	양주시	133824	79527	79138	389	54297	18409	정동영	대통합민주신당
경기도	4100	동두천시	67629	38221	38032	189	29408	8741	정동영	대통합민주신당
경기도	4100	안산시상록구	266293	153609	153066	543	112684	43183	정동영	대통합민주신당
경기도	4100	안산시단원구	238970	134675	134154	521	104295	38367	정동영	대통합민주신당
경기도	4100	고양시덕양구	283032	176306	175776	530	106726	43375	정동영	대통합민주신당
경기도	4100	고양시일산동구	184138	115854	115536	318	68284	25295	정동영	대통합민주신당
경기도	4100	고양시일산서구	204400	132601	132265	336	71799	29467	정동영	대통합민주신당
경기도	4100	과천시	45430	32075	31993	82	13355	6308	정동영	대통합민주신당
경기도	4100	의왕시	101448	66677	66464	213	34771	15670	정동영	대통합민주신당
경기도	4100	구리시	144987	91250	90994	256	53737	20746	정동영	대통합민주신당
경기도	4100	남양주시	361363	219433	218730	703	141930	50520	정동영	대통합민주신당
경기도	4100	오산시	103848	60027	59808	219	43821	14370	정동영	대통합민주신당
경기도	4100	화성시	265536	159514	158846	668	106022	34968	정동영	대통합민주신당
경기도	4100	시흥시	277333	157636	157120	516	119697	45012	정동영	대통합민주신당
경기도	4100	군포시	203559	133078	132707	371	70481	32262	정동영	대통합민주신당
경기도	4100	하남시	106527	65545	65324	221	40982	15325	정동영	대통합민주신당
경기도	4100	파주시	228024	138055	137399	656	89969	30084	정동영	대통합민주신당
경기도	4100	여주군	82266	49800	49436	364	32466	9214	정동영	대통합민주신당
경기도	4100	이천시	144497	83665	83144	521	60832	15257	정동영	대통합민주신당
경기도	4100	용인시처인구	151077	87778	87381	397	63299	20100	정동영	대통합민주신당
경기도	4100	용인시수지구	211290	140500	140202	298	70790	24687	정동영	대통합민주신당
경기도	4100	용인시기흥구	217439	140377	140032	345	77062	29436	정동영	대통합민주신당
경기도	4100	안성시	124360	73933	73489	444	50427	16282	정동영	대통합민주신당
경기도	4100	김포시	153236	96255	95859	396	56981	20342	정동영	대통합민주신당
경기도	4100	광주시	171826	104240	103850	390	67586	23821	정동영	대통합민주신당
경기도	4100	포천시	120695	71154	70689	465	49541	14971	정동영	대통합민주신당
경기도	4100	연천군	36588	23834	23623	211	12754	5441	정동영	대통합민주신당
경기도	4100	양평군	70828	45899	45534	365	24929	7463	정동영	대통합민주신당
경기도	4100	가평군	44634	29186	28836	350	15448	5462	정동영	대통합민주신당
경기도	4100	수원시장안구	210171	133783	133407	376	76388	64832	이명박	한나라당
경기도	4100	수원시권선구	227968	135070	134626	444	92898	65272	이명박	한나라당
경기도	4100	수원시팔달구	169529	97064	96690	374	72465	48972	이명박	한나라당
경기도	4100	수원시영통구	175615	111290	111059	231	64325	56136	이명박	한나라당
경기도	4100	성남시수정구	202875	113585	113142	443	89290	51580	이명박	한나라당
경기도	4100	성남시중원구	205596	114597	114215	382	90999	52703	이명박	한나라당
경기도	4100	성남시분당구	321923	218340	217842	498	103583	134060	이명박	한나라당
경기도	4100	의정부시	314746	191670	191042	628	123076	100542	이명박	한나라당
경기도	4100	안양시만안구	205444	127123	126574	549	78321	60840	이명박	한나라당
경기도	4100	안양시동안구	261803	176837	176218	619	84966	90423	이명박	한나라당
경기도	4100	부천시원미구	333326	202315	201769	546	131011	95829	이명박	한나라당
경기도	4100	부천시소사구	174754	106639	106278	361	68115	50341	이명박	한나라당
경기도	4100	부천시오정구	140783	79906	79587	319	60877	36051	이명박	한나라당
경기도	4100	광명시	236416	149929	149494	435	86487	69944	이명박	한나라당
경기도	4100	평택시	296098	176789	176037	752	119309	88319	이명박	한나라당
경기도	4100	양주시	133824	79527	79138	389	54297	43554	이명박	한나라당
경기도	4100	동두천시	67629	38221	38032	189	29408	21126	이명박	한나라당
경기도	4100	안산시상록구	266293	153609	153066	543	112684	70545	이명박	한나라당
경기도	4100	안산시단원구	238970	134675	134154	521	104295	61105	이명박	한나라당
경기도	4100	고양시덕양구	283032	176306	175776	530	106726	91510	이명박	한나라당
경기도	4100	고양시일산동구	184138	115854	115536	318	68284	63571	이명박	한나라당
경기도	4100	고양시일산서구	204400	132601	132265	336	71799	72844	이명박	한나라당
경기도	4100	과천시	45430	32075	31993	82	13355	18228	이명박	한나라당
경기도	4100	의왕시	101448	66677	66464	213	34771	33605	이명박	한나라당
경기도	4100	구리시	144987	91250	90994	256	53737	49370	이명박	한나라당
경기도	4100	남양주시	361363	219433	218730	703	141930	119873	이명박	한나라당
경기도	4100	오산시	103848	60027	59808	219	43821	28666	이명박	한나라당
경기도	4100	화성시	265536	159514	158846	668	106022	81713	이명박	한나라당
경기도	4100	시흥시	277333	157636	157120	516	119697	72523	이명박	한나라당
경기도	4100	군포시	203559	133078	132707	371	70481	63844	이명박	한나라당
경기도	4100	하남시	106527	65545	65324	221	40982	35272	이명박	한나라당
경기도	4100	파주시	228024	138055	137399	656	89969	76460	이명박	한나라당
경기도	4100	여주군	82266	49800	49436	364	32466	27822	이명박	한나라당
경기도	4100	이천시	144497	83665	83144	521	60832	47323	이명박	한나라당
경기도	4100	용인시처인구	151077	87778	87381	397	63299	46632	이명박	한나라당
경기도	4100	용인시수지구	211290	140500	140202	298	70790	85920	이명박	한나라당
경기도	4100	용인시기흥구	217439	140377	140032	345	77062	77906	이명박	한나라당
경기도	4100	안성시	124360	73933	73489	444	50427	36971	이명박	한나라당
경기도	4100	김포시	153236	96255	95859	396	56981	54078	이명박	한나라당
경기도	4100	광주시	171826	104240	103850	390	67586	58125	이명박	한나라당
경기도	4100	포천시	120695	71154	70689	465	49541	40396	이명박	한나라당
경기도	4100	연천군	36588	23834	23623	211	12754	13072	이명박	한나라당
경기도	4100	양평군	70828	45899	45534	365	24929	28550	이명박	한나라당
경기도	4100	가평군	44634	29186	28836	350	15448	16995	이명박	한나라당
경기도	4100	수원시장안구	210171	133783	133407	376	76388	4402	권영길	민주노동당
경기도	4100	수원시권선구	227968	135070	134626	444	92898	4140	권영길	민주노동당
경기도	4100	수원시팔달구	169529	97064	96690	374	72465	2592	권영길	민주노동당
경기도	4100	수원시영통구	175615	111290	111059	231	64325	2895	권영길	민주노동당
경기도	4100	성남시수정구	202875	113585	113142	443	89290	3392	권영길	민주노동당
경기도	4100	성남시중원구	205596	114597	114215	382	90999	3333	권영길	민주노동당
경기도	4100	성남시분당구	321923	218340	217842	498	103583	4080	권영길	민주노동당
경기도	4100	의정부시	314746	191670	191042	628	123076	5483	권영길	민주노동당
경기도	4100	안양시만안구	205444	127123	126574	549	78321	3503	권영길	민주노동당
경기도	4100	안양시동안구	261803	176837	176218	619	84966	4300	권영길	민주노동당
경기도	4100	부천시원미구	333326	202315	201769	546	131011	5636	권영길	민주노동당
경기도	4100	부천시소사구	174754	106639	106278	361	68115	3110	권영길	민주노동당
경기도	4100	부천시오정구	140783	79906	79587	319	60877	2150	권영길	민주노동당
경기도	4100	광명시	236416	149929	149494	435	86487	4888	권영길	민주노동당
경기도	4100	평택시	296098	176789	176037	752	119309	10314	권영길	민주노동당
경기도	4100	양주시	133824	79527	79138	389	54297	2088	권영길	민주노동당
경기도	4100	동두천시	67629	38221	38032	189	29408	968	권영길	민주노동당
경기도	4100	안산시상록구	266293	153609	153066	543	112684	4878	권영길	민주노동당
경기도	4100	안산시단원구	238970	134675	134154	521	104295	4516	권영길	민주노동당
경기도	4100	고양시덕양구	283032	176306	175776	530	106726	4759	권영길	민주노동당
경기도	4100	고양시일산동구	184138	115854	115536	318	68284	2838	권영길	민주노동당
경기도	4100	고양시일산서구	204400	132601	132265	336	71799	3260	권영길	민주노동당
경기도	4100	과천시	45430	32075	31993	82	13355	868	권영길	민주노동당
경기도	4100	의왕시	101448	66677	66464	213	34771	1824	권영길	민주노동당
경기도	4100	구리시	144987	91250	90994	256	53737	2338	권영길	민주노동당
경기도	4100	남양주시	361363	219433	218730	703	141930	5370	권영길	민주노동당
경기도	4100	오산시	103848	60027	59808	219	43821	2150	권영길	민주노동당
경기도	4100	화성시	265536	159514	158846	668	106022	6170	권영길	민주노동당
경기도	4100	시흥시	277333	157636	157120	516	119697	4810	권영길	민주노동당
경기도	4100	군포시	203559	133078	132707	371	70481	4204	권영길	민주노동당
경기도	4100	하남시	106527	65545	65324	221	40982	1337	권영길	민주노동당
경기도	4100	파주시	228024	138055	137399	656	89969	3812	권영길	민주노동당
경기도	4100	여주군	82266	49800	49436	364	32466	1601	권영길	민주노동당
경기도	4100	이천시	144497	83665	83144	521	60832	2451	권영길	민주노동당
경기도	4100	용인시처인구	151077	87778	87381	397	63299	2271	권영길	민주노동당
경기도	4100	용인시수지구	211290	140500	140202	298	70790	2589	권영길	민주노동당
경기도	4100	용인시기흥구	217439	140377	140032	345	77062	3203	권영길	민주노동당
경기도	4100	안성시	124360	73933	73489	444	50427	3097	권영길	민주노동당
경기도	4100	김포시	153236	96255	95859	396	56981	2439	권영길	민주노동당
경기도	4100	광주시	171826	104240	103850	390	67586	2207	권영길	민주노동당
경기도	4100	포천시	120695	71154	70689	465	49541	2098	권영길	민주노동당
경기도	4100	연천군	36588	23834	23623	211	12754	678	권영길	민주노동당
경기도	4100	양평군	70828	45899	45534	365	24929	1080	권영길	민주노동당
경기도	4100	가평군	44634	29186	28836	350	15448	708	권영길	민주노동당
경기도	4100	수원시장안구	210171	133783	133407	376	76388	751	이인제	민주당
경기도	4100	수원시권선구	227968	135070	134626	444	92898	834	이인제	민주당
경기도	4100	수원시팔달구	169529	97064	96690	374	72465	645	이인제	민주당
경기도	4100	수원시영통구	175615	111290	111059	231	64325	459	이인제	민주당
경기도	4100	성남시수정구	202875	113585	113142	443	89290	942	이인제	민주당
경기도	4100	성남시중원구	205596	114597	114215	382	90999	969	이인제	민주당
경기도	4100	성남시분당구	321923	218340	217842	498	103583	626	이인제	민주당
경기도	4100	의정부시	314746	191670	191042	628	123076	1016	이인제	민주당
경기도	4100	안양시만안구	205444	127123	126574	549	78321	823	이인제	민주당
경기도	4100	안양시동안구	261803	176837	176218	619	84966	742	이인제	민주당
경기도	4100	부천시원미구	333326	202315	201769	546	131011	1119	이인제	민주당
경기도	4100	부천시소사구	174754	106639	106278	361	68115	631	이인제	민주당
경기도	4100	부천시오정구	140783	79906	79587	319	60877	609	이인제	민주당
경기도	4100	광명시	236416	149929	149494	435	86487	911	이인제	민주당
경기도	4100	평택시	296098	176789	176037	752	119309	1451	이인제	민주당
경기도	4100	양주시	133824	79527	79138	389	54297	555	이인제	민주당
경기도	4100	동두천시	67629	38221	38032	189	29408	329	이인제	민주당
경기도	4100	안산시상록구	266293	153609	153066	543	112684	1014	이인제	민주당
경기도	4100	안산시단원구	238970	134675	134154	521	104295	977	이인제	민주당
경기도	4100	고양시덕양구	283032	176306	175776	530	106726	845	이인제	민주당
경기도	4100	고양시일산동구	184138	115854	115536	318	68284	383	이인제	민주당
경기도	4100	고양시일산서구	204400	132601	132265	336	71799	470	이인제	민주당
경기도	4100	과천시	45430	32075	31993	82	13355	82	이인제	민주당
경기도	4100	의왕시	101448	66677	66464	213	34771	340	이인제	민주당
경기도	4100	구리시	144987	91250	90994	256	53737	472	이인제	민주당
경기도	4100	남양주시	361363	219433	218730	703	141930	1289	이인제	민주당
경기도	4100	오산시	103848	60027	59808	219	43821	463	이인제	민주당
경기도	4100	화성시	265536	159514	158846	668	106022	1116	이인제	민주당
경기도	4100	시흥시	277333	157636	157120	516	119697	1108	이인제	민주당
경기도	4100	군포시	203559	133078	132707	371	70481	651	이인제	민주당
경기도	4100	하남시	106527	65545	65324	221	40982	354	이인제	민주당
경기도	4100	파주시	228024	138055	137399	656	89969	902	이인제	민주당
경기도	4100	여주군	82266	49800	49436	364	32466	511	이인제	민주당
경기도	4100	이천시	144497	83665	83144	521	60832	719	이인제	민주당
경기도	4100	용인시처인구	151077	87778	87381	397	63299	729	이인제	민주당
경기도	4100	용인시수지구	211290	140500	140202	298	70790	349	이인제	민주당
경기도	4100	용인시기흥구	217439	140377	140032	345	77062	503	이인제	민주당
경기도	4100	안성시	124360	73933	73489	444	50427	685	이인제	민주당
경기도	4100	김포시	153236	96255	95859	396	56981	623	이인제	민주당
경기도	4100	광주시	171826	104240	103850	390	67586	737	이인제	민주당
경기도	4100	포천시	120695	71154	70689	465	49541	704	이인제	민주당
경기도	4100	연천군	36588	23834	23623	211	12754	267	이인제	민주당
경기도	4100	양평군	70828	45899	45534	365	24929	473	이인제	민주당
경기도	4100	가평군	44634	29186	28836	350	15448	335	이인제	민주당
경기도	4100	수원시장안구	210171	133783	133407	376	76388	10787	문국현	창조한국당
경기도	4100	수원시권선구	227968	135070	134626	444	92898	10157	문국현	창조한국당
경기도	4100	수원시팔달구	169529	97064	96690	374	72465	7260	문국현	창조한국당
경기도	4100	수원시영통구	175615	111290	111059	231	64325	10290	문국현	창조한국당
경기도	4100	성남시수정구	202875	113585	113142	443	89290	7911	문국현	창조한국당
경기도	4100	성남시중원구	205596	114597	114215	382	90999	7374	문국현	창조한국당
경기도	4100	성남시분당구	321923	218340	217842	498	103583	15577	문국현	창조한국당
경기도	4100	의정부시	314746	191670	191042	628	123076	12525	문국현	창조한국당
경기도	4100	안양시만안구	205444	127123	126574	549	78321	9768	문국현	창조한국당
경기도	4100	안양시동안구	261803	176837	176218	619	84966	15119	문국현	창조한국당
경기도	4100	부천시원미구	333326	202315	201769	546	131011	15556	문국현	창조한국당
경기도	4100	부천시소사구	174754	106639	106278	361	68115	8117	문국현	창조한국당
경기도	4100	부천시오정구	140783	79906	79587	319	60877	5149	문국현	창조한국당
경기도	4100	광명시	236416	149929	149494	435	86487	11077	문국현	창조한국당
경기도	4100	평택시	296098	176789	176037	752	119309	10959	문국현	창조한국당
경기도	4100	양주시	133824	79527	79138	389	54297	4465	문국현	창조한국당
경기도	4100	동두천시	67629	38221	38032	189	29408	1878	문국현	창조한국당
경기도	4100	안산시상록구	266293	153609	153066	543	112684	11353	문국현	창조한국당
경기도	4100	안산시단원구	238970	134675	134154	521	104295	9275	문국현	창조한국당
경기도	4100	고양시덕양구	283032	176306	175776	530	106726	12527	문국현	창조한국당
경기도	4100	고양시일산동구	184138	115854	115536	318	68284	9055	문국현	창조한국당
경기도	4100	고양시일산서구	204400	132601	132265	336	71799	10042	문국현	창조한국당
경기도	4100	과천시	45430	32075	31993	82	13355	2603	문국현	창조한국당
경기도	4100	의왕시	101448	66677	66464	213	34771	5431	문국현	창조한국당
경기도	4100	구리시	144987	91250	90994	256	53737	6259	문국현	창조한국당
경기도	4100	남양주시	361363	219433	218730	703	141930	14217	문국현	창조한국당
경기도	4100	오산시	103848	60027	59808	219	43821	4462	문국현	창조한국당
경기도	4100	화성시	265536	159514	158846	668	106022	10972	문국현	창조한국당
경기도	4100	시흥시	277333	157636	157120	516	119697	10577	문국현	창조한국당
경기도	4100	군포시	203559	133078	132707	371	70481	11661	문국현	창조한국당
경기도	4100	하남시	106527	65545	65324	221	40982	4135	문국현	창조한국당
경기도	4100	파주시	228024	138055	137399	656	89969	8497	문국현	창조한국당
경기도	4100	여주군	82266	49800	49436	364	32466	2739	문국현	창조한국당
경기도	4100	이천시	144497	83665	83144	521	60832	5428	문국현	창조한국당
경기도	4100	용인시처인구	151077	87778	87381	397	63299	5375	문국현	창조한국당
경기도	4100	용인시수지구	211290	140500	140202	298	70790	10002	문국현	창조한국당
경기도	4100	용인시기흥구	217439	140377	140032	345	77062	11149	문국현	창조한국당
경기도	4100	안성시	124360	73933	73489	444	50427	4502	문국현	창조한국당
경기도	4100	김포시	153236	96255	95859	396	56981	5762	문국현	창조한국당
경기도	4100	광주시	171826	104240	103850	390	67586	6120	문국현	창조한국당
경기도	4100	포천시	120695	71154	70689	465	49541	3720	문국현	창조한국당
경기도	4100	연천군	36588	23834	23623	211	12754	1111	문국현	창조한국당
경기도	4100	양평군	70828	45899	45534	365	24929	2171	문국현	창조한국당
경기도	4100	가평군	44634	29186	28836	350	15448	1378	문국현	창조한국당
경기도	4100	수원시장안구	210171	133783	133407	376	76388	94	정근모	참주인연합
경기도	4100	수원시권선구	227968	135070	134626	444	92898	95	정근모	참주인연합
경기도	4100	수원시팔달구	169529	97064	96690	374	72465	72	정근모	참주인연합
경기도	4100	수원시영통구	175615	111290	111059	231	64325	68	정근모	참주인연합
경기도	4100	성남시수정구	202875	113585	113142	443	89290	87	정근모	참주인연합
경기도	4100	성남시중원구	205596	114597	114215	382	90999	74	정근모	참주인연합
경기도	4100	성남시분당구	321923	218340	217842	498	103583	139	정근모	참주인연합
경기도	4100	의정부시	314746	191670	191042	628	123076	113	정근모	참주인연합
경기도	4100	안양시만안구	205444	127123	126574	549	78321	70	정근모	참주인연합
경기도	4100	안양시동안구	261803	176837	176218	619	84966	97	정근모	참주인연합
경기도	4100	부천시원미구	333326	202315	201769	546	131011	114	정근모	참주인연합
경기도	4100	부천시소사구	174754	106639	106278	361	68115	81	정근모	참주인연합
경기도	4100	부천시오정구	140783	79906	79587	319	60877	46	정근모	참주인연합
경기도	4100	광명시	236416	149929	149494	435	86487	98	정근모	참주인연합
경기도	4100	평택시	296098	176789	176037	752	119309	107	정근모	참주인연합
경기도	4100	양주시	133824	79527	79138	389	54297	71	정근모	참주인연합
경기도	4100	동두천시	67629	38221	38032	189	29408	32	정근모	참주인연합
경기도	4100	안산시상록구	266293	153609	153066	543	112684	112	정근모	참주인연합
경기도	4100	안산시단원구	238970	134675	134154	521	104295	89	정근모	참주인연합
경기도	4100	고양시덕양구	283032	176306	175776	530	106726	131	정근모	참주인연합
경기도	4100	고양시일산동구	184138	115854	115536	318	68284	69	정근모	참주인연합
경기도	4100	고양시일산서구	204400	132601	132265	336	71799	56	정근모	참주인연합
경기도	4100	과천시	45430	32075	31993	82	13355	27	정근모	참주인연합
경기도	4100	의왕시	101448	66677	66464	213	34771	48	정근모	참주인연합
경기도	4100	구리시	144987	91250	90994	256	53737	41	정근모	참주인연합
경기도	4100	남양주시	361363	219433	218730	703	141930	150	정근모	참주인연합
경기도	4100	오산시	103848	60027	59808	219	43821	35	정근모	참주인연합
경기도	4100	화성시	265536	159514	158846	668	106022	84	정근모	참주인연합
경기도	4100	시흥시	277333	157636	157120	516	119697	105	정근모	참주인연합
경기도	4100	군포시	203559	133078	132707	371	70481	72	정근모	참주인연합
경기도	4100	하남시	106527	65545	65324	221	40982	35	정근모	참주인연합
경기도	4100	파주시	228024	138055	137399	656	89969	94	정근모	참주인연합
경기도	4100	여주군	82266	49800	49436	364	32466	32	정근모	참주인연합
경기도	4100	이천시	144497	83665	83144	521	60832	63	정근모	참주인연합
경기도	4100	용인시처인구	151077	87778	87381	397	63299	88	정근모	참주인연합
경기도	4100	용인시수지구	211290	140500	140202	298	70790	86	정근모	참주인연합
경기도	4100	용인시기흥구	217439	140377	140032	345	77062	118	정근모	참주인연합
경기도	4100	안성시	124360	73933	73489	444	50427	80	정근모	참주인연합
경기도	4100	김포시	153236	96255	95859	396	56981	60	정근모	참주인연합
경기도	4100	광주시	171826	104240	103850	390	67586	65	정근모	참주인연합
경기도	4100	포천시	120695	71154	70689	465	49541	56	정근모	참주인연합
경기도	4100	연천군	36588	23834	23623	211	12754	25	정근모	참주인연합
경기도	4100	양평군	70828	45899	45534	365	24929	61	정근모	참주인연합
경기도	4100	가평군	44634	29186	28836	350	15448	38	정근모	참주인연합
경기도	4100	수원시장안구	210171	133783	133407	376	76388	597	허경영	경제공화당
경기도	4100	수원시권선구	227968	135070	134626	444	92898	647	허경영	경제공화당
경기도	4100	수원시팔달구	169529	97064	96690	374	72465	456	허경영	경제공화당
경기도	4100	수원시영통구	175615	111290	111059	231	64325	542	허경영	경제공화당
경기도	4100	성남시수정구	202875	113585	113142	443	89290	582	허경영	경제공화당
경기도	4100	성남시중원구	205596	114597	114215	382	90999	614	허경영	경제공화당
경기도	4100	성남시분당구	321923	218340	217842	498	103583	736	허경영	경제공화당
경기도	4100	의정부시	314746	191670	191042	628	123076	1001	허경영	경제공화당
경기도	4100	안양시만안구	205444	127123	126574	549	78321	590	허경영	경제공화당
경기도	4100	안양시동안구	261803	176837	176218	619	84966	760	허경영	경제공화당
경기도	4100	부천시원미구	333326	202315	201769	546	131011	1010	허경영	경제공화당
경기도	4100	부천시소사구	174754	106639	106278	361	68115	584	허경영	경제공화당
경기도	4100	부천시오정구	140783	79906	79587	319	60877	418	허경영	경제공화당
경기도	4100	광명시	236416	149929	149494	435	86487	744	허경영	경제공화당
경기도	4100	평택시	296098	176789	176037	752	119309	843	허경영	경제공화당
경기도	4100	양주시	133824	79527	79138	389	54297	456	허경영	경제공화당
경기도	4100	동두천시	67629	38221	38032	189	29408	183	허경영	경제공화당
경기도	4100	안산시상록구	266293	153609	153066	543	112684	738	허경영	경제공화당
경기도	4100	안산시단원구	238970	134675	134154	521	104295	640	허경영	경제공화당
경기도	4100	고양시덕양구	283032	176306	175776	530	106726	681	허경영	경제공화당
경기도	4100	고양시일산동구	184138	115854	115536	318	68284	393	허경영	경제공화당
경기도	4100	고양시일산서구	204400	132601	132265	336	71799	407	허경영	경제공화당
경기도	4100	과천시	45430	32075	31993	82	13355	117	허경영	경제공화당
경기도	4100	의왕시	101448	66677	66464	213	34771	282	허경영	경제공화당
경기도	4100	구리시	144987	91250	90994	256	53737	499	허경영	경제공화당
경기도	4100	남양주시	361363	219433	218730	703	141930	1180	허경영	경제공화당
경기도	4100	오산시	103848	60027	59808	219	43821	296	허경영	경제공화당
경기도	4100	화성시	265536	159514	158846	668	106022	781	허경영	경제공화당
경기도	4100	시흥시	277333	157636	157120	516	119697	848	허경영	경제공화당
경기도	4100	군포시	203559	133078	132707	371	70481	601	허경영	경제공화당
경기도	4100	하남시	106527	65545	65324	221	40982	321	허경영	경제공화당
경기도	4100	파주시	228024	138055	137399	656	89969	615	허경영	경제공화당
경기도	4100	여주군	82266	49800	49436	364	32466	244	허경영	경제공화당
경기도	4100	이천시	144497	83665	83144	521	60832	414	허경영	경제공화당
경기도	4100	용인시처인구	151077	87778	87381	397	63299	449	허경영	경제공화당
경기도	4100	용인시수지구	211290	140500	140202	298	70790	442	허경영	경제공화당
경기도	4100	용인시기흥구	217439	140377	140032	345	77062	572	허경영	경제공화당
경기도	4100	안성시	124360	73933	73489	444	50427	429	허경영	경제공화당
경기도	4100	김포시	153236	96255	95859	396	56981	418	허경영	경제공화당
경기도	4100	광주시	171826	104240	103850	390	67586	477	허경영	경제공화당
경기도	4100	포천시	120695	71154	70689	465	49541	407	허경영	경제공화당
경기도	4100	연천군	36588	23834	23623	211	12754	125	허경영	경제공화당
경기도	4100	양평군	70828	45899	45534	365	24929	225	허경영	경제공화당
경기도	4100	가평군	44634	29186	28836	350	15448	190	허경영	경제공화당
경기도	4100	수원시장안구	210171	133783	133407	376	76388	31	전관	새시대참사람연합
경기도	4100	수원시권선구	227968	135070	134626	444	92898	47	전관	새시대참사람연합
경기도	4100	수원시팔달구	169529	97064	96690	374	72465	29	전관	새시대참사람연합
경기도	4100	수원시영통구	175615	111290	111059	231	64325	25	전관	새시대참사람연합
경기도	4100	성남시수정구	202875	113585	113142	443	89290	35	전관	새시대참사람연합
경기도	4100	성남시중원구	205596	114597	114215	382	90999	27	전관	새시대참사람연합
경기도	4100	성남시분당구	321923	218340	217842	498	103583	34	전관	새시대참사람연합
경기도	4100	의정부시	314746	191670	191042	628	123076	40	전관	새시대참사람연합
경기도	4100	안양시만안구	205444	127123	126574	549	78321	31	전관	새시대참사람연합
경기도	4100	안양시동안구	261803	176837	176218	619	84966	26	전관	새시대참사람연합
경기도	4100	부천시원미구	333326	202315	201769	546	131011	39	전관	새시대참사람연합
경기도	4100	부천시소사구	174754	106639	106278	361	68115	22	전관	새시대참사람연합
경기도	4100	부천시오정구	140783	79906	79587	319	60877	23	전관	새시대참사람연합
경기도	4100	광명시	236416	149929	149494	435	86487	29	전관	새시대참사람연합
경기도	4100	평택시	296098	176789	176037	752	119309	53	전관	새시대참사람연합
경기도	4100	양주시	133824	79527	79138	389	54297	27	전관	새시대참사람연합
경기도	4100	동두천시	67629	38221	38032	189	29408	11	전관	새시대참사람연합
경기도	4100	안산시상록구	266293	153609	153066	543	112684	37	전관	새시대참사람연합
경기도	4100	안산시단원구	238970	134675	134154	521	104295	40	전관	새시대참사람연합
경기도	4100	고양시덕양구	283032	176306	175776	530	106726	49	전관	새시대참사람연합
경기도	4100	고양시일산동구	184138	115854	115536	318	68284	26	전관	새시대참사람연합
경기도	4100	고양시일산서구	204400	132601	132265	336	71799	20	전관	새시대참사람연합
경기도	4100	과천시	45430	32075	31993	82	13355	8	전관	새시대참사람연합
경기도	4100	의왕시	101448	66677	66464	213	34771	10	전관	새시대참사람연합
경기도	4100	구리시	144987	91250	90994	256	53737	14	전관	새시대참사람연합
경기도	4100	남양주시	361363	219433	218730	703	141930	56	전관	새시대참사람연합
경기도	4100	오산시	103848	60027	59808	219	43821	12	전관	새시대참사람연합
경기도	4100	화성시	265536	159514	158846	668	106022	39	전관	새시대참사람연합
경기도	4100	시흥시	277333	157636	157120	516	119697	26	전관	새시대참사람연합
경기도	4100	군포시	203559	133078	132707	371	70481	26	전관	새시대참사람연합
경기도	4100	하남시	106527	65545	65324	221	40982	16	전관	새시대참사람연합
경기도	4100	파주시	228024	138055	137399	656	89969	67	전관	새시대참사람연합
경기도	4100	여주군	82266	49800	49436	364	32466	27	전관	새시대참사람연합
경기도	4100	이천시	144497	83665	83144	521	60832	34	전관	새시대참사람연합
경기도	4100	용인시처인구	151077	87778	87381	397	63299	36	전관	새시대참사람연합
경기도	4100	용인시수지구	211290	140500	140202	298	70790	16	전관	새시대참사람연합
경기도	4100	용인시기흥구	217439	140377	140032	345	77062	16	전관	새시대참사람연합
경기도	4100	안성시	124360	73933	73489	444	50427	34	전관	새시대참사람연합
경기도	4100	김포시	153236	96255	95859	396	56981	20	전관	새시대참사람연합
경기도	4100	광주시	171826	104240	103850	390	67586	36	전관	새시대참사람연합
경기도	4100	포천시	120695	71154	70689	465	49541	46	전관	새시대참사람연합
경기도	4100	연천군	36588	23834	23623	211	12754	19	전관	새시대참사람연합
경기도	4100	양평군	70828	45899	45534	365	24929	21	전관	새시대참사람연합
경기도	4100	가평군	44634	29186	28836	350	15448	32	전관	새시대참사람연합
경기도	4100	수원시장안구	210171	133783	133407	376	76388	96	금민	한국사회당
경기도	4100	수원시권선구	227968	135070	134626	444	92898	105	금민	한국사회당
경기도	4100	수원시팔달구	169529	97064	96690	374	72465	78	금민	한국사회당
경기도	4100	수원시영통구	175615	111290	111059	231	64325	74	금민	한국사회당
경기도	4100	성남시수정구	202875	113585	113142	443	89290	77	금민	한국사회당
경기도	4100	성남시중원구	205596	114597	114215	382	90999	92	금민	한국사회당
경기도	4100	성남시분당구	321923	218340	217842	498	103583	109	금민	한국사회당
경기도	4100	의정부시	314746	191670	191042	628	123076	71	금민	한국사회당
경기도	4100	안양시만안구	205444	127123	126574	549	78321	79	금민	한국사회당
경기도	4100	안양시동안구	261803	176837	176218	619	84966	107	금민	한국사회당
경기도	4100	부천시원미구	333326	202315	201769	546	131011	135	금민	한국사회당
경기도	4100	부천시소사구	174754	106639	106278	361	68115	67	금민	한국사회당
경기도	4100	부천시오정구	140783	79906	79587	319	60877	63	금민	한국사회당
경기도	4100	광명시	236416	149929	149494	435	86487	82	금민	한국사회당
경기도	4100	평택시	296098	176789	176037	752	119309	122	금민	한국사회당
경기도	4100	양주시	133824	79527	79138	389	54297	45	금민	한국사회당
경기도	4100	동두천시	67629	38221	38032	189	29408	25	금민	한국사회당
경기도	4100	안산시상록구	266293	153609	153066	543	112684	120	금민	한국사회당
경기도	4100	안산시단원구	238970	134675	134154	521	104295	76	금민	한국사회당
경기도	4100	고양시덕양구	283032	176306	175776	530	106726	128	금민	한국사회당
경기도	4100	고양시일산동구	184138	115854	115536	318	68284	73	금민	한국사회당
경기도	4100	고양시일산서구	204400	132601	132265	336	71799	82	금민	한국사회당
경기도	4100	과천시	45430	32075	31993	82	13355	16	금민	한국사회당
경기도	4100	의왕시	101448	66677	66464	213	34771	38	금민	한국사회당
경기도	4100	구리시	144987	91250	90994	256	53737	45	금민	한국사회당
경기도	4100	남양주시	361363	219433	218730	703	141930	121	금민	한국사회당
경기도	4100	오산시	103848	60027	59808	219	43821	50	금민	한국사회당
경기도	4100	화성시	265536	159514	158846	668	106022	112	금민	한국사회당
경기도	4100	시흥시	277333	157636	157120	516	119697	98	금민	한국사회당
경기도	4100	군포시	203559	133078	132707	371	70481	75	금민	한국사회당
경기도	4100	하남시	106527	65545	65324	221	40982	36	금민	한국사회당
경기도	4100	파주시	228024	138055	137399	656	89969	86	금민	한국사회당
경기도	4100	여주군	82266	49800	49436	364	32466	53	금민	한국사회당
경기도	4100	이천시	144497	83665	83144	521	60832	65	금민	한국사회당
경기도	4100	용인시처인구	151077	87778	87381	397	63299	72	금민	한국사회당
경기도	4100	용인시수지구	211290	140500	140202	298	70790	53	금민	한국사회당
경기도	4100	용인시기흥구	217439	140377	140032	345	77062	57	금민	한국사회당
경기도	4100	안성시	124360	73933	73489	444	50427	76	금민	한국사회당
경기도	4100	김포시	153236	96255	95859	396	56981	38	금민	한국사회당
경기도	4100	광주시	171826	104240	103850	390	67586	65	금민	한국사회당
경기도	4100	포천시	120695	71154	70689	465	49541	57	금민	한국사회당
경기도	4100	연천군	36588	23834	23623	211	12754	20	금민	한국사회당
경기도	4100	양평군	70828	45899	45534	365	24929	39	금민	한국사회당
경기도	4100	가평군	44634	29186	28836	350	15448	29	금민	한국사회당
경기도	4100	수원시장안구	210171	133783	133407	376	76388	21176	이회창	무소속
경기도	4100	수원시권선구	227968	135070	134626	444	92898	21784	이회창	무소속
경기도	4100	수원시팔달구	169529	97064	96690	374	72465	15331	이회창	무소속
경기도	4100	수원시영통구	175615	111290	111059	231	64325	16999	이회창	무소속
경기도	4100	성남시수정구	202875	113585	113142	443	89290	14015	이회창	무소속
경기도	4100	성남시중원구	205596	114597	114215	382	90999	14194	이회창	무소속
경기도	4100	성남시분당구	321923	218340	217842	498	103583	25735	이회창	무소속
경기도	4100	의정부시	314746	191670	191042	628	123076	23806	이회창	무소속
경기도	4100	안양시만안구	205444	127123	126574	549	78321	18799	이회창	무소속
경기도	4100	안양시동안구	261803	176837	176218	619	84966	24255	이회창	무소속
경기도	4100	부천시원미구	333326	202315	201769	546	131011	28392	이회창	무소속
경기도	4100	부천시소사구	174754	106639	106278	361	68115	15003	이회창	무소속
경기도	4100	부천시오정구	140783	79906	79587	319	60877	10856	이회창	무소속
경기도	4100	광명시	236416	149929	149494	435	86487	19985	이회창	무소속
경기도	4100	평택시	296098	176789	176037	752	119309	26749	이회창	무소속
경기도	4100	양주시	133824	79527	79138	389	54297	9468	이회창	무소속
경기도	4100	동두천시	67629	38221	38032	189	29408	4739	이회창	무소속
경기도	4100	안산시상록구	266293	153609	153066	543	112684	21086	이회창	무소속
경기도	4100	안산시단원구	238970	134675	134154	521	104295	19069	이회창	무소속
경기도	4100	고양시덕양구	283032	176306	175776	530	106726	21771	이회창	무소속
경기도	4100	고양시일산동구	184138	115854	115536	318	68284	13833	이회창	무소속
경기도	4100	고양시일산서구	204400	132601	132265	336	71799	15617	이회창	무소속
경기도	4100	과천시	45430	32075	31993	82	13355	3736	이회창	무소속
경기도	4100	의왕시	101448	66677	66464	213	34771	9216	이회창	무소속
경기도	4100	구리시	144987	91250	90994	256	53737	11210	이회창	무소속
경기도	4100	남양주시	361363	219433	218730	703	141930	25954	이회창	무소속
경기도	4100	오산시	103848	60027	59808	219	43821	9304	이회창	무소속
경기도	4100	화성시	265536	159514	158846	668	106022	22891	이회창	무소속
경기도	4100	시흥시	277333	157636	157120	516	119697	22013	이회창	무소속
경기도	4100	군포시	203559	133078	132707	371	70481	19311	이회창	무소속
경기도	4100	하남시	106527	65545	65324	221	40982	8493	이회창	무소속
경기도	4100	파주시	228024	138055	137399	656	89969	16782	이회창	무소속
경기도	4100	여주군	82266	49800	49436	364	32466	7193	이회창	무소속
경기도	4100	이천시	144497	83665	83144	521	60832	11390	이회창	무소속
경기도	4100	용인시처인구	151077	87778	87381	397	63299	11629	이회창	무소속
경기도	4100	용인시수지구	211290	140500	140202	298	70790	16058	이회창	무소속
경기도	4100	용인시기흥구	217439	140377	140032	345	77062	17072	이회창	무소속
경기도	4100	안성시	124360	73933	73489	444	50427	11333	이회창	무소속
경기도	4100	김포시	153236	96255	95859	396	56981	12079	이회창	무소속
경기도	4100	광주시	171826	104240	103850	390	67586	12197	이회창	무소속
경기도	4100	포천시	120695	71154	70689	465	49541	8234	이회창	무소속
경기도	4100	연천군	36588	23834	23623	211	12754	2865	이회창	무소속
경기도	4100	양평군	70828	45899	45534	365	24929	5451	이회창	무소속
경기도	4100	가평군	44634	29186	28836	350	15448	3669	이회창	무소속
강원도	4200	춘천시	196492	125883	125187	696	70609	22632	정동영	대통합민주신당
강원도	4200	원주시	222473	134205	133446	759	88268	25195	정동영	대통합민주신당
강원도	4200	강릉시	170634	105225	104573	652	65409	15492	정동영	대통합민주신당
강원도	4200	동해시	74275	45514	45188	326	28761	7256	정동영	대통합민주신당
강원도	4200	삼척시	56902	36635	36306	329	20267	6030	정동영	대통합민주신당
강원도	4200	태백시	40897	24364	24190	174	16533	4050	정동영	대통합민주신당
강원도	4200	정선군	34720	21600	21354	246	13120	4772	정동영	대통합민주신당
강원도	4200	속초시	64461	36959	36794	165	27502	6597	정동영	대통합민주신당
강원도	4200	고성군	24828	16112	15983	129	8716	3053	정동영	대통합민주신당
강원도	4200	양양군	23327	15507	15350	157	7820	2985	정동영	대통합민주신당
강원도	4200	인제군	25011	16576	16380	196	8435	4193	정동영	대통합민주신당
강원도	4200	홍천군	55527	35562	35230	332	19965	8539	정동영	대통합민주신당
강원도	4200	횡성군	35075	23250	22978	272	11825	5168	정동영	대통합민주신당
강원도	4200	영월군	32950	21913	21636	277	11037	4922	정동영	대통합민주신당
강원도	4200	평창군	35702	22624	22384	240	13078	5198	정동영	대통합민주신당
강원도	4200	화천군	18066	11854	11707	147	6212	2748	정동영	대통합민주신당
강원도	4200	양구군	16648	11163	11040	123	5485	2794	정동영	대통합민주신당
강원도	4200	철원군	36667	23949	23777	172	12718	5044	정동영	대통합민주신당
강원도	4200	춘천시	196492	125883	125187	696	70609	66113	이명박	한나라당
강원도	4200	원주시	222473	134205	133446	759	88268	68001	이명박	한나라당
강원도	4200	강릉시	170634	105225	104573	652	65409	57934	이명박	한나라당
강원도	4200	동해시	74275	45514	45188	326	28761	23942	이명박	한나라당
강원도	4200	삼척시	56902	36635	36306	329	20267	18696	이명박	한나라당
강원도	4200	태백시	40897	24364	24190	174	16533	12227	이명박	한나라당
강원도	4200	정선군	34720	21600	21354	246	13120	9705	이명박	한나라당
강원도	4200	속초시	64461	36959	36794	165	27502	20765	이명박	한나라당
강원도	4200	고성군	24828	16112	15983	129	8716	9058	이명박	한나라당
강원도	4200	양양군	23327	15507	15350	157	7820	8133	이명박	한나라당
강원도	4200	인제군	25011	16576	16380	196	8435	7640	이명박	한나라당
강원도	4200	홍천군	55527	35562	35230	332	19965	17210	이명박	한나라당
강원도	4200	횡성군	35075	23250	22978	272	11825	11162	이명박	한나라당
강원도	4200	영월군	32950	21913	21636	277	11037	10435	이명박	한나라당
강원도	4200	평창군	35702	22624	22384	240	13078	10828	이명박	한나라당
강원도	4200	화천군	18066	11854	11707	147	6212	5827	이명박	한나라당
강원도	4200	양구군	16648	11163	11040	123	5485	5113	이명박	한나라당
강원도	4200	철원군	36667	23949	23777	172	12718	13215	이명박	한나라당
강원도	4200	춘천시	196492	125883	125187	696	70609	4352	권영길	민주노동당
강원도	4200	원주시	222473	134205	133446	759	88268	6322	권영길	민주노동당
강원도	4200	강릉시	170634	105225	104573	652	65409	3294	권영길	민주노동당
강원도	4200	동해시	74275	45514	45188	326	28761	1513	권영길	민주노동당
강원도	4200	삼척시	56902	36635	36306	329	20267	1296	권영길	민주노동당
강원도	4200	태백시	40897	24364	24190	174	16533	964	권영길	민주노동당
강원도	4200	정선군	34720	21600	21354	246	13120	978	권영길	민주노동당
강원도	4200	속초시	64461	36959	36794	165	27502	1183	권영길	민주노동당
강원도	4200	고성군	24828	16112	15983	129	8716	508	권영길	민주노동당
강원도	4200	양양군	23327	15507	15350	157	7820	540	권영길	민주노동당
강원도	4200	인제군	25011	16576	16380	196	8435	591	권영길	민주노동당
강원도	4200	홍천군	55527	35562	35230	332	19965	1536	권영길	민주노동당
강원도	4200	횡성군	35075	23250	22978	272	11825	1220	권영길	민주노동당
강원도	4200	영월군	32950	21913	21636	277	11037	778	권영길	민주노동당
강원도	4200	평창군	35702	22624	22384	240	13078	799	권영길	민주노동당
강원도	4200	화천군	18066	11854	11707	147	6212	528	권영길	민주노동당
강원도	4200	양구군	16648	11163	11040	123	5485	511	권영길	민주노동당
강원도	4200	철원군	36667	23949	23777	172	12718	1216	권영길	민주노동당
강원도	4200	춘천시	196492	125883	125187	696	70609	792	이인제	민주당
강원도	4200	원주시	222473	134205	133446	759	88268	990	이인제	민주당
강원도	4200	강릉시	170634	105225	104573	652	65409	534	이인제	민주당
강원도	4200	동해시	74275	45514	45188	326	28761	262	이인제	민주당
강원도	4200	삼척시	56902	36635	36306	329	20267	268	이인제	민주당
강원도	4200	태백시	40897	24364	24190	174	16533	188	이인제	민주당
강원도	4200	정선군	34720	21600	21354	246	13120	286	이인제	민주당
강원도	4200	속초시	64461	36959	36794	165	27502	201	이인제	민주당
강원도	4200	고성군	24828	16112	15983	129	8716	153	이인제	민주당
강원도	4200	양양군	23327	15507	15350	157	7820	153	이인제	민주당
강원도	4200	인제군	25011	16576	16380	196	8435	207	이인제	민주당
강원도	4200	홍천군	55527	35562	35230	332	19965	514	이인제	민주당
강원도	4200	횡성군	35075	23250	22978	272	11825	298	이인제	민주당
강원도	4200	영월군	32950	21913	21636	277	11037	301	이인제	민주당
강원도	4200	평창군	35702	22624	22384	240	13078	239	이인제	민주당
강원도	4200	화천군	18066	11854	11707	147	6212	202	이인제	민주당
강원도	4200	양구군	16648	11163	11040	123	5485	193	이인제	민주당
강원도	4200	철원군	36667	23949	23777	172	12718	304	이인제	민주당
강원도	4200	춘천시	196492	125883	125187	696	70609	9591	문국현	창조한국당
강원도	4200	원주시	222473	134205	133446	759	88268	8623	문국현	창조한국당
강원도	4200	강릉시	170634	105225	104573	652	65409	6288	문국현	창조한국당
강원도	4200	동해시	74275	45514	45188	326	28761	2594	문국현	창조한국당
강원도	4200	삼척시	56902	36635	36306	329	20267	1621	문국현	창조한국당
강원도	4200	태백시	40897	24364	24190	174	16533	1344	문국현	창조한국당
강원도	4200	정선군	34720	21600	21354	246	13120	874	문국현	창조한국당
강원도	4200	속초시	64461	36959	36794	165	27502	2169	문국현	창조한국당
강원도	4200	고성군	24828	16112	15983	129	8716	702	문국현	창조한국당
강원도	4200	양양군	23327	15507	15350	157	7820	694	문국현	창조한국당
강원도	4200	인제군	25011	16576	16380	196	8435	985	문국현	창조한국당
강원도	4200	홍천군	55527	35562	35230	332	19965	1706	문국현	창조한국당
강원도	4200	횡성군	35075	23250	22978	272	11825	1084	문국현	창조한국당
강원도	4200	영월군	32950	21913	21636	277	11037	935	문국현	창조한국당
강원도	4200	평창군	35702	22624	22384	240	13078	1072	문국현	창조한국당
강원도	4200	화천군	18066	11854	11707	147	6212	569	문국현	창조한국당
강원도	4200	양구군	16648	11163	11040	123	5485	579	문국현	창조한국당
강원도	4200	철원군	36667	23949	23777	172	12718	1122	문국현	창조한국당
강원도	4200	춘천시	196492	125883	125187	696	70609	95	정근모	참주인연합
강원도	4200	원주시	222473	134205	133446	759	88268	133	정근모	참주인연합
강원도	4200	강릉시	170634	105225	104573	652	65409	71	정근모	참주인연합
강원도	4200	동해시	74275	45514	45188	326	28761	30	정근모	참주인연합
강원도	4200	삼척시	56902	36635	36306	329	20267	30	정근모	참주인연합
강원도	4200	태백시	40897	24364	24190	174	16533	8	정근모	참주인연합
강원도	4200	정선군	34720	21600	21354	246	13120	25	정근모	참주인연합
강원도	4200	속초시	64461	36959	36794	165	27502	18	정근모	참주인연합
강원도	4200	고성군	24828	16112	15983	129	8716	13	정근모	참주인연합
강원도	4200	양양군	23327	15507	15350	157	7820	13	정근모	참주인연합
강원도	4200	인제군	25011	16576	16380	196	8435	18	정근모	참주인연합
강원도	4200	홍천군	55527	35562	35230	332	19965	36	정근모	참주인연합
강원도	4200	횡성군	35075	23250	22978	272	11825	24	정근모	참주인연합
강원도	4200	영월군	32950	21913	21636	277	11037	27	정근모	참주인연합
강원도	4200	평창군	35702	22624	22384	240	13078	25	정근모	참주인연합
강원도	4200	화천군	18066	11854	11707	147	6212	16	정근모	참주인연합
강원도	4200	양구군	16648	11163	11040	123	5485	12	정근모	참주인연합
강원도	4200	철원군	36667	23949	23777	172	12718	21	정근모	참주인연합
강원도	4200	춘천시	196492	125883	125187	696	70609	757	허경영	경제공화당
강원도	4200	원주시	222473	134205	133446	759	88268	905	허경영	경제공화당
강원도	4200	강릉시	170634	105225	104573	652	65409	1066	허경영	경제공화당
강원도	4200	동해시	74275	45514	45188	326	28761	236	허경영	경제공화당
강원도	4200	삼척시	56902	36635	36306	329	20267	171	허경영	경제공화당
강원도	4200	태백시	40897	24364	24190	174	16533	96	허경영	경제공화당
강원도	4200	정선군	34720	21600	21354	246	13120	106	허경영	경제공화당
강원도	4200	속초시	64461	36959	36794	165	27502	261	허경영	경제공화당
강원도	4200	고성군	24828	16112	15983	129	8716	100	허경영	경제공화당
강원도	4200	양양군	23327	15507	15350	157	7820	118	허경영	경제공화당
강원도	4200	인제군	25011	16576	16380	196	8435	118	허경영	경제공화당
강원도	4200	홍천군	55527	35562	35230	332	19965	303	허경영	경제공화당
강원도	4200	횡성군	35075	23250	22978	272	11825	190	허경영	경제공화당
강원도	4200	영월군	32950	21913	21636	277	11037	125	허경영	경제공화당
강원도	4200	평창군	35702	22624	22384	240	13078	190	허경영	경제공화당
강원도	4200	화천군	18066	11854	11707	147	6212	88	허경영	경제공화당
강원도	4200	양구군	16648	11163	11040	123	5485	96	허경영	경제공화당
강원도	4200	철원군	36667	23949	23777	172	12718	137	허경영	경제공화당
강원도	4200	춘천시	196492	125883	125187	696	70609	51	전관	새시대참사람연합
강원도	4200	원주시	222473	134205	133446	759	88268	47	전관	새시대참사람연합
강원도	4200	강릉시	170634	105225	104573	652	65409	47	전관	새시대참사람연합
강원도	4200	동해시	74275	45514	45188	326	28761	11	전관	새시대참사람연합
강원도	4200	삼척시	56902	36635	36306	329	20267	22	전관	새시대참사람연합
강원도	4200	태백시	40897	24364	24190	174	16533	6	전관	새시대참사람연합
강원도	4200	정선군	34720	21600	21354	246	13120	29	전관	새시대참사람연합
강원도	4200	속초시	64461	36959	36794	165	27502	26	전관	새시대참사람연합
강원도	4200	고성군	24828	16112	15983	129	8716	10	전관	새시대참사람연합
강원도	4200	양양군	23327	15507	15350	157	7820	7	전관	새시대참사람연합
강원도	4200	인제군	25011	16576	16380	196	8435	41	전관	새시대참사람연합
강원도	4200	홍천군	55527	35562	35230	332	19965	30	전관	새시대참사람연합
강원도	4200	횡성군	35075	23250	22978	272	11825	22	전관	새시대참사람연합
강원도	4200	영월군	32950	21913	21636	277	11037	21	전관	새시대참사람연합
강원도	4200	평창군	35702	22624	22384	240	13078	21	전관	새시대참사람연합
강원도	4200	화천군	18066	11854	11707	147	6212	15	전관	새시대참사람연합
강원도	4200	양구군	16648	11163	11040	123	5485	13	전관	새시대참사람연합
강원도	4200	철원군	36667	23949	23777	172	12718	17	전관	새시대참사람연합
강원도	4200	춘천시	196492	125883	125187	696	70609	106	금민	한국사회당
강원도	4200	원주시	222473	134205	133446	759	88268	188	금민	한국사회당
강원도	4200	강릉시	170634	105225	104573	652	65409	107	금민	한국사회당
강원도	4200	동해시	74275	45514	45188	326	28761	42	금민	한국사회당
강원도	4200	삼척시	56902	36635	36306	329	20267	51	금민	한국사회당
강원도	4200	태백시	40897	24364	24190	174	16533	27	금민	한국사회당
강원도	4200	정선군	34720	21600	21354	246	13120	44	금민	한국사회당
강원도	4200	속초시	64461	36959	36794	165	27502	21	금민	한국사회당
강원도	4200	고성군	24828	16112	15983	129	8716	13	금민	한국사회당
강원도	4200	양양군	23327	15507	15350	157	7820	16	금민	한국사회당
강원도	4200	인제군	25011	16576	16380	196	8435	16	금민	한국사회당
강원도	4200	홍천군	55527	35562	35230	332	19965	53	금민	한국사회당
강원도	4200	횡성군	35075	23250	22978	272	11825	44	금민	한국사회당
강원도	4200	영월군	32950	21913	21636	277	11037	33	금민	한국사회당
강원도	4200	평창군	35702	22624	22384	240	13078	38	금민	한국사회당
강원도	4200	화천군	18066	11854	11707	147	6212	16	금민	한국사회당
강원도	4200	양구군	16648	11163	11040	123	5485	15	금민	한국사회당
강원도	4200	철원군	36667	23949	23777	172	12718	19	금민	한국사회당
강원도	4200	춘천시	196492	125883	125187	696	70609	20698	이회창	무소속
강원도	4200	원주시	222473	134205	133446	759	88268	23042	이회창	무소속
강원도	4200	강릉시	170634	105225	104573	652	65409	19740	이회창	무소속
강원도	4200	동해시	74275	45514	45188	326	28761	9302	이회창	무소속
강원도	4200	삼척시	56902	36635	36306	329	20267	8121	이회창	무소속
강원도	4200	태백시	40897	24364	24190	174	16533	5280	이회창	무소속
강원도	4200	정선군	34720	21600	21354	246	13120	4535	이회창	무소속
강원도	4200	속초시	64461	36959	36794	165	27502	5553	이회창	무소속
강원도	4200	고성군	24828	16112	15983	129	8716	2373	이회창	무소속
강원도	4200	양양군	23327	15507	15350	157	7820	2691	이회창	무소속
강원도	4200	인제군	25011	16576	16380	196	8435	2571	이회창	무소속
강원도	4200	홍천군	55527	35562	35230	332	19965	5303	이회창	무소속
강원도	4200	횡성군	35075	23250	22978	272	11825	3766	이회창	무소속
강원도	4200	영월군	32950	21913	21636	277	11037	4059	이회창	무소속
강원도	4200	평창군	35702	22624	22384	240	13078	3974	이회창	무소속
강원도	4200	화천군	18066	11854	11707	147	6212	1698	이회창	무소속
강원도	4200	양구군	16648	11163	11040	123	5485	1714	이회창	무소속
강원도	4200	철원군	36667	23949	23777	172	12718	2682	이회창	무소속
충청북도	4300	청주시상당구	184975	111986	111392	594	72989	24361	정동영	대통합민주신당
충청북도	4300	청주시흥덕구	277547	165610	164812	798	111937	36408	정동영	대통합민주신당
충청북도	4300	충주시	157206	94852	93985	867	62354	20282	정동영	대통합민주신당
충청북도	4300	제천시	105649	66705	66034	671	38944	13123	정동영	대통합민주신당
충청북도	4300	단양군	26564	17457	17194	263	9107	3873	정동영	대통합민주신당
충청북도	4300	청원군	109982	67302	66518	784	42680	18173	정동영	대통합민주신당
충청북도	4300	영동군	41056	27267	26832	435	13789	7113	정동영	대통합민주신당
충청북도	4300	보은군	29383	19907	19603	304	9476	6978	정동영	대통합민주신당
충청북도	4300	옥천군	44227	29097	28605	492	15130	9178	정동영	대통합민주신당
충청북도	4300	음성군	68117	39820	39361	459	28297	10210	정동영	대통합민주신당
충청북도	4300	진천군	46260	27916	27605	311	18344	7549	정동영	대통합민주신당
충청북도	4300	괴산군	31545	20753	20378	375	10792	4786	정동영	대통합민주신당
충청북도	4300	증평군	23591	13921	13777	144	9670	3603	정동영	대통합민주신당
충청북도	4300	청주시상당구	184975	111986	111392	594	72989	46133	이명박	한나라당
충청북도	4300	청주시흥덕구	277547	165610	164812	798	111937	66251	이명박	한나라당
충청북도	4300	충주시	157206	94852	93985	867	62354	45089	이명박	한나라당
충청북도	4300	제천시	105649	66705	66034	671	38944	30743	이명박	한나라당
충청북도	4300	단양군	26564	17457	17194	263	9107	7552	이명박	한나라당
충청북도	4300	청원군	109982	67302	66518	784	42680	25120	이명박	한나라당
충청북도	4300	영동군	41056	27267	26832	435	13789	11464	이명박	한나라당
충청북도	4300	보은군	29383	19907	19603	304	9476	6880	이명박	한나라당
충청북도	4300	옥천군	44227	29097	28605	492	15130	9731	이명박	한나라당
충청북도	4300	음성군	68117	39820	39361	459	28297	16303	이명박	한나라당
충청북도	4300	진천군	46260	27916	27605	311	18344	10792	이명박	한나라당
충청북도	4300	괴산군	31545	20753	20378	375	10792	8404	이명박	한나라당
충청북도	4300	증평군	23591	13921	13777	144	9670	5037	이명박	한나라당
충청북도	4300	청주시상당구	184975	111986	111392	594	72989	3349	권영길	민주노동당
충청북도	4300	청주시흥덕구	277547	165610	164812	798	111937	5506	권영길	민주노동당
충청북도	4300	충주시	157206	94852	93985	867	62354	2972	권영길	민주노동당
충청북도	4300	제천시	105649	66705	66034	671	38944	2620	권영길	민주노동당
충청북도	4300	단양군	26564	17457	17194	263	9107	633	권영길	민주노동당
충청북도	4300	청원군	109982	67302	66518	784	42680	2309	권영길	민주노동당
충청북도	4300	영동군	41056	27267	26832	435	13789	1170	권영길	민주노동당
충청북도	4300	보은군	29383	19907	19603	304	9476	726	권영길	민주노동당
충청북도	4300	옥천군	44227	29097	28605	492	15130	1160	권영길	민주노동당
충청북도	4300	음성군	68117	39820	39361	459	28297	1823	권영길	민주노동당
충청북도	4300	진천군	46260	27916	27605	311	18344	1446	권영길	민주노동당
충청북도	4300	괴산군	31545	20753	20378	375	10792	1163	권영길	민주노동당
충청북도	4300	증평군	23591	13921	13777	144	9670	408	권영길	민주노동당
충청북도	4300	청주시상당구	184975	111986	111392	594	72989	948	이인제	민주당
충청북도	4300	청주시흥덕구	277547	165610	164812	798	111937	1343	이인제	민주당
충청북도	4300	충주시	157206	94852	93985	867	62354	1097	이인제	민주당
충청북도	4300	제천시	105649	66705	66034	671	38944	643	이인제	민주당
충청북도	4300	단양군	26564	17457	17194	263	9107	225	이인제	민주당
충청북도	4300	청원군	109982	67302	66518	784	42680	874	이인제	민주당
충청북도	4300	영동군	41056	27267	26832	435	13789	363	이인제	민주당
충청북도	4300	보은군	29383	19907	19603	304	9476	368	이인제	민주당
충청북도	4300	옥천군	44227	29097	28605	492	15130	507	이인제	민주당
충청북도	4300	음성군	68117	39820	39361	459	28297	602	이인제	민주당
충청북도	4300	진천군	46260	27916	27605	311	18344	432	이인제	민주당
충청북도	4300	괴산군	31545	20753	20378	375	10792	377	이인제	민주당
충청북도	4300	증평군	23591	13921	13777	144	9670	186	이인제	민주당
충청북도	4300	청주시상당구	184975	111986	111392	594	72989	7176	문국현	창조한국당
충청북도	4300	청주시흥덕구	277547	165610	164812	798	111937	11728	문국현	창조한국당
충청북도	4300	충주시	157206	94852	93985	867	62354	5201	문국현	창조한국당
충청북도	4300	제천시	105649	66705	66034	671	38944	3290	문국현	창조한국당
충청북도	4300	단양군	26564	17457	17194	263	9107	785	문국현	창조한국당
충청북도	4300	청원군	109982	67302	66518	784	42680	3893	문국현	창조한국당
충청북도	4300	영동군	41056	27267	26832	435	13789	1033	문국현	창조한국당
충청북도	4300	보은군	29383	19907	19603	304	9476	781	문국현	창조한국당
충청북도	4300	옥천군	44227	29097	28605	492	15130	1252	문국현	창조한국당
충청북도	4300	음성군	68117	39820	39361	459	28297	1948	문국현	창조한국당
충청북도	4300	진천군	46260	27916	27605	311	18344	1315	문국현	창조한국당
충청북도	4300	괴산군	31545	20753	20378	375	10792	742	문국현	창조한국당
충청북도	4300	증평군	23591	13921	13777	144	9670	740	문국현	창조한국당
충청북도	4300	청주시상당구	184975	111986	111392	594	72989	81	정근모	참주인연합
충청북도	4300	청주시흥덕구	277547	165610	164812	798	111937	93	정근모	참주인연합
충청북도	4300	충주시	157206	94852	93985	867	62354	63	정근모	참주인연합
충청북도	4300	제천시	105649	66705	66034	671	38944	42	정근모	참주인연합
충청북도	4300	단양군	26564	17457	17194	263	9107	23	정근모	참주인연합
충청북도	4300	청원군	109982	67302	66518	784	42680	65	정근모	참주인연합
충청북도	4300	영동군	41056	27267	26832	435	13789	34	정근모	참주인연합
충청북도	4300	보은군	29383	19907	19603	304	9476	15	정근모	참주인연합
충청북도	4300	옥천군	44227	29097	28605	492	15130	36	정근모	참주인연합
충청북도	4300	음성군	68117	39820	39361	459	28297	51	정근모	참주인연합
충청북도	4300	진천군	46260	27916	27605	311	18344	23	정근모	참주인연합
충청북도	4300	괴산군	31545	20753	20378	375	10792	27	정근모	참주인연합
충청북도	4300	증평군	23591	13921	13777	144	9670	8	정근모	참주인연합
충청북도	4300	청주시상당구	184975	111986	111392	594	72989	562	허경영	경제공화당
충청북도	4300	청주시흥덕구	277547	165610	164812	798	111937	764	허경영	경제공화당
충청북도	4300	충주시	157206	94852	93985	867	62354	597	허경영	경제공화당
충청북도	4300	제천시	105649	66705	66034	671	38944	377	허경영	경제공화당
충청북도	4300	단양군	26564	17457	17194	263	9107	114	허경영	경제공화당
충청북도	4300	청원군	109982	67302	66518	784	42680	275	허경영	경제공화당
충청북도	4300	영동군	41056	27267	26832	435	13789	96	허경영	경제공화당
충청북도	4300	보은군	29383	19907	19603	304	9476	88	허경영	경제공화당
충청북도	4300	옥천군	44227	29097	28605	492	15130	116	허경영	경제공화당
충청북도	4300	음성군	68117	39820	39361	459	28297	194	허경영	경제공화당
충청북도	4300	진천군	46260	27916	27605	311	18344	142	허경영	경제공화당
충청북도	4300	괴산군	31545	20753	20378	375	10792	38	허경영	경제공화당
충청북도	4300	증평군	23591	13921	13777	144	9670	72	허경영	경제공화당
충청북도	4300	청주시상당구	184975	111986	111392	594	72989	31	전관	새시대참사람연합
충청북도	4300	청주시흥덕구	277547	165610	164812	798	111937	45	전관	새시대참사람연합
충청북도	4300	충주시	157206	94852	93985	867	62354	41	전관	새시대참사람연합
충청북도	4300	제천시	105649	66705	66034	671	38944	38	전관	새시대참사람연합
충청북도	4300	단양군	26564	17457	17194	263	9107	11	전관	새시대참사람연합
충청북도	4300	청원군	109982	67302	66518	784	42680	39	전관	새시대참사람연합
충청북도	4300	영동군	41056	27267	26832	435	13789	12	전관	새시대참사람연합
충청북도	4300	보은군	29383	19907	19603	304	9476	15	전관	새시대참사람연합
충청북도	4300	옥천군	44227	29097	28605	492	15130	22	전관	새시대참사람연합
충청북도	4300	음성군	68117	39820	39361	459	28297	31	전관	새시대참사람연합
충청북도	4300	진천군	46260	27916	27605	311	18344	14	전관	새시대참사람연합
충청북도	4300	괴산군	31545	20753	20378	375	10792	10	전관	새시대참사람연합
충청북도	4300	증평군	23591	13921	13777	144	9670	12	전관	새시대참사람연합
충청북도	4300	청주시상당구	184975	111986	111392	594	72989	82	금민	한국사회당
충청북도	4300	청주시흥덕구	277547	165610	164812	798	111937	164	금민	한국사회당
충청북도	4300	충주시	157206	94852	93985	867	62354	60	금민	한국사회당
충청북도	4300	제천시	105649	66705	66034	671	38944	77	금민	한국사회당
충청북도	4300	단양군	26564	17457	17194	263	9107	21	금민	한국사회당
충청북도	4300	청원군	109982	67302	66518	784	42680	92	금민	한국사회당
충청북도	4300	영동군	41056	27267	26832	435	13789	45	금민	한국사회당
충청북도	4300	보은군	29383	19907	19603	304	9476	23	금민	한국사회당
충청북도	4300	옥천군	44227	29097	28605	492	15130	63	금민	한국사회당
충청북도	4300	음성군	68117	39820	39361	459	28297	38	금민	한국사회당
충청북도	4300	진천군	46260	27916	27605	311	18344	30	금민	한국사회당
충청북도	4300	괴산군	31545	20753	20378	375	10792	44	금민	한국사회당
충청북도	4300	증평군	23591	13921	13777	144	9670	20	금민	한국사회당
충청북도	4300	청주시상당구	184975	111986	111392	594	72989	28669	이회창	무소속
충청북도	4300	청주시흥덕구	277547	165610	164812	798	111937	42510	이회창	무소속
충청북도	4300	충주시	157206	94852	93985	867	62354	18583	이회창	무소속
충청북도	4300	제천시	105649	66705	66034	671	38944	15081	이회창	무소속
충청북도	4300	단양군	26564	17457	17194	263	9107	3957	이회창	무소속
충청북도	4300	청원군	109982	67302	66518	784	42680	15678	이회창	무소속
충청북도	4300	영동군	41056	27267	26832	435	13789	5502	이회창	무소속
충청북도	4300	보은군	29383	19907	19603	304	9476	3729	이회창	무소속
충청북도	4300	옥천군	44227	29097	28605	492	15130	6540	이회창	무소속
충청북도	4300	음성군	68117	39820	39361	459	28297	8161	이회창	무소속
충청북도	4300	진천군	46260	27916	27605	311	18344	5862	이회창	무소속
충청북도	4300	괴산군	31545	20753	20378	375	10792	4787	이회창	무소속
충청북도	4300	증평군	23591	13921	13777	144	9670	3691	이회창	무소속
충청남도	4400	천안시	384145	223871	222796	1075	160274	47217	정동영	대통합민주신당
충청남도	4400	공주시	100441	60827	60206	621	39614	13301	정동영	대통합민주신당
충청남도	4400	보령시	85009	52590	51947	643	32419	10172	정동영	대통합민주신당
충청남도	4400	아산시	167540	94122	93533	589	73418	18665	정동영	대통합민주신당
충청남도	4400	서산시	115264	69287	68637	650	45977	14056	정동영	대통합민주신당
충청남도	4400	태안군	51230	31923	31464	459	19307	7355	정동영	대통합민주신당
충청남도	4400	금산군	46603	28558	28214	344	18045	8063	정동영	대통합민주신당
충청남도	4400	연기군	63317	42235	41231	1004	21082	10525	정동영	대통합민주신당
충청남도	4400	논산시	102616	61078	60515	563	41538	17311	정동영	대통합민주신당
충청남도	4400	계룡시	25719	17187	17114	73	8532	3808	정동영	대통합민주신당
충청남도	4400	부여군	63526	39879	39381	498	23647	8562	정동영	대통합민주신당
충청남도	4400	서천군	50538	31927	31539	388	18611	8302	정동영	대통합민주신당
충청남도	4400	홍성군	70470	44195	43742	453	26275	6891	정동영	대통합민주신당
충청남도	4400	청양군	27914	18733	18493	240	9181	3172	정동영	대통합민주신당
충청남도	4400	예산군	72086	48521	48142	379	23565	4350	정동영	대통합민주신당
충청남도	4400	당진군	106333	59106	58551	555	47227	11249	정동영	대통합민주신당
충청남도	4400	천안시	384145	223871	222796	1075	160274	90229	이명박	한나라당
충청남도	4400	공주시	100441	60827	60206	621	39614	16936	이명박	한나라당
충청남도	4400	보령시	85009	52590	51947	643	32419	16630	이명박	한나라당
충청남도	4400	아산시	167540	94122	93533	589	73418	35318	이명박	한나라당
충청남도	4400	서산시	115264	69287	68637	650	45977	26335	이명박	한나라당
충청남도	4400	태안군	51230	31923	31464	459	19307	11033	이명박	한나라당
충청남도	4400	금산군	46603	28558	28214	344	18045	9005	이명박	한나라당
충청남도	4400	연기군	63317	42235	41231	1004	21082	11585	이명박	한나라당
충청남도	4400	논산시	102616	61078	60515	563	41538	17467	이명박	한나라당
충청남도	4400	계룡시	25719	17187	17114	73	8532	7639	이명박	한나라당
충청남도	4400	부여군	63526	39879	39381	498	23647	11784	이명박	한나라당
충청남도	4400	서천군	50538	31927	31539	388	18611	9823	이명박	한나라당
충청남도	4400	홍성군	70470	44195	43742	453	26275	13117	이명박	한나라당
충청남도	4400	청양군	27914	18733	18493	240	9181	4926	이명박	한나라당
충청남도	4400	예산군	72086	48521	48142	379	23565	9487	이명박	한나라당
충청남도	4400	당진군	106333	59106	58551	555	47227	22379	이명박	한나라당
충청남도	4400	천안시	384145	223871	222796	1075	160274	8381	권영길	민주노동당
충청남도	4400	공주시	100441	60827	60206	621	39614	1639	권영길	민주노동당
충청남도	4400	보령시	85009	52590	51947	643	32419	1686	권영길	민주노동당
충청남도	4400	아산시	167540	94122	93533	589	73418	5331	권영길	민주노동당
충청남도	4400	서산시	115264	69287	68637	650	45977	2648	권영길	민주노동당
충청남도	4400	태안군	51230	31923	31464	459	19307	927	권영길	민주노동당
충청남도	4400	금산군	46603	28558	28214	344	18045	809	권영길	민주노동당
충청남도	4400	연기군	63317	42235	41231	1004	21082	1042	권영길	민주노동당
충청남도	4400	논산시	102616	61078	60515	563	41538	1776	권영길	민주노동당
충청남도	4400	계룡시	25719	17187	17114	73	8532	308	권영길	민주노동당
충청남도	4400	부여군	63526	39879	39381	498	23647	1469	권영길	민주노동당
충청남도	4400	서천군	50538	31927	31539	388	18611	1165	권영길	민주노동당
충청남도	4400	홍성군	70470	44195	43742	453	26275	1174	권영길	민주노동당
충청남도	4400	청양군	27914	18733	18493	240	9181	538	권영길	민주노동당
충청남도	4400	예산군	72086	48521	48142	379	23565	753	권영길	민주노동당
충청남도	4400	당진군	106333	59106	58551	555	47227	2486	권영길	민주노동당
충청남도	4400	천안시	384145	223871	222796	1075	160274	2093	이인제	민주당
충청남도	4400	공주시	100441	60827	60206	621	39614	1378	이인제	민주당
충청남도	4400	보령시	85009	52590	51947	643	32419	1217	이인제	민주당
충청남도	4400	아산시	167540	94122	93533	589	73418	1023	이인제	민주당
충청남도	4400	서산시	115264	69287	68637	650	45977	1263	이인제	민주당
충청남도	4400	태안군	51230	31923	31464	459	19307	723	이인제	민주당
충청남도	4400	금산군	46603	28558	28214	344	18045	1202	이인제	민주당
충청남도	4400	연기군	63317	42235	41231	1004	21082	705	이인제	민주당
충청남도	4400	논산시	102616	61078	60515	563	41538	6964	이인제	민주당
충청남도	4400	계룡시	25719	17187	17114	73	8532	284	이인제	민주당
충청남도	4400	부여군	63526	39879	39381	498	23647	2183	이인제	민주당
충청남도	4400	서천군	50538	31927	31539	388	18611	939	이인제	민주당
충청남도	4400	홍성군	70470	44195	43742	453	26275	651	이인제	민주당
충청남도	4400	청양군	27914	18733	18493	240	9181	593	이인제	민주당
충청남도	4400	예산군	72086	48521	48142	379	23565	283	이인제	민주당
충청남도	4400	당진군	106333	59106	58551	555	47227	1091	이인제	민주당
충청남도	4400	천안시	384145	223871	222796	1075	160274	14876	문국현	창조한국당
충청남도	4400	공주시	100441	60827	60206	621	39614	2732	문국현	창조한국당
충청남도	4400	보령시	85009	52590	51947	643	32419	1972	문국현	창조한국당
충청남도	4400	아산시	167540	94122	93533	589	73418	5165	문국현	창조한국당
충청남도	4400	서산시	115264	69287	68637	650	45977	3285	문국현	창조한국당
충청남도	4400	태안군	51230	31923	31464	459	19307	1331	문국현	창조한국당
충청남도	4400	금산군	46603	28558	28214	344	18045	956	문국현	창조한국당
충청남도	4400	연기군	63317	42235	41231	1004	21082	1943	문국현	창조한국당
충청남도	4400	논산시	102616	61078	60515	563	41538	2317	문국현	창조한국당
충청남도	4400	계룡시	25719	17187	17114	73	8532	1105	문국현	창조한국당
충청남도	4400	부여군	63526	39879	39381	498	23647	1417	문국현	창조한국당
충청남도	4400	서천군	50538	31927	31539	388	18611	946	문국현	창조한국당
충청남도	4400	홍성군	70470	44195	43742	453	26275	1497	문국현	창조한국당
충청남도	4400	청양군	27914	18733	18493	240	9181	514	문국현	창조한국당
충청남도	4400	예산군	72086	48521	48142	379	23565	825	문국현	창조한국당
충청남도	4400	당진군	106333	59106	58551	555	47227	2502	문국현	창조한국당
충청남도	4400	천안시	384145	223871	222796	1075	160274	196	정근모	참주인연합
충청남도	4400	공주시	100441	60827	60206	621	39614	54	정근모	참주인연합
충청남도	4400	보령시	85009	52590	51947	643	32419	85	정근모	참주인연합
충청남도	4400	아산시	167540	94122	93533	589	73418	67	정근모	참주인연합
충청남도	4400	서산시	115264	69287	68637	650	45977	57	정근모	참주인연합
충청남도	4400	태안군	51230	31923	31464	459	19307	41	정근모	참주인연합
충청남도	4400	금산군	46603	28558	28214	344	18045	41	정근모	참주인연합
충청남도	4400	연기군	63317	42235	41231	1004	21082	74	정근모	참주인연합
충청남도	4400	논산시	102616	61078	60515	563	41538	79	정근모	참주인연합
충청남도	4400	계룡시	25719	17187	17114	73	8532	9	정근모	참주인연합
충청남도	4400	부여군	63526	39879	39381	498	23647	52	정근모	참주인연합
충청남도	4400	서천군	50538	31927	31539	388	18611	42	정근모	참주인연합
충청남도	4400	홍성군	70470	44195	43742	453	26275	39	정근모	참주인연합
충청남도	4400	청양군	27914	18733	18493	240	9181	23	정근모	참주인연합
충청남도	4400	예산군	72086	48521	48142	379	23565	22	정근모	참주인연합
충청남도	4400	당진군	106333	59106	58551	555	47227	53	정근모	참주인연합
충청남도	4400	천안시	384145	223871	222796	1075	160274	972	허경영	경제공화당
충청남도	4400	공주시	100441	60827	60206	621	39614	262	허경영	경제공화당
충청남도	4400	보령시	85009	52590	51947	643	32419	190	허경영	경제공화당
충청남도	4400	아산시	167540	94122	93533	589	73418	477	허경영	경제공화당
충청남도	4400	서산시	115264	69287	68637	650	45977	350	허경영	경제공화당
충청남도	4400	태안군	51230	31923	31464	459	19307	137	허경영	경제공화당
충청남도	4400	금산군	46603	28558	28214	344	18045	115	허경영	경제공화당
충청남도	4400	연기군	63317	42235	41231	1004	21082	192	허경영	경제공화당
충청남도	4400	논산시	102616	61078	60515	563	41538	236	허경영	경제공화당
충청남도	4400	계룡시	25719	17187	17114	73	8532	60	허경영	경제공화당
충청남도	4400	부여군	63526	39879	39381	498	23647	141	허경영	경제공화당
충청남도	4400	서천군	50538	31927	31539	388	18611	95	허경영	경제공화당
충청남도	4400	홍성군	70470	44195	43742	453	26275	157	허경영	경제공화당
충청남도	4400	청양군	27914	18733	18493	240	9181	70	허경영	경제공화당
충청남도	4400	예산군	72086	48521	48142	379	23565	119	허경영	경제공화당
충청남도	4400	당진군	106333	59106	58551	555	47227	241	허경영	경제공화당
충청남도	4400	천안시	384145	223871	222796	1075	160274	65	전관	새시대참사람연합
충청남도	4400	공주시	100441	60827	60206	621	39614	37	전관	새시대참사람연합
충청남도	4400	보령시	85009	52590	51947	643	32419	40	전관	새시대참사람연합
충청남도	4400	아산시	167540	94122	93533	589	73418	28	전관	새시대참사람연합
충청남도	4400	서산시	115264	69287	68637	650	45977	41	전관	새시대참사람연합
충청남도	4400	태안군	51230	31923	31464	459	19307	28	전관	새시대참사람연합
충청남도	4400	금산군	46603	28558	28214	344	18045	27	전관	새시대참사람연합
충청남도	4400	연기군	63317	42235	41231	1004	21082	31	전관	새시대참사람연합
충청남도	4400	논산시	102616	61078	60515	563	41538	68	전관	새시대참사람연합
충청남도	4400	계룡시	25719	17187	17114	73	8532	14	전관	새시대참사람연합
충청남도	4400	부여군	63526	39879	39381	498	23647	64	전관	새시대참사람연합
충청남도	4400	서천군	50538	31927	31539	388	18611	29	전관	새시대참사람연합
충청남도	4400	홍성군	70470	44195	43742	453	26275	27	전관	새시대참사람연합
충청남도	4400	청양군	27914	18733	18493	240	9181	14	전관	새시대참사람연합
충청남도	4400	예산군	72086	48521	48142	379	23565	25	전관	새시대참사람연합
충청남도	4400	당진군	106333	59106	58551	555	47227	30	전관	새시대참사람연합
충청남도	4400	천안시	384145	223871	222796	1075	160274	218	금민	한국사회당
충청남도	4400	공주시	100441	60827	60206	621	39614	78	금민	한국사회당
충청남도	4400	보령시	85009	52590	51947	643	32419	79	금민	한국사회당
충청남도	4400	아산시	167540	94122	93533	589	73418	122	금민	한국사회당
충청남도	4400	서산시	115264	69287	68637	650	45977	69	금민	한국사회당
충청남도	4400	태안군	51230	31923	31464	459	19307	53	금민	한국사회당
충청남도	4400	금산군	46603	28558	28214	344	18045	42	금민	한국사회당
충청남도	4400	연기군	63317	42235	41231	1004	21082	50	금민	한국사회당
충청남도	4400	논산시	102616	61078	60515	563	41538	67	금민	한국사회당
충청남도	4400	계룡시	25719	17187	17114	73	8532	14	금민	한국사회당
충청남도	4400	부여군	63526	39879	39381	498	23647	75	금민	한국사회당
충청남도	4400	서천군	50538	31927	31539	388	18611	54	금민	한국사회당
충청남도	4400	홍성군	70470	44195	43742	453	26275	56	금민	한국사회당
충청남도	4400	청양군	27914	18733	18493	240	9181	37	금민	한국사회당
충청남도	4400	예산군	72086	48521	48142	379	23565	51	금민	한국사회당
충청남도	4400	당진군	106333	59106	58551	555	47227	66	금민	한국사회당
충청남도	4400	천안시	384145	223871	222796	1075	160274	58549	이회창	무소속
충청남도	4400	공주시	100441	60827	60206	621	39614	23789	이회창	무소속
충청남도	4400	보령시	85009	52590	51947	643	32419	19876	이회창	무소속
충청남도	4400	아산시	167540	94122	93533	589	73418	27337	이회창	무소속
충청남도	4400	서산시	115264	69287	68637	650	45977	20533	이회창	무소속
충청남도	4400	태안군	51230	31923	31464	459	19307	9836	이회창	무소속
충청남도	4400	금산군	46603	28558	28214	344	18045	7954	이회창	무소속
충청남도	4400	연기군	63317	42235	41231	1004	21082	15084	이회창	무소속
충청남도	4400	논산시	102616	61078	60515	563	41538	14230	이회창	무소속
충청남도	4400	계룡시	25719	17187	17114	73	8532	3873	이회창	무소속
충청남도	4400	부여군	63526	39879	39381	498	23647	13634	이회창	무소속
충청남도	4400	서천군	50538	31927	31539	388	18611	10144	이회창	무소속
충청남도	4400	홍성군	70470	44195	43742	453	26275	20133	이회창	무소속
충청남도	4400	청양군	27914	18733	18493	240	9181	8606	이회창	무소속
충청남도	4400	예산군	72086	48521	48142	379	23565	32227	이회창	무소속
충청남도	4400	당진군	106333	59106	58551	555	47227	18454	이회창	무소속
전라북도	4500	전주시완산구	255669	173723	173277	446	81946	140317	정동영	대통합민주신당
전라북도	4500	전주시덕진구	203973	138028	137685	343	65945	111433	정동영	대통합민주신당
전라북도	4500	군산시	198926	125277	124800	477	73649	96750	정동영	대통합민주신당
전라북도	4500	익산시	236123	151701	151125	576	84422	120624	정동영	대통합민주신당
전라북도	4500	정읍시	97592	65233	64756	477	32359	54890	정동영	대통합민주신당
전라북도	4500	남원시	69951	49456	49086	370	20495	42232	정동영	대통합민주신당
전라북도	4500	김제시	79810	54726	54381	345	25084	46019	정동영	대통합민주신당
전라북도	4500	완주군	65917	44710	44449	261	21207	36557	정동영	대통합민주신당
전라북도	4500	진안군	22970	16059	15901	158	6911	13276	정동영	대통합민주신당
전라북도	4500	무주군	21099	14660	14511	149	6439	11305	정동영	대통합민주신당
전라북도	4500	장수군	19853	14224	14065	159	5629	11614	정동영	대통합민주신당
전라북도	4500	임실군	26931	19427	19210	217	7504	16454	정동영	대통합민주신당
전라북도	4500	순창군	25208	19324	19120	204	5884	17343	정동영	대통합민주신당
전라북도	4500	고창군	50039	34236	33919	317	15803	28901	정동영	대통합민주신당
전라북도	4500	부안군	50995	36791	36167	624	14204	29521	정동영	대통합민주신당
전라북도	4500	전주시완산구	255669	173723	173277	446	81946	16560	이명박	한나라당
전라북도	4500	전주시덕진구	203973	138028	137685	343	65945	12304	이명박	한나라당
전라북도	4500	군산시	198926	125277	124800	477	73649	14338	이명박	한나라당
전라북도	4500	익산시	236123	151701	151125	576	84422	15429	이명박	한나라당
전라북도	4500	정읍시	97592	65233	64756	477	32359	4835	이명박	한나라당
전라북도	4500	남원시	69951	49456	49086	370	20495	3299	이명박	한나라당
전라북도	4500	김제시	79810	54726	54381	345	25084	4250	이명박	한나라당
전라북도	4500	완주군	65917	44710	44449	261	21207	3500	이명박	한나라당
전라북도	4500	진안군	22970	16059	15901	158	6911	1240	이명박	한나라당
전라북도	4500	무주군	21099	14660	14511	149	6439	1641	이명박	한나라당
전라북도	4500	장수군	19853	14224	14065	159	5629	1151	이명박	한나라당
전라북도	4500	임실군	26931	19427	19210	217	7504	1276	이명박	한나라당
전라북도	4500	순창군	25208	19324	19120	204	5884	771	이명박	한나라당
전라북도	4500	고창군	50039	34236	33919	317	15803	2308	이명박	한나라당
전라북도	4500	부안군	50995	36791	36167	624	14204	3247	이명박	한나라당
전라북도	4500	전주시완산구	255669	173723	173277	446	81946	2368	권영길	민주노동당
전라북도	4500	전주시덕진구	203973	138028	137685	343	65945	2839	권영길	민주노동당
전라북도	4500	군산시	198926	125277	124800	477	73649	3354	권영길	민주노동당
전라북도	4500	익산시	236123	151701	151125	576	84422	3235	권영길	민주노동당
전라북도	4500	정읍시	97592	65233	64756	477	32359	1231	권영길	민주노동당
전라북도	4500	남원시	69951	49456	49086	370	20495	613	권영길	민주노동당
전라북도	4500	김제시	79810	54726	54381	345	25084	772	권영길	민주노동당
전라북도	4500	완주군	65917	44710	44449	261	21207	1292	권영길	민주노동당
전라북도	4500	진안군	22970	16059	15901	158	6911	234	권영길	민주노동당
전라북도	4500	무주군	21099	14660	14511	149	6439	277	권영길	민주노동당
전라북도	4500	장수군	19853	14224	14065	159	5629	309	권영길	민주노동당
전라북도	4500	임실군	26931	19427	19210	217	7504	200	권영길	민주노동당
전라북도	4500	순창군	25208	19324	19120	204	5884	248	권영길	민주노동당
전라북도	4500	고창군	50039	34236	33919	317	15803	533	권영길	민주노동당
전라북도	4500	부안군	50995	36791	36167	624	14204	634	권영길	민주노동당
전라북도	4500	전주시완산구	255669	173723	173277	446	81946	1033	이인제	민주당
전라북도	4500	전주시덕진구	203973	138028	137685	343	65945	718	이인제	민주당
전라북도	4500	군산시	198926	125277	124800	477	73649	753	이인제	민주당
전라북도	4500	익산시	236123	151701	151125	576	84422	1360	이인제	민주당
전라북도	4500	정읍시	97592	65233	64756	477	32359	359	이인제	민주당
전라북도	4500	남원시	69951	49456	49086	370	20495	331	이인제	민주당
전라북도	4500	김제시	79810	54726	54381	345	25084	419	이인제	민주당
전라북도	4500	완주군	65917	44710	44449	261	21207	356	이인제	민주당
전라북도	4500	진안군	22970	16059	15901	158	6911	136	이인제	민주당
전라북도	4500	무주군	21099	14660	14511	149	6439	118	이인제	민주당
전라북도	4500	장수군	19853	14224	14065	159	5629	104	이인제	민주당
전라북도	4500	임실군	26931	19427	19210	217	7504	184	이인제	민주당
전라북도	4500	순창군	25208	19324	19120	204	5884	76	이인제	민주당
전라북도	4500	고창군	50039	34236	33919	317	15803	249	이인제	민주당
전라북도	4500	부안군	50995	36791	36167	624	14204	354	이인제	민주당
전라북도	4500	전주시완산구	255669	173723	173277	446	81946	6064	문국현	창조한국당
전라북도	4500	전주시덕진구	203973	138028	137685	343	65945	4877	문국현	창조한국당
전라북도	4500	군산시	198926	125277	124800	477	73649	4050	문국현	창조한국당
전라북도	4500	익산시	236123	151701	151125	576	84422	4571	문국현	창조한국당
전라북도	4500	정읍시	97592	65233	64756	477	32359	1291	문국현	창조한국당
전라북도	4500	남원시	69951	49456	49086	370	20495	856	문국현	창조한국당
전라북도	4500	김제시	79810	54726	54381	345	25084	1090	문국현	창조한국당
전라북도	4500	완주군	65917	44710	44449	261	21207	1016	문국현	창조한국당
전라북도	4500	진안군	22970	16059	15901	158	6911	319	문국현	창조한국당
전라북도	4500	무주군	21099	14660	14511	149	6439	315	문국현	창조한국당
전라북도	4500	장수군	19853	14224	14065	159	5629	227	문국현	창조한국당
전라북도	4500	임실군	26931	19427	19210	217	7504	250	문국현	창조한국당
전라북도	4500	순창군	25208	19324	19120	204	5884	149	문국현	창조한국당
전라북도	4500	고창군	50039	34236	33919	317	15803	559	문국현	창조한국당
전라북도	4500	부안군	50995	36791	36167	624	14204	939	문국현	창조한국당
전라북도	4500	전주시완산구	255669	173723	173277	446	81946	95	정근모	참주인연합
전라북도	4500	전주시덕진구	203973	138028	137685	343	65945	58	정근모	참주인연합
전라북도	4500	군산시	198926	125277	124800	477	73649	95	정근모	참주인연합
전라북도	4500	익산시	236123	151701	151125	576	84422	96	정근모	참주인연합
전라북도	4500	정읍시	97592	65233	64756	477	32359	25	정근모	참주인연합
전라북도	4500	남원시	69951	49456	49086	370	20495	18	정근모	참주인연합
전라북도	4500	김제시	79810	54726	54381	345	25084	29	정근모	참주인연합
전라북도	4500	완주군	65917	44710	44449	261	21207	31	정근모	참주인연합
전라북도	4500	진안군	22970	16059	15901	158	6911	14	정근모	참주인연합
전라북도	4500	무주군	21099	14660	14511	149	6439	12	정근모	참주인연합
전라북도	4500	장수군	19853	14224	14065	159	5629	2	정근모	참주인연합
전라북도	4500	임실군	26931	19427	19210	217	7504	13	정근모	참주인연합
전라북도	4500	순창군	25208	19324	19120	204	5884	12	정근모	참주인연합
전라북도	4500	고창군	50039	34236	33919	317	15803	26	정근모	참주인연합
전라북도	4500	부안군	50995	36791	36167	624	14204	64	정근모	참주인연합
전라북도	4500	전주시완산구	255669	173723	173277	446	81946	367	허경영	경제공화당
전라북도	4500	전주시덕진구	203973	138028	137685	343	65945	330	허경영	경제공화당
전라북도	4500	군산시	198926	125277	124800	477	73649	191	허경영	경제공화당
전라북도	4500	익산시	236123	151701	151125	576	84422	291	허경영	경제공화당
전라북도	4500	정읍시	97592	65233	64756	477	32359	100	허경영	경제공화당
전라북도	4500	남원시	69951	49456	49086	370	20495	56	허경영	경제공화당
전라북도	4500	김제시	79810	54726	54381	345	25084	75	허경영	경제공화당
전라북도	4500	완주군	65917	44710	44449	261	21207	91	허경영	경제공화당
전라북도	4500	진안군	22970	16059	15901	158	6911	38	허경영	경제공화당
전라북도	4500	무주군	21099	14660	14511	149	6439	37	허경영	경제공화당
전라북도	4500	장수군	19853	14224	14065	159	5629	29	허경영	경제공화당
전라북도	4500	임실군	26931	19427	19210	217	7504	21	허경영	경제공화당
전라북도	4500	순창군	25208	19324	19120	204	5884	20	허경영	경제공화당
전라북도	4500	고창군	50039	34236	33919	317	15803	51	허경영	경제공화당
전라북도	4500	부안군	50995	36791	36167	624	14204	80	허경영	경제공화당
전라북도	4500	전주시완산구	255669	173723	173277	446	81946	19	전관	새시대참사람연합
전라북도	4500	전주시덕진구	203973	138028	137685	343	65945	16	전관	새시대참사람연합
전라북도	4500	군산시	198926	125277	124800	477	73649	17	전관	새시대참사람연합
전라북도	4500	익산시	236123	151701	151125	576	84422	34	전관	새시대참사람연합
전라북도	4500	정읍시	97592	65233	64756	477	32359	16	전관	새시대참사람연합
전라북도	4500	남원시	69951	49456	49086	370	20495	14	전관	새시대참사람연합
전라북도	4500	김제시	79810	54726	54381	345	25084	16	전관	새시대참사람연합
전라북도	4500	완주군	65917	44710	44449	261	21207	16	전관	새시대참사람연합
전라북도	4500	진안군	22970	16059	15901	158	6911	13	전관	새시대참사람연합
전라북도	4500	무주군	21099	14660	14511	149	6439	7	전관	새시대참사람연합
전라북도	4500	장수군	19853	14224	14065	159	5629	12	전관	새시대참사람연합
전라북도	4500	임실군	26931	19427	19210	217	7504	17	전관	새시대참사람연합
전라북도	4500	순창군	25208	19324	19120	204	5884	9	전관	새시대참사람연합
전라북도	4500	고창군	50039	34236	33919	317	15803	19	전관	새시대참사람연합
전라북도	4500	부안군	50995	36791	36167	624	14204	45	전관	새시대참사람연합
전라북도	4500	전주시완산구	255669	173723	173277	446	81946	62	금민	한국사회당
전라북도	4500	전주시덕진구	203973	138028	137685	343	65945	49	금민	한국사회당
전라북도	4500	군산시	198926	125277	124800	477	73649	49	금민	한국사회당
전라북도	4500	익산시	236123	151701	151125	576	84422	78	금민	한국사회당
전라북도	4500	정읍시	97592	65233	64756	477	32359	36	금민	한국사회당
전라북도	4500	남원시	69951	49456	49086	370	20495	38	금민	한국사회당
전라북도	4500	김제시	79810	54726	54381	345	25084	36	금민	한국사회당
전라북도	4500	완주군	65917	44710	44449	261	21207	40	금민	한국사회당
전라북도	4500	진안군	22970	16059	15901	158	6911	15	금민	한국사회당
전라북도	4500	무주군	21099	14660	14511	149	6439	10	금민	한국사회당
전라북도	4500	장수군	19853	14224	14065	159	5629	15	금민	한국사회당
전라북도	4500	임실군	26931	19427	19210	217	7504	20	금민	한국사회당
전라북도	4500	순창군	25208	19324	19120	204	5884	15	금민	한국사회당
전라북도	4500	고창군	50039	34236	33919	317	15803	36	금민	한국사회당
전라북도	4500	부안군	50995	36791	36167	624	14204	39	금민	한국사회당
전라북도	4500	전주시완산구	255669	173723	173277	446	81946	6392	이회창	무소속
전라북도	4500	전주시덕진구	203973	138028	137685	343	65945	5061	이회창	무소속
전라북도	4500	군산시	198926	125277	124800	477	73649	5203	이회창	무소속
전라북도	4500	익산시	236123	151701	151125	576	84422	5407	이회창	무소속
전라북도	4500	정읍시	97592	65233	64756	477	32359	1973	이회창	무소속
전라북도	4500	남원시	69951	49456	49086	370	20495	1629	이회창	무소속
전라북도	4500	김제시	79810	54726	54381	345	25084	1675	이회창	무소속
전라북도	4500	완주군	65917	44710	44449	261	21207	1550	이회창	무소속
전라북도	4500	진안군	22970	16059	15901	158	6911	616	이회창	무소속
전라북도	4500	무주군	21099	14660	14511	149	6439	789	이회창	무소속
전라북도	4500	장수군	19853	14224	14065	159	5629	602	이회창	무소속
전라북도	4500	임실군	26931	19427	19210	217	7504	775	이회창	무소속
전라북도	4500	순창군	25208	19324	19120	204	5884	477	이회창	무소속
전라북도	4500	고창군	50039	34236	33919	317	15803	1237	이회창	무소속
전라북도	4500	부안군	50995	36791	36167	624	14204	1244	이회창	무소속
전라남도	4600	목포시	179160	104320	103913	407	74840	83225	정동영	대통합민주신당
전라남도	4600	여수시	223347	139798	139086	712	83549	109765	정동영	대통합민주신당
전라남도	4600	순천시	196303	125839	125229	610	70464	97384	정동영	대통합민주신당
전라남도	4600	나주시	77930	51998	51486	512	25932	41506	정동영	대통합민주신당
전라남도	4600	광양시	98340	62793	62489	304	35547	43204	정동영	대통합민주신당
전라남도	4600	담양군	41587	28834	28578	256	12753	23872	정동영	대통합민주신당
전라남도	4600	장성군	38966	29003	28565	438	9963	22841	정동영	대통합민주신당
전라남도	4600	곡성군	27604	19181	18954	227	8423	15521	정동영	대통합민주신당
전라남도	4600	구례군	23231	16090	15950	140	7141	12480	정동영	대통합민주신당
전라남도	4600	고흥군	66681	44303	43769	534	22378	34207	정동영	대통합민주신당
전라남도	4600	보성군	42498	28000	27682	318	14498	20610	정동영	대통합민주신당
전라남도	4600	화순군	55659	35684	35420	264	19975	28138	정동영	대통합민주신당
전라남도	4600	장흥군	35526	26481	25992	489	9045	19730	정동영	대통합민주신당
전라남도	4600	강진군	33693	22087	21867	220	11606	16564	정동영	대통합민주신당
전라남도	4600	완도군	46449	30496	30129	367	15953	24615	정동영	대통합민주신당
전라남도	4600	해남군	67227	45542	44683	859	21685	35193	정동영	대통합민주신당
전라남도	4600	진도군	29034	18856	18617	239	10178	15164	정동영	대통합민주신당
전라남도	4600	영암군	47590	31323	30965	358	16267	24145	정동영	대통합민주신당
전라남도	4600	무안군	51219	32718	32371	347	18501	26267	정동영	대통합민주신당
전라남도	4600	영광군	47268	32207	31785	422	15061	25768	정동영	대통합민주신당
전라남도	4600	함평군	31915	22101	21800	301	9814	17937	정동영	대통합민주신당
전라남도	4600	신안군	39604	23807	23521	286	15797	19173	정동영	대통합민주신당
전라남도	4600	목포시	179160	104320	103913	407	74840	9604	이명박	한나라당
전라남도	4600	여수시	223347	139798	139086	712	83549	13489	이명박	한나라당
전라남도	4600	순천시	196303	125839	125229	610	70464	12177	이명박	한나라당
전라남도	4600	나주시	77930	51998	51486	512	25932	3920	이명박	한나라당
전라남도	4600	광양시	98340	62793	62489	304	35547	9013	이명박	한나라당
전라남도	4600	담양군	41587	28834	28578	256	12753	1974	이명박	한나라당
전라남도	4600	장성군	38966	29003	28565	438	9963	2500	이명박	한나라당
전라남도	4600	곡성군	27604	19181	18954	227	8423	1247	이명박	한나라당
전라남도	4600	구례군	23231	16090	15950	140	7141	1448	이명박	한나라당
전라남도	4600	고흥군	66681	44303	43769	534	22378	4003	이명박	한나라당
전라남도	4600	보성군	42498	28000	27682	318	14498	3213	이명박	한나라당
전라남도	4600	화순군	55659	35684	35420	264	19975	2632	이명박	한나라당
전라남도	4600	장흥군	35526	26481	25992	489	9045	2216	이명박	한나라당
전라남도	4600	강진군	33693	22087	21867	220	11606	2265	이명박	한나라당
전라남도	4600	완도군	46449	30496	30129	367	15953	2132	이명박	한나라당
전라남도	4600	해남군	67227	45542	44683	859	21685	3535	이명박	한나라당
전라남도	4600	진도군	29034	18856	18617	239	10178	1598	이명박	한나라당
전라남도	4600	영암군	47590	31323	30965	358	16267	3031	이명박	한나라당
전라남도	4600	무안군	51219	32718	32371	347	18501	2703	이명박	한나라당
전라남도	4600	영광군	47268	32207	31785	422	15061	2466	이명박	한나라당
전라남도	4600	함평군	31915	22101	21800	301	9814	1643	이명박	한나라당
전라남도	4600	신안군	39604	23807	23521	286	15797	2025	이명박	한나라당
전라남도	4600	목포시	179160	104320	103913	407	74840	2164	권영길	민주노동당
전라남도	4600	여수시	223347	139798	139086	712	83549	3047	권영길	민주노동당
전라남도	4600	순천시	196303	125839	125229	610	70464	3102	권영길	민주노동당
전라남도	4600	나주시	77930	51998	51486	512	25932	1204	권영길	민주노동당
전라남도	4600	광양시	98340	62793	62489	304	35547	2031	권영길	민주노동당
전라남도	4600	담양군	41587	28834	28578	256	12753	436	권영길	민주노동당
전라남도	4600	장성군	38966	29003	28565	438	9963	411	권영길	민주노동당
전라남도	4600	곡성군	27604	19181	18954	227	8423	618	권영길	민주노동당
전라남도	4600	구례군	23231	16090	15950	140	7141	539	권영길	민주노동당
전라남도	4600	고흥군	66681	44303	43769	534	22378	658	권영길	민주노동당
전라남도	4600	보성군	42498	28000	27682	318	14498	744	권영길	민주노동당
전라남도	4600	화순군	55659	35684	35420	264	19975	1099	권영길	민주노동당
전라남도	4600	장흥군	35526	26481	25992	489	9045	960	권영길	민주노동당
전라남도	4600	강진군	33693	22087	21867	220	11606	689	권영길	민주노동당
전라남도	4600	완도군	46449	30496	30129	367	15953	511	권영길	민주노동당
전라남도	4600	해남군	67227	45542	44683	859	21685	1176	권영길	민주노동당
전라남도	4600	진도군	29034	18856	18617	239	10178	344	권영길	민주노동당
전라남도	4600	영암군	47590	31323	30965	358	16267	1136	권영길	민주노동당
전라남도	4600	무안군	51219	32718	32371	347	18501	727	권영길	민주노동당
전라남도	4600	영광군	47268	32207	31785	422	15061	861	권영길	민주노동당
전라남도	4600	함평군	31915	22101	21800	301	9814	305	권영길	민주노동당
전라남도	4600	신안군	39604	23807	23521	286	15797	416	권영길	민주노동당
전라남도	4600	목포시	179160	104320	103913	407	74840	1518	이인제	민주당
전라남도	4600	여수시	223347	139798	139086	712	83549	2197	이인제	민주당
전라남도	4600	순천시	196303	125839	125229	610	70464	1995	이인제	민주당
전라남도	4600	나주시	77930	51998	51486	512	25932	1713	이인제	민주당
전라남도	4600	광양시	98340	62793	62489	304	35547	1130	이인제	민주당
전라남도	4600	담양군	41587	28834	28578	256	12753	519	이인제	민주당
전라남도	4600	장성군	38966	29003	28565	438	9963	589	이인제	민주당
전라남도	4600	곡성군	27604	19181	18954	227	8423	480	이인제	민주당
전라남도	4600	구례군	23231	16090	15950	140	7141	370	이인제	민주당
전라남도	4600	고흥군	66681	44303	43769	534	22378	2401	이인제	민주당
전라남도	4600	보성군	42498	28000	27682	318	14498	1033	이인제	민주당
전라남도	4600	화순군	55659	35684	35420	264	19975	923	이인제	민주당
전라남도	4600	장흥군	35526	26481	25992	489	9045	884	이인제	민주당
전라남도	4600	강진군	33693	22087	21867	220	11606	673	이인제	민주당
전라남도	4600	완도군	46449	30496	30129	367	15953	1171	이인제	민주당
전라남도	4600	해남군	67227	45542	44683	859	21685	1782	이인제	민주당
전라남도	4600	진도군	29034	18856	18617	239	10178	413	이인제	민주당
전라남도	4600	영암군	47590	31323	30965	358	16267	687	이인제	민주당
전라남도	4600	무안군	51219	32718	32371	347	18501	859	이인제	민주당
전라남도	4600	영광군	47268	32207	31785	422	15061	471	이인제	민주당
전라남도	4600	함평군	31915	22101	21800	301	9814	640	이인제	민주당
전라남도	4600	신안군	39604	23807	23521	286	15797	626	이인제	민주당
전라남도	4600	목포시	179160	104320	103913	407	74840	3800	문국현	창조한국당
전라남도	4600	여수시	223347	139798	139086	712	83549	5159	문국현	창조한국당
전라남도	4600	순천시	196303	125839	125229	610	70464	5283	문국현	창조한국당
전라남도	4600	나주시	77930	51998	51486	512	25932	1426	문국현	창조한국당
전라남도	4600	광양시	98340	62793	62489	304	35547	3085	문국현	창조한국당
전라남도	4600	담양군	41587	28834	28578	256	12753	665	문국현	창조한국당
전라남도	4600	장성군	38966	29003	28565	438	9963	898	문국현	창조한국당
전라남도	4600	곡성군	27604	19181	18954	227	8423	348	문국현	창조한국당
전라남도	4600	구례군	23231	16090	15950	140	7141	375	문국현	창조한국당
전라남도	4600	고흥군	66681	44303	43769	534	22378	870	문국현	창조한국당
전라남도	4600	보성군	42498	28000	27682	318	14498	867	문국현	창조한국당
전라남도	4600	화순군	55659	35684	35420	264	19975	1214	문국현	창조한국당
전라남도	4600	장흥군	35526	26481	25992	489	9045	939	문국현	창조한국당
전라남도	4600	강진군	33693	22087	21867	220	11606	601	문국현	창조한국당
전라남도	4600	완도군	46449	30496	30129	367	15953	613	문국현	창조한국당
전라남도	4600	해남군	67227	45542	44683	859	21685	1259	문국현	창조한국당
전라남도	4600	진도군	29034	18856	18617	239	10178	412	문국현	창조한국당
전라남도	4600	영암군	47590	31323	30965	358	16267	886	문국현	창조한국당
전라남도	4600	무안군	51219	32718	32371	347	18501	757	문국현	창조한국당
전라남도	4600	영광군	47268	32207	31785	422	15061	796	문국현	창조한국당
전라남도	4600	함평군	31915	22101	21800	301	9814	526	문국현	창조한국당
전라남도	4600	신안군	39604	23807	23521	286	15797	510	문국현	창조한국당
전라남도	4600	목포시	179160	104320	103913	407	74840	64	정근모	참주인연합
전라남도	4600	여수시	223347	139798	139086	712	83549	82	정근모	참주인연합
전라남도	4600	순천시	196303	125839	125229	610	70464	72	정근모	참주인연합
전라남도	4600	나주시	77930	51998	51486	512	25932	35	정근모	참주인연합
전라남도	4600	광양시	98340	62793	62489	304	35547	51	정근모	참주인연합
전라남도	4600	담양군	41587	28834	28578	256	12753	28	정근모	참주인연합
전라남도	4600	장성군	38966	29003	28565	438	9963	184	정근모	참주인연합
전라남도	4600	곡성군	27604	19181	18954	227	8423	17	정근모	참주인연합
전라남도	4600	구례군	23231	16090	15950	140	7141	17	정근모	참주인연합
전라남도	4600	고흥군	66681	44303	43769	534	22378	22	정근모	참주인연합
전라남도	4600	보성군	42498	28000	27682	318	14498	32	정근모	참주인연합
전라남도	4600	화순군	55659	35684	35420	264	19975	18	정근모	참주인연합
전라남도	4600	장흥군	35526	26481	25992	489	9045	60	정근모	참주인연합
전라남도	4600	강진군	33693	22087	21867	220	11606	19	정근모	참주인연합
전라남도	4600	완도군	46449	30496	30129	367	15953	26	정근모	참주인연합
전라남도	4600	해남군	67227	45542	44683	859	21685	67	정근모	참주인연합
전라남도	4600	진도군	29034	18856	18617	239	10178	14	정근모	참주인연합
전라남도	4600	영암군	47590	31323	30965	358	16267	20	정근모	참주인연합
전라남도	4600	무안군	51219	32718	32371	347	18501	35	정근모	참주인연합
전라남도	4600	영광군	47268	32207	31785	422	15061	32	정근모	참주인연합
전라남도	4600	함평군	31915	22101	21800	301	9814	17	정근모	참주인연합
전라남도	4600	신안군	39604	23807	23521	286	15797	26	정근모	참주인연합
전라남도	4600	목포시	179160	104320	103913	407	74840	200	허경영	경제공화당
전라남도	4600	여수시	223347	139798	139086	712	83549	402	허경영	경제공화당
전라남도	4600	순천시	196303	125839	125229	610	70464	263	허경영	경제공화당
전라남도	4600	나주시	77930	51998	51486	512	25932	108	허경영	경제공화당
전라남도	4600	광양시	98340	62793	62489	304	35547	201	허경영	경제공화당
전라남도	4600	담양군	41587	28834	28578	256	12753	55	허경영	경제공화당
전라남도	4600	장성군	38966	29003	28565	438	9963	77	허경영	경제공화당
전라남도	4600	곡성군	27604	19181	18954	227	8423	40	허경영	경제공화당
전라남도	4600	구례군	23231	16090	15950	140	7141	44	허경영	경제공화당
전라남도	4600	고흥군	66681	44303	43769	534	22378	54	허경영	경제공화당
전라남도	4600	보성군	42498	28000	27682	318	14498	68	허경영	경제공화당
전라남도	4600	화순군	55659	35684	35420	264	19975	75	허경영	경제공화당
전라남도	4600	장흥군	35526	26481	25992	489	9045	149	허경영	경제공화당
전라남도	4600	강진군	33693	22087	21867	220	11606	44	허경영	경제공화당
전라남도	4600	완도군	46449	30496	30129	367	15953	45	허경영	경제공화당
전라남도	4600	해남군	67227	45542	44683	859	21685	99	허경영	경제공화당
전라남도	4600	진도군	29034	18856	18617	239	10178	33	허경영	경제공화당
전라남도	4600	영암군	47590	31323	30965	358	16267	61	허경영	경제공화당
전라남도	4600	무안군	51219	32718	32371	347	18501	51	허경영	경제공화당
전라남도	4600	영광군	47268	32207	31785	422	15061	49	허경영	경제공화당
전라남도	4600	함평군	31915	22101	21800	301	9814	37	허경영	경제공화당
전라남도	4600	신안군	39604	23807	23521	286	15797	24	허경영	경제공화당
전라남도	4600	목포시	179160	104320	103913	407	74840	19	전관	새시대참사람연합
전라남도	4600	여수시	223347	139798	139086	712	83549	37	전관	새시대참사람연합
전라남도	4600	순천시	196303	125839	125229	610	70464	37	전관	새시대참사람연합
전라남도	4600	나주시	77930	51998	51486	512	25932	37	전관	새시대참사람연합
전라남도	4600	광양시	98340	62793	62489	304	35547	14	전관	새시대참사람연합
전라남도	4600	담양군	41587	28834	28578	256	12753	13	전관	새시대참사람연합
전라남도	4600	장성군	38966	29003	28565	438	9963	19	전관	새시대참사람연합
전라남도	4600	곡성군	27604	19181	18954	227	8423	17	전관	새시대참사람연합
전라남도	4600	구례군	23231	16090	15950	140	7141	6	전관	새시대참사람연합
전라남도	4600	고흥군	66681	44303	43769	534	22378	28	전관	새시대참사람연합
전라남도	4600	보성군	42498	28000	27682	318	14498	17	전관	새시대참사람연합
전라남도	4600	화순군	55659	35684	35420	264	19975	22	전관	새시대참사람연합
전라남도	4600	장흥군	35526	26481	25992	489	9045	39	전관	새시대참사람연합
전라남도	4600	강진군	33693	22087	21867	220	11606	14	전관	새시대참사람연합
전라남도	4600	완도군	46449	30496	30129	367	15953	18	전관	새시대참사람연합
전라남도	4600	해남군	67227	45542	44683	859	21685	43	전관	새시대참사람연합
전라남도	4600	진도군	29034	18856	18617	239	10178	9	전관	새시대참사람연합
전라남도	4600	영암군	47590	31323	30965	358	16267	15	전관	새시대참사람연합
전라남도	4600	무안군	51219	32718	32371	347	18501	16	전관	새시대참사람연합
전라남도	4600	영광군	47268	32207	31785	422	15061	55	전관	새시대참사람연합
전라남도	4600	함평군	31915	22101	21800	301	9814	27	전관	새시대참사람연합
전라남도	4600	신안군	39604	23807	23521	286	15797	15	전관	새시대참사람연합
전라남도	4600	목포시	179160	104320	103913	407	74840	64	금민	한국사회당
전라남도	4600	여수시	223347	139798	139086	712	83549	70	금민	한국사회당
전라남도	4600	순천시	196303	125839	125229	610	70464	65	금민	한국사회당
전라남도	4600	나주시	77930	51998	51486	512	25932	37	금민	한국사회당
전라남도	4600	광양시	98340	62793	62489	304	35547	24	금민	한국사회당
전라남도	4600	담양군	41587	28834	28578	256	12753	24	금민	한국사회당
전라남도	4600	장성군	38966	29003	28565	438	9963	17	금민	한국사회당
전라남도	4600	곡성군	27604	19181	18954	227	8423	12	금민	한국사회당
전라남도	4600	구례군	23231	16090	15950	140	7141	15	금민	한국사회당
전라남도	4600	고흥군	66681	44303	43769	534	22378	35	금민	한국사회당
전라남도	4600	보성군	42498	28000	27682	318	14498	42	금민	한국사회당
전라남도	4600	화순군	55659	35684	35420	264	19975	38	금민	한국사회당
전라남도	4600	장흥군	35526	26481	25992	489	9045	29	금민	한국사회당
전라남도	4600	강진군	33693	22087	21867	220	11606	22	금민	한국사회당
전라남도	4600	완도군	46449	30496	30129	367	15953	21	금민	한국사회당
전라남도	4600	해남군	67227	45542	44683	859	21685	42	금민	한국사회당
전라남도	4600	진도군	29034	18856	18617	239	10178	16	금민	한국사회당
전라남도	4600	영암군	47590	31323	30965	358	16267	17	금민	한국사회당
전라남도	4600	무안군	51219	32718	32371	347	18501	29	금민	한국사회당
전라남도	4600	영광군	47268	32207	31785	422	15061	83	금민	한국사회당
전라남도	4600	함평군	31915	22101	21800	301	9814	20	금민	한국사회당
전라남도	4600	신안군	39604	23807	23521	286	15797	21	금민	한국사회당
전라남도	4600	목포시	179160	104320	103913	407	74840	3255	이회창	무소속
전라남도	4600	여수시	223347	139798	139086	712	83549	4838	이회창	무소속
전라남도	4600	순천시	196303	125839	125229	610	70464	4851	이회창	무소속
전라남도	4600	나주시	77930	51998	51486	512	25932	1500	이회창	무소속
전라남도	4600	광양시	98340	62793	62489	304	35547	3736	이회창	무소속
전라남도	4600	담양군	41587	28834	28578	256	12753	992	이회창	무소속
전라남도	4600	장성군	38966	29003	28565	438	9963	1029	이회창	무소속
전라남도	4600	곡성군	27604	19181	18954	227	8423	654	이회창	무소속
전라남도	4600	구례군	23231	16090	15950	140	7141	656	이회창	무소속
전라남도	4600	고흥군	66681	44303	43769	534	22378	1491	이회창	무소속
전라남도	4600	보성군	42498	28000	27682	318	14498	1056	이회창	무소속
전라남도	4600	화순군	55659	35684	35420	264	19975	1261	이회창	무소속
전라남도	4600	장흥군	35526	26481	25992	489	9045	986	이회창	무소속
전라남도	4600	강진군	33693	22087	21867	220	11606	976	이회창	무소속
전라남도	4600	완도군	46449	30496	30129	367	15953	977	이회창	무소속
전라남도	4600	해남군	67227	45542	44683	859	21685	1487	이회창	무소속
전라남도	4600	진도군	29034	18856	18617	239	10178	614	이회창	무소속
전라남도	4600	영암군	47590	31323	30965	358	16267	967	이회창	무소속
전라남도	4600	무안군	51219	32718	32371	347	18501	927	이회창	무소속
전라남도	4600	영광군	47268	32207	31785	422	15061	1204	이회창	무소속
전라남도	4600	함평군	31915	22101	21800	301	9814	648	이회창	무소속
전라남도	4600	신안군	39604	23807	23521	286	15797	685	이회창	무소속
경상북도	4700	포항시북구	191990	140685	140060	625	51305	6757	정동영	대통합민주신당
경상북도	4700	포항시남구	193356	136640	135905	735	56716	8910	정동영	대통합민주신당
경상북도	4700	울릉군	8561	5834	5793	41	2727	554	정동영	대통합민주신당
경상북도	4700	경주시	211623	145887	144872	1015	65736	8968	정동영	대통합민주신당
경상북도	4700	김천시	109767	74936	74267	669	34831	4707	정동영	대통합민주신당
경상북도	4700	안동시	133566	90343	89321	1022	43223	6599	정동영	대통합민주신당
경상북도	4700	구미시	280481	172422	171658	764	108059	12743	정동영	대통합민주신당
경상북도	4700	영주시	91618	63686	63067	619	27932	4704	정동영	대통합민주신당
경상북도	4700	영천시	86531	60974	59998	976	25557	4348	정동영	대통합민주신당
경상북도	4700	상주시	87304	62722	61891	831	24582	4321	정동영	대통합민주신당
경상북도	4700	문경시	61373	43068	42582	486	18305	2834	정동영	대통합민주신당
경상북도	4700	예천군	41837	29903	29383	520	11934	2282	정동영	대통합민주신당
경상북도	4700	경산시	181228	117751	117185	566	63477	7775	정동영	대통합민주신당
경상북도	4700	청도군	39106	29630	29093	537	9476	1885	정동영	대통합민주신당
경상북도	4700	고령군	28742	19990	19723	267	8752	1462	정동영	대통합민주신당
경상북도	4700	성주군	38277	26370	26050	320	11907	1691	정동영	대통합민주신당
경상북도	4700	칠곡군	85733	53075	52716	359	32658	4147	정동영	대통합민주신당
경상북도	4700	군위군	22558	16452	16234	218	6106	1047	정동영	대통합민주신당
경상북도	4700	의성군	53346	38182	37701	481	15164	2517	정동영	대통합민주신당
경상북도	4700	청송군	23708	17932	17566	366	5776	1571	정동영	대통합민주신당
경상북도	4700	영양군	16408	11710	11530	180	4698	1120	정동영	대통합민주신당
경상북도	4700	영덕군	36879	27649	27259	390	9230	1377	정동영	대통합민주신당
경상북도	4700	봉화군	29972	21290	20912	378	8682	1812	정동영	대통합민주신당
경상북도	4700	울진군	43430	30078	29706	372	13352	2691	정동영	대통합민주신당
경상북도	4700	포항시북구	191990	140685	140060	625	51305	118169	이명박	한나라당
경상북도	4700	포항시남구	193356	136640	135905	735	56716	108775	이명박	한나라당
경상북도	4700	울릉군	8561	5834	5793	41	2727	4342	이명박	한나라당
경상북도	4700	경주시	211623	145887	144872	1015	65736	107948	이명박	한나라당
경상북도	4700	김천시	109767	74936	74267	669	34831	50908	이명박	한나라당
경상북도	4700	안동시	133566	90343	89321	1022	43223	59978	이명박	한나라당
경상북도	4700	구미시	280481	172422	171658	764	108059	114803	이명박	한나라당
경상북도	4700	영주시	91618	63686	63067	619	27932	43029	이명박	한나라당
경상북도	4700	영천시	86531	60974	59998	976	25557	44263	이명박	한나라당
경상북도	4700	상주시	87304	62722	61891	831	24582	44152	이명박	한나라당
경상북도	4700	문경시	61373	43068	42582	486	18305	30867	이명박	한나라당
경상북도	4700	예천군	41837	29903	29383	520	11934	20464	이명박	한나라당
경상북도	4700	경산시	181228	117751	117185	566	63477	79438	이명박	한나라당
경상북도	4700	청도군	39106	29630	29093	537	9476	20077	이명박	한나라당
경상북도	4700	고령군	28742	19990	19723	267	8752	13420	이명박	한나라당
경상북도	4700	성주군	38277	26370	26050	320	11907	18615	이명박	한나라당
경상북도	4700	칠곡군	85733	53075	52716	359	32658	35502	이명박	한나라당
경상북도	4700	군위군	22558	16452	16234	218	6106	12147	이명박	한나라당
경상북도	4700	의성군	53346	38182	37701	481	15164	27525	이명박	한나라당
경상북도	4700	청송군	23708	17932	17566	366	5776	12422	이명박	한나라당
경상북도	4700	영양군	16408	11710	11530	180	4698	8199	이명박	한나라당
경상북도	4700	영덕군	36879	27649	27259	390	9230	23129	이명박	한나라당
경상북도	4700	봉화군	29972	21290	20912	378	8682	13981	이명박	한나라당
경상북도	4700	울진군	43430	30078	29706	372	13352	21804	이명박	한나라당
경상북도	4700	포항시북구	191990	140685	140060	625	51305	2678	권영길	민주노동당
경상북도	4700	포항시남구	193356	136640	135905	735	56716	3355	권영길	민주노동당
경상북도	4700	울릉군	8561	5834	5793	41	2727	99	권영길	민주노동당
경상북도	4700	경주시	211623	145887	144872	1015	65736	6366	권영길	민주노동당
경상북도	4700	김천시	109767	74936	74267	669	34831	1533	권영길	민주노동당
경상북도	4700	안동시	133566	90343	89321	1022	43223	2829	권영길	민주노동당
경상북도	4700	구미시	280481	172422	171658	764	108059	4386	권영길	민주노동당
경상북도	4700	영주시	91618	63686	63067	619	27932	1813	권영길	민주노동당
경상북도	4700	영천시	86531	60974	59998	976	25557	1499	권영길	민주노동당
경상북도	4700	상주시	87304	62722	61891	831	24582	1712	권영길	민주노동당
경상북도	4700	문경시	61373	43068	42582	486	18305	856	권영길	민주노동당
경상북도	4700	예천군	41837	29903	29383	520	11934	880	권영길	민주노동당
경상북도	4700	경산시	181228	117751	117185	566	63477	3164	권영길	민주노동당
경상북도	4700	청도군	39106	29630	29093	537	9476	726	권영길	민주노동당
경상북도	4700	고령군	28742	19990	19723	267	8752	635	권영길	민주노동당
경상북도	4700	성주군	38277	26370	26050	320	11907	666	권영길	민주노동당
경상북도	4700	칠곡군	85733	53075	52716	359	32658	1286	권영길	민주노동당
경상북도	4700	군위군	22558	16452	16234	218	6106	394	권영길	민주노동당
경상북도	4700	의성군	53346	38182	37701	481	15164	1493	권영길	민주노동당
경상북도	4700	청송군	23708	17932	17566	366	5776	609	권영길	민주노동당
경상북도	4700	영양군	16408	11710	11530	180	4698	440	권영길	민주노동당
경상북도	4700	영덕군	36879	27649	27259	390	9230	482	권영길	민주노동당
경상북도	4700	봉화군	29972	21290	20912	378	8682	819	권영길	민주노동당
경상북도	4700	울진군	43430	30078	29706	372	13352	607	권영길	민주노동당
경상북도	4700	포항시북구	191990	140685	140060	625	51305	148	이인제	민주당
경상북도	4700	포항시남구	193356	136640	135905	735	56716	248	이인제	민주당
경상북도	4700	울릉군	8561	5834	5793	41	2727	14	이인제	민주당
경상북도	4700	경주시	211623	145887	144872	1015	65736	342	이인제	민주당
경상북도	4700	김천시	109767	74936	74267	669	34831	234	이인제	민주당
경상북도	4700	안동시	133566	90343	89321	1022	43223	222	이인제	민주당
경상북도	4700	구미시	280481	172422	171658	764	108059	381	이인제	민주당
경상북도	4700	영주시	91618	63686	63067	619	27932	229	이인제	민주당
경상북도	4700	영천시	86531	60974	59998	976	25557	244	이인제	민주당
경상북도	4700	상주시	87304	62722	61891	831	24582	251	이인제	민주당
경상북도	4700	문경시	61373	43068	42582	486	18305	158	이인제	민주당
경상북도	4700	예천군	41837	29903	29383	520	11934	101	이인제	민주당
경상북도	4700	경산시	181228	117751	117185	566	63477	231	이인제	민주당
경상북도	4700	청도군	39106	29630	29093	537	9476	130	이인제	민주당
경상북도	4700	고령군	28742	19990	19723	267	8752	67	이인제	민주당
경상북도	4700	성주군	38277	26370	26050	320	11907	93	이인제	민주당
경상북도	4700	칠곡군	85733	53075	52716	359	32658	142	이인제	민주당
경상북도	4700	군위군	22558	16452	16234	218	6106	58	이인제	민주당
경상북도	4700	의성군	53346	38182	37701	481	15164	147	이인제	민주당
경상북도	4700	청송군	23708	17932	17566	366	5776	89	이인제	민주당
경상북도	4700	영양군	16408	11710	11530	180	4698	48	이인제	민주당
경상북도	4700	영덕군	36879	27649	27259	390	9230	52	이인제	민주당
경상북도	4700	봉화군	29972	21290	20912	378	8682	103	이인제	민주당
경상북도	4700	울진군	43430	30078	29706	372	13352	91	이인제	민주당
경상북도	4700	포항시북구	191990	140685	140060	625	51305	3852	문국현	창조한국당
경상북도	4700	포항시남구	193356	136640	135905	735	56716	4433	문국현	창조한국당
경상북도	4700	울릉군	8561	5834	5793	41	2727	162	문국현	창조한국당
경상북도	4700	경주시	211623	145887	144872	1015	65736	4498	문국현	창조한국당
경상북도	4700	김천시	109767	74936	74267	669	34831	2882	문국현	창조한국당
경상북도	4700	안동시	133566	90343	89321	1022	43223	3256	문국현	창조한국당
경상북도	4700	구미시	280481	172422	171658	764	108059	8233	문국현	창조한국당
경상북도	4700	영주시	91618	63686	63067	619	27932	2212	문국현	창조한국당
경상북도	4700	영천시	86531	60974	59998	976	25557	1768	문국현	창조한국당
경상북도	4700	상주시	87304	62722	61891	831	24582	1483	문국현	창조한국당
경상북도	4700	문경시	61373	43068	42582	486	18305	1010	문국현	창조한국당
경상북도	4700	예천군	41837	29903	29383	520	11934	700	문국현	창조한국당
경상북도	4700	경산시	181228	117751	117185	566	63477	4669	문국현	창조한국당
경상북도	4700	청도군	39106	29630	29093	537	9476	930	문국현	창조한국당
경상북도	4700	고령군	28742	19990	19723	267	8752	500	문국현	창조한국당
경상북도	4700	성주군	38277	26370	26050	320	11907	649	문국현	창조한국당
경상북도	4700	칠곡군	85733	53075	52716	359	32658	2255	문국현	창조한국당
경상북도	4700	군위군	22558	16452	16234	218	6106	293	문국현	창조한국당
경상북도	4700	의성군	53346	38182	37701	481	15164	814	문국현	창조한국당
경상북도	4700	청송군	23708	17932	17566	366	5776	581	문국현	창조한국당
경상북도	4700	영양군	16408	11710	11530	180	4698	296	문국현	창조한국당
경상북도	4700	영덕군	36879	27649	27259	390	9230	372	문국현	창조한국당
경상북도	4700	봉화군	29972	21290	20912	378	8682	568	문국현	창조한국당
경상북도	4700	울진군	43430	30078	29706	372	13352	929	문국현	창조한국당
경상북도	4700	포항시북구	191990	140685	140060	625	51305	37	정근모	참주인연합
경상북도	4700	포항시남구	193356	136640	135905	735	56716	45	정근모	참주인연합
경상북도	4700	울릉군	8561	5834	5793	41	2727	4	정근모	참주인연합
경상북도	4700	경주시	211623	145887	144872	1015	65736	59	정근모	참주인연합
경상북도	4700	김천시	109767	74936	74267	669	34831	38	정근모	참주인연합
경상북도	4700	안동시	133566	90343	89321	1022	43223	90	정근모	참주인연합
경상북도	4700	구미시	280481	172422	171658	764	108059	58	정근모	참주인연합
경상북도	4700	영주시	91618	63686	63067	619	27932	45	정근모	참주인연합
경상북도	4700	영천시	86531	60974	59998	976	25557	97	정근모	참주인연합
경상북도	4700	상주시	87304	62722	61891	831	24582	49	정근모	참주인연합
경상북도	4700	문경시	61373	43068	42582	486	18305	20	정근모	참주인연합
경상북도	4700	예천군	41837	29903	29383	520	11934	26	정근모	참주인연합
경상북도	4700	경산시	181228	117751	117185	566	63477	52	정근모	참주인연합
경상북도	4700	청도군	39106	29630	29093	537	9476	60	정근모	참주인연합
경상북도	4700	고령군	28742	19990	19723	267	8752	14	정근모	참주인연합
경상북도	4700	성주군	38277	26370	26050	320	11907	13	정근모	참주인연합
경상북도	4700	칠곡군	85733	53075	52716	359	32658	15	정근모	참주인연합
경상북도	4700	군위군	22558	16452	16234	218	6106	7	정근모	참주인연합
경상북도	4700	의성군	53346	38182	37701	481	15164	17	정근모	참주인연합
경상북도	4700	청송군	23708	17932	17566	366	5776	17	정근모	참주인연합
경상북도	4700	영양군	16408	11710	11530	180	4698	8	정근모	참주인연합
경상북도	4700	영덕군	36879	27649	27259	390	9230	8	정근모	참주인연합
경상북도	4700	봉화군	29972	21290	20912	378	8682	19	정근모	참주인연합
경상북도	4700	울진군	43430	30078	29706	372	13352	21	정근모	참주인연합
경상북도	4700	포항시북구	191990	140685	140060	625	51305	204	허경영	경제공화당
경상북도	4700	포항시남구	193356	136640	135905	735	56716	291	허경영	경제공화당
경상북도	4700	울릉군	8561	5834	5793	41	2727	25	허경영	경제공화당
경상북도	4700	경주시	211623	145887	144872	1015	65736	396	허경영	경제공화당
경상북도	4700	김천시	109767	74936	74267	669	34831	229	허경영	경제공화당
경상북도	4700	안동시	133566	90343	89321	1022	43223	328	허경영	경제공화당
경상북도	4700	구미시	280481	172422	171658	764	108059	752	허경영	경제공화당
경상북도	4700	영주시	91618	63686	63067	619	27932	205	허경영	경제공화당
경상북도	4700	영천시	86531	60974	59998	976	25557	216	허경영	경제공화당
경상북도	4700	상주시	87304	62722	61891	831	24582	287	허경영	경제공화당
경상북도	4700	문경시	61373	43068	42582	486	18305	149	허경영	경제공화당
경상북도	4700	예천군	41837	29903	29383	520	11934	91	허경영	경제공화당
경상북도	4700	경산시	181228	117751	117185	566	63477	355	허경영	경제공화당
경상북도	4700	청도군	39106	29630	29093	537	9476	197	허경영	경제공화당
경상북도	4700	고령군	28742	19990	19723	267	8752	65	허경영	경제공화당
경상북도	4700	성주군	38277	26370	26050	320	11907	55	허경영	경제공화당
경상북도	4700	칠곡군	85733	53075	52716	359	32658	192	허경영	경제공화당
경상북도	4700	군위군	22558	16452	16234	218	6106	34	허경영	경제공화당
경상북도	4700	의성군	53346	38182	37701	481	15164	87	허경영	경제공화당
경상북도	4700	청송군	23708	17932	17566	366	5776	127	허경영	경제공화당
경상북도	4700	영양군	16408	11710	11530	180	4698	25	허경영	경제공화당
경상북도	4700	영덕군	36879	27649	27259	390	9230	47	허경영	경제공화당
경상북도	4700	봉화군	29972	21290	20912	378	8682	124	허경영	경제공화당
경상북도	4700	울진군	43430	30078	29706	372	13352	215	허경영	경제공화당
경상북도	4700	포항시북구	191990	140685	140060	625	51305	18	전관	새시대참사람연합
경상북도	4700	포항시남구	193356	136640	135905	735	56716	22	전관	새시대참사람연합
경상북도	4700	울릉군	8561	5834	5793	41	2727	0	전관	새시대참사람연합
경상북도	4700	경주시	211623	145887	144872	1015	65736	38	전관	새시대참사람연합
경상북도	4700	김천시	109767	74936	74267	669	34831	29	전관	새시대참사람연합
경상북도	4700	안동시	133566	90343	89321	1022	43223	46	전관	새시대참사람연합
경상북도	4700	구미시	280481	172422	171658	764	108059	31	전관	새시대참사람연합
경상북도	4700	영주시	91618	63686	63067	619	27932	31	전관	새시대참사람연합
경상북도	4700	영천시	86531	60974	59998	976	25557	78	전관	새시대참사람연합
경상북도	4700	상주시	87304	62722	61891	831	24582	40	전관	새시대참사람연합
경상북도	4700	문경시	61373	43068	42582	486	18305	23	전관	새시대참사람연합
경상북도	4700	예천군	41837	29903	29383	520	11934	14	전관	새시대참사람연합
경상북도	4700	경산시	181228	117751	117185	566	63477	32	전관	새시대참사람연합
경상북도	4700	청도군	39106	29630	29093	537	9476	138	전관	새시대참사람연합
경상북도	4700	고령군	28742	19990	19723	267	8752	13	전관	새시대참사람연합
경상북도	4700	성주군	38277	26370	26050	320	11907	22	전관	새시대참사람연합
경상북도	4700	칠곡군	85733	53075	52716	359	32658	17	전관	새시대참사람연합
경상북도	4700	군위군	22558	16452	16234	218	6106	6	전관	새시대참사람연합
경상북도	4700	의성군	53346	38182	37701	481	15164	38	전관	새시대참사람연합
경상북도	4700	청송군	23708	17932	17566	366	5776	13	전관	새시대참사람연합
경상북도	4700	영양군	16408	11710	11530	180	4698	6	전관	새시대참사람연합
경상북도	4700	영덕군	36879	27649	27259	390	9230	9	전관	새시대참사람연합
경상북도	4700	봉화군	29972	21290	20912	378	8682	17	전관	새시대참사람연합
경상북도	4700	울진군	43430	30078	29706	372	13352	18	전관	새시대참사람연합
경상북도	4700	포항시북구	191990	140685	140060	625	51305	54	금민	한국사회당
경상북도	4700	포항시남구	193356	136640	135905	735	56716	72	금민	한국사회당
경상북도	4700	울릉군	8561	5834	5793	41	2727	5	금민	한국사회당
경상북도	4700	경주시	211623	145887	144872	1015	65736	100	금민	한국사회당
경상북도	4700	김천시	109767	74936	74267	669	34831	76	금민	한국사회당
경상북도	4700	안동시	133566	90343	89321	1022	43223	119	금민	한국사회당
경상북도	4700	구미시	280481	172422	171658	764	108059	96	금민	한국사회당
경상북도	4700	영주시	91618	63686	63067	619	27932	105	금민	한국사회당
경상북도	4700	영천시	86531	60974	59998	976	25557	159	금민	한국사회당
경상북도	4700	상주시	87304	62722	61891	831	24582	88	금민	한국사회당
경상북도	4700	문경시	61373	43068	42582	486	18305	53	금민	한국사회당
경상북도	4700	예천군	41837	29903	29383	520	11934	51	금민	한국사회당
경상북도	4700	경산시	181228	117751	117185	566	63477	76	금민	한국사회당
경상북도	4700	청도군	39106	29630	29093	537	9476	47	금민	한국사회당
경상북도	4700	고령군	28742	19990	19723	267	8752	29	금민	한국사회당
경상북도	4700	성주군	38277	26370	26050	320	11907	39	금민	한국사회당
경상북도	4700	칠곡군	85733	53075	52716	359	32658	40	금민	한국사회당
경상북도	4700	군위군	22558	16452	16234	218	6106	25	금민	한국사회당
경상북도	4700	의성군	53346	38182	37701	481	15164	57	금민	한국사회당
경상북도	4700	청송군	23708	17932	17566	366	5776	22	금민	한국사회당
경상북도	4700	영양군	16408	11710	11530	180	4698	22	금민	한국사회당
경상북도	4700	영덕군	36879	27649	27259	390	9230	20	금민	한국사회당
경상북도	4700	봉화군	29972	21290	20912	378	8682	67	금민	한국사회당
경상북도	4700	울진군	43430	30078	29706	372	13352	36	금민	한국사회당
경상북도	4700	포항시북구	191990	140685	140060	625	51305	8143	이회창	무소속
경상북도	4700	포항시남구	193356	136640	135905	735	56716	9754	이회창	무소속
경상북도	4700	울릉군	8561	5834	5793	41	2727	588	이회창	무소속
경상북도	4700	경주시	211623	145887	144872	1015	65736	16157	이회창	무소속
경상북도	4700	김천시	109767	74936	74267	669	34831	13631	이회창	무소속
경상북도	4700	안동시	133566	90343	89321	1022	43223	15854	이회창	무소속
경상북도	4700	구미시	280481	172422	171658	764	108059	30175	이회창	무소속
경상북도	4700	영주시	91618	63686	63067	619	27932	10694	이회창	무소속
경상북도	4700	영천시	86531	60974	59998	976	25557	7326	이회창	무소속
경상북도	4700	상주시	87304	62722	61891	831	24582	9508	이회창	무소속
경상북도	4700	문경시	61373	43068	42582	486	18305	6612	이회창	무소속
경상북도	4700	예천군	41837	29903	29383	520	11934	4774	이회창	무소속
경상북도	4700	경산시	181228	117751	117185	566	63477	21393	이회창	무소속
경상북도	4700	청도군	39106	29630	29093	537	9476	4903	이회창	무소속
경상북도	4700	고령군	28742	19990	19723	267	8752	3518	이회창	무소속
경상북도	4700	성주군	38277	26370	26050	320	11907	4207	이회창	무소속
경상북도	4700	칠곡군	85733	53075	52716	359	32658	9120	이회창	무소속
경상북도	4700	군위군	22558	16452	16234	218	6106	2223	이회창	무소속
경상북도	4700	의성군	53346	38182	37701	481	15164	5006	이회창	무소속
경상북도	4700	청송군	23708	17932	17566	366	5776	2115	이회창	무소속
경상북도	4700	영양군	16408	11710	11530	180	4698	1366	이회창	무소속
경상북도	4700	영덕군	36879	27649	27259	390	9230	1763	이회창	무소속
경상북도	4700	봉화군	29972	21290	20912	378	8682	3402	이회창	무소속
경상북도	4700	울진군	43430	30078	29706	372	13352	3294	이회창	무소속
경상남도	4800	창원시	362408	231700	230617	1083	130708	29081	정동영	대통합민주신당
경상남도	4800	마산시	324462	209020	207666	1354	115442	20557	정동영	대통합민주신당
경상남도	4800	진주시	250883	167564	166102	1462	83319	15332	정동영	대통합민주신당
경상남도	4800	진해시	121833	79408	78891	517	42425	9834	정동영	대통합민주신당
경상남도	4800	통영시	104365	64408	63614	794	39957	6610	정동영	대통합민주신당
경상남도	4800	고성군	45808	29676	29127	549	16132	3268	정동영	대통합민주신당
경상남도	4800	사천시	88020	57258	56535	723	30762	5945	정동영	대통합민주신당
경상남도	4800	김해시	328602	196486	195430	1056	132116	33010	정동영	대통합민주신당
경상남도	4800	밀양시	90039	59131	58269	862	30908	7002	정동영	대통합민주신당
경상남도	4800	거제시	150738	88567	87824	743	62171	13614	정동영	대통합민주신당
경상남도	4800	의령군	25869	18150	17618	532	7719	1849	정동영	대통합민주신당
경상남도	4800	함안군	51439	36737	36132	605	14702	3930	정동영	대통합민주신당
경상남도	4800	창녕군	51627	35815	35139	676	15812	3698	정동영	대통합민주신당
경상남도	4800	양산시	168925	101284	100580	704	67641	14220	정동영	대통합민주신당
경상남도	4800	하동군	45826	30695	29975	720	15131	5097	정동영	대통합민주신당
경상남도	4800	남해군	45169	30603	29909	694	14566	4709	정동영	대통합민주신당
경상남도	4800	함양군	33470	25093	24507	586	8377	3200	정동영	대통합민주신당
경상남도	4800	산청군	30086	21140	20604	536	8946	2055	정동영	대통합민주신당
경상남도	4800	거창군	50823	34594	33881	713	16229	3637	정동영	대통합민주신당
경상남도	4800	합천군	45959	31741	30910	831	14218	2815	정동영	대통합민주신당
경상남도	4800	창원시	362408	231700	230617	1083	130708	119272	이명박	한나라당
경상남도	4800	마산시	324462	209020	207666	1354	115442	122030	이명박	한나라당
경상남도	4800	진주시	250883	167564	166102	1462	83319	97767	이명박	한나라당
경상남도	4800	진해시	121833	79408	78891	517	42425	43764	이명박	한나라당
경상남도	4800	통영시	104365	64408	63614	794	39957	38853	이명박	한나라당
경상남도	4800	고성군	45808	29676	29127	549	16132	16716	이명박	한나라당
경상남도	4800	사천시	88020	57258	56535	723	30762	31520	이명박	한나라당
경상남도	4800	김해시	328602	196486	195430	1056	132116	94923	이명박	한나라당
경상남도	4800	밀양시	90039	59131	58269	862	30908	32527	이명박	한나라당
경상남도	4800	거제시	150738	88567	87824	743	62171	45598	이명박	한나라당
경상남도	4800	의령군	25869	18150	17618	532	7719	9440	이명박	한나라당
경상남도	4800	함안군	51439	36737	36132	605	14702	19584	이명박	한나라당
경상남도	4800	창녕군	51627	35815	35139	676	15812	19389	이명박	한나라당
경상남도	4800	양산시	168925	101284	100580	704	67641	55734	이명박	한나라당
경상남도	4800	하동군	45826	30695	29975	720	15131	15618	이명박	한나라당
경상남도	4800	남해군	45169	30603	29909	694	14566	15991	이명박	한나라당
경상남도	4800	함양군	33470	25093	24507	586	8377	13967	이명박	한나라당
경상남도	4800	산청군	30086	21140	20604	536	8946	12239	이명박	한나라당
경상남도	4800	거창군	50823	34594	33881	713	16229	19863	이명박	한나라당
경상남도	4800	합천군	45959	31741	30910	831	14218	18867	이명박	한나라당
경상남도	4800	창원시	362408	231700	230617	1083	130708	18327	권영길	민주노동당
경상남도	4800	마산시	324462	209020	207666	1354	115442	8730	권영길	민주노동당
경상남도	4800	진주시	250883	167564	166102	1462	83319	7752	권영길	민주노동당
경상남도	4800	진해시	121833	79408	78891	517	42425	3417	권영길	민주노동당
경상남도	4800	통영시	104365	64408	63614	794	39957	2293	권영길	민주노동당
경상남도	4800	고성군	45808	29676	29127	549	16132	1254	권영길	민주노동당
경상남도	4800	사천시	88020	57258	56535	723	30762	2774	권영길	민주노동당
경상남도	4800	김해시	328602	196486	195430	1056	132116	8619	권영길	민주노동당
경상남도	4800	밀양시	90039	59131	58269	862	30908	2255	권영길	민주노동당
경상남도	4800	거제시	150738	88567	87824	743	62171	8622	권영길	민주노동당
경상남도	4800	의령군	25869	18150	17618	532	7719	1103	권영길	민주노동당
경상남도	4800	함안군	51439	36737	36132	605	14702	2317	권영길	민주노동당
경상남도	4800	창녕군	51627	35815	35139	676	15812	1831	권영길	민주노동당
경상남도	4800	양산시	168925	101284	100580	704	67641	4367	권영길	민주노동당
경상남도	4800	하동군	45826	30695	29975	720	15131	1677	권영길	민주노동당
경상남도	4800	남해군	45169	30603	29909	694	14566	1404	권영길	민주노동당
경상남도	4800	함양군	33470	25093	24507	586	8377	1087	권영길	민주노동당
경상남도	4800	산청군	30086	21140	20604	536	8946	1482	권영길	민주노동당
경상남도	4800	거창군	50823	34594	33881	713	16229	1708	권영길	민주노동당
경상남도	4800	합천군	45959	31741	30910	831	14218	1626	권영길	민주노동당
경상남도	4800	창원시	362408	231700	230617	1083	130708	537	이인제	민주당
경상남도	4800	마산시	324462	209020	207666	1354	115442	480	이인제	민주당
경상남도	4800	진주시	250883	167564	166102	1462	83319	398	이인제	민주당
경상남도	4800	진해시	121833	79408	78891	517	42425	234	이인제	민주당
경상남도	4800	통영시	104365	64408	63614	794	39957	229	이인제	민주당
경상남도	4800	고성군	45808	29676	29127	549	16132	120	이인제	민주당
경상남도	4800	사천시	88020	57258	56535	723	30762	185	이인제	민주당
경상남도	4800	김해시	328602	196486	195430	1056	132116	595	이인제	민주당
경상남도	4800	밀양시	90039	59131	58269	862	30908	222	이인제	민주당
경상남도	4800	거제시	150738	88567	87824	743	62171	360	이인제	민주당
경상남도	4800	의령군	25869	18150	17618	532	7719	88	이인제	민주당
경상남도	4800	함안군	51439	36737	36132	605	14702	142	이인제	민주당
경상남도	4800	창녕군	51627	35815	35139	676	15812	197	이인제	민주당
경상남도	4800	양산시	168925	101284	100580	704	67641	320	이인제	민주당
경상남도	4800	하동군	45826	30695	29975	720	15131	166	이인제	민주당
경상남도	4800	남해군	45169	30603	29909	694	14566	176	이인제	민주당
경상남도	4800	함양군	33470	25093	24507	586	8377	150	이인제	민주당
경상남도	4800	산청군	30086	21140	20604	536	8946	87	이인제	민주당
경상남도	4800	거창군	50823	34594	33881	713	16229	127	이인제	민주당
경상남도	4800	합천군	45959	31741	30910	831	14218	122	이인제	민주당
경상남도	4800	창원시	362408	231700	230617	1083	130708	13263	문국현	창조한국당
경상남도	4800	마산시	324462	209020	207666	1354	115442	9677	문국현	창조한국당
경상남도	4800	진주시	250883	167564	166102	1462	83319	7629	문국현	창조한국당
경상남도	4800	진해시	121833	79408	78891	517	42425	4351	문국현	창조한국당
경상남도	4800	통영시	104365	64408	63614	794	39957	2523	문국현	창조한국당
경상남도	4800	고성군	45808	29676	29127	549	16132	946	문국현	창조한국당
경상남도	4800	사천시	88020	57258	56535	723	30762	2166	문국현	창조한국당
경상남도	4800	김해시	328602	196486	195430	1056	132116	12154	문국현	창조한국당
경상남도	4800	밀양시	90039	59131	58269	862	30908	2324	문국현	창조한국당
경상남도	4800	거제시	150738	88567	87824	743	62171	4225	문국현	창조한국당
경상남도	4800	의령군	25869	18150	17618	532	7719	486	문국현	창조한국당
경상남도	4800	함안군	51439	36737	36132	605	14702	1534	문국현	창조한국당
경상남도	4800	창녕군	51627	35815	35139	676	15812	1347	문국현	창조한국당
경상남도	4800	양산시	168925	101284	100580	704	67641	5490	문국현	창조한국당
경상남도	4800	하동군	45826	30695	29975	720	15131	1086	문국현	창조한국당
경상남도	4800	남해군	45169	30603	29909	694	14566	902	문국현	창조한국당
경상남도	4800	함양군	33470	25093	24507	586	8377	966	문국현	창조한국당
경상남도	4800	산청군	30086	21140	20604	536	8946	552	문국현	창조한국당
경상남도	4800	거창군	50823	34594	33881	713	16229	1345	문국현	창조한국당
경상남도	4800	합천군	45959	31741	30910	831	14218	927	문국현	창조한국당
경상남도	4800	창원시	362408	231700	230617	1083	130708	91	정근모	참주인연합
경상남도	4800	마산시	324462	209020	207666	1354	115442	62	정근모	참주인연합
경상남도	4800	진주시	250883	167564	166102	1462	83319	82	정근모	참주인연합
경상남도	4800	진해시	121833	79408	78891	517	42425	44	정근모	참주인연합
경상남도	4800	통영시	104365	64408	63614	794	39957	42	정근모	참주인연합
경상남도	4800	고성군	45808	29676	29127	549	16132	27	정근모	참주인연합
경상남도	4800	사천시	88020	57258	56535	723	30762	32	정근모	참주인연합
경상남도	4800	김해시	328602	196486	195430	1056	132116	109	정근모	참주인연합
경상남도	4800	밀양시	90039	59131	58269	862	30908	52	정근모	참주인연합
경상남도	4800	거제시	150738	88567	87824	743	62171	37	정근모	참주인연합
경상남도	4800	의령군	25869	18150	17618	532	7719	50	정근모	참주인연합
경상남도	4800	함안군	51439	36737	36132	605	14702	165	정근모	참주인연합
경상남도	4800	창녕군	51627	35815	35139	676	15812	207	정근모	참주인연합
경상남도	4800	양산시	168925	101284	100580	704	67641	64	정근모	참주인연합
경상남도	4800	하동군	45826	30695	29975	720	15131	30	정근모	참주인연합
경상남도	4800	남해군	45169	30603	29909	694	14566	30	정근모	참주인연합
경상남도	4800	함양군	33470	25093	24507	586	8377	123	정근모	참주인연합
경상남도	4800	산청군	30086	21140	20604	536	8946	11	정근모	참주인연합
경상남도	4800	거창군	50823	34594	33881	713	16229	26	정근모	참주인연합
경상남도	4800	합천군	45959	31741	30910	831	14218	26	정근모	참주인연합
경상남도	4800	창원시	362408	231700	230617	1083	130708	888	허경영	경제공화당
경상남도	4800	마산시	324462	209020	207666	1354	115442	720	허경영	경제공화당
경상남도	4800	진주시	250883	167564	166102	1462	83319	650	허경영	경제공화당
경상남도	4800	진해시	121833	79408	78891	517	42425	272	허경영	경제공화당
경상남도	4800	통영시	104365	64408	63614	794	39957	218	허경영	경제공화당
경상남도	4800	고성군	45808	29676	29127	549	16132	109	허경영	경제공화당
경상남도	4800	사천시	88020	57258	56535	723	30762	188	허경영	경제공화당
경상남도	4800	김해시	328602	196486	195430	1056	132116	880	허경영	경제공화당
경상남도	4800	밀양시	90039	59131	58269	862	30908	192	허경영	경제공화당
경상남도	4800	거제시	150738	88567	87824	743	62171	375	허경영	경제공화당
경상남도	4800	의령군	25869	18150	17618	532	7719	80	허경영	경제공화당
경상남도	4800	함안군	51439	36737	36132	605	14702	212	허경영	경제공화당
경상남도	4800	창녕군	51627	35815	35139	676	15812	157	허경영	경제공화당
경상남도	4800	양산시	168925	101284	100580	704	67641	413	허경영	경제공화당
경상남도	4800	하동군	45826	30695	29975	720	15131	105	허경영	경제공화당
경상남도	4800	남해군	45169	30603	29909	694	14566	127	허경영	경제공화당
경상남도	4800	함양군	33470	25093	24507	586	8377	147	허경영	경제공화당
경상남도	4800	산청군	30086	21140	20604	536	8946	93	허경영	경제공화당
경상남도	4800	거창군	50823	34594	33881	713	16229	128	허경영	경제공화당
경상남도	4800	합천군	45959	31741	30910	831	14218	109	허경영	경제공화당
경상남도	4800	창원시	362408	231700	230617	1083	130708	50	전관	새시대참사람연합
경상남도	4800	마산시	324462	209020	207666	1354	115442	45	전관	새시대참사람연합
경상남도	4800	진주시	250883	167564	166102	1462	83319	55	전관	새시대참사람연합
경상남도	4800	진해시	121833	79408	78891	517	42425	29	전관	새시대참사람연합
경상남도	4800	통영시	104365	64408	63614	794	39957	33	전관	새시대참사람연합
경상남도	4800	고성군	45808	29676	29127	549	16132	16	전관	새시대참사람연합
경상남도	4800	사천시	88020	57258	56535	723	30762	19	전관	새시대참사람연합
경상남도	4800	김해시	328602	196486	195430	1056	132116	57	전관	새시대참사람연합
경상남도	4800	밀양시	90039	59131	58269	862	30908	31	전관	새시대참사람연합
경상남도	4800	거제시	150738	88567	87824	743	62171	27	전관	새시대참사람연합
경상남도	4800	의령군	25869	18150	17618	532	7719	20	전관	새시대참사람연합
경상남도	4800	함안군	51439	36737	36132	605	14702	33	전관	새시대참사람연합
경상남도	4800	창녕군	51627	35815	35139	676	15812	33	전관	새시대참사람연합
경상남도	4800	양산시	168925	101284	100580	704	67641	27	전관	새시대참사람연합
경상남도	4800	하동군	45826	30695	29975	720	15131	34	전관	새시대참사람연합
경상남도	4800	남해군	45169	30603	29909	694	14566	20	전관	새시대참사람연합
경상남도	4800	함양군	33470	25093	24507	586	8377	33	전관	새시대참사람연합
경상남도	4800	산청군	30086	21140	20604	536	8946	13	전관	새시대참사람연합
경상남도	4800	거창군	50823	34594	33881	713	16229	20	전관	새시대참사람연합
경상남도	4800	합천군	45959	31741	30910	831	14218	17	전관	새시대참사람연합
경상남도	4800	창원시	362408	231700	230617	1083	130708	121	금민	한국사회당
경상남도	4800	마산시	324462	209020	207666	1354	115442	114	금민	한국사회당
경상남도	4800	진주시	250883	167564	166102	1462	83319	96	금민	한국사회당
경상남도	4800	진해시	121833	79408	78891	517	42425	45	금민	한국사회당
경상남도	4800	통영시	104365	64408	63614	794	39957	52	금민	한국사회당
경상남도	4800	고성군	45808	29676	29127	549	16132	50	금민	한국사회당
경상남도	4800	사천시	88020	57258	56535	723	30762	67	금민	한국사회당
경상남도	4800	김해시	328602	196486	195430	1056	132116	138	금민	한국사회당
경상남도	4800	밀양시	90039	59131	58269	862	30908	52	금민	한국사회당
경상남도	4800	거제시	150738	88567	87824	743	62171	58	금민	한국사회당
경상남도	4800	의령군	25869	18150	17618	532	7719	30	금민	한국사회당
경상남도	4800	함안군	51439	36737	36132	605	14702	38	금민	한국사회당
경상남도	4800	창녕군	51627	35815	35139	676	15812	63	금민	한국사회당
경상남도	4800	양산시	168925	101284	100580	704	67641	68	금민	한국사회당
경상남도	4800	하동군	45826	30695	29975	720	15131	42	금민	한국사회당
경상남도	4800	남해군	45169	30603	29909	694	14566	45	금민	한국사회당
경상남도	4800	함양군	33470	25093	24507	586	8377	40	금민	한국사회당
경상남도	4800	산청군	30086	21140	20604	536	8946	35	금민	한국사회당
경상남도	4800	거창군	50823	34594	33881	713	16229	45	금민	한국사회당
경상남도	4800	합천군	45959	31741	30910	831	14218	62	금민	한국사회당
경상남도	4800	창원시	362408	231700	230617	1083	130708	48987	이회창	무소속
경상남도	4800	마산시	324462	209020	207666	1354	115442	45251	이회창	무소속
경상남도	4800	진주시	250883	167564	166102	1462	83319	36341	이회창	무소속
경상남도	4800	진해시	121833	79408	78891	517	42425	16901	이회창	무소속
경상남도	4800	통영시	104365	64408	63614	794	39957	12761	이회창	무소속
경상남도	4800	고성군	45808	29676	29127	549	16132	6621	이회창	무소속
경상남도	4800	사천시	88020	57258	56535	723	30762	13639	이회창	무소속
경상남도	4800	김해시	328602	196486	195430	1056	132116	44945	이회창	무소속
경상남도	4800	밀양시	90039	59131	58269	862	30908	13612	이회창	무소속
경상남도	4800	거제시	150738	88567	87824	743	62171	14908	이회창	무소속
경상남도	4800	의령군	25869	18150	17618	532	7719	4472	이회창	무소속
경상남도	4800	함안군	51439	36737	36132	605	14702	8177	이회창	무소속
경상남도	4800	창녕군	51627	35815	35139	676	15812	8217	이회창	무소속
경상남도	4800	양산시	168925	101284	100580	704	67641	19877	이회창	무소속
경상남도	4800	하동군	45826	30695	29975	720	15131	6120	이회창	무소속
경상남도	4800	남해군	45169	30603	29909	694	14566	6505	이회창	무소속
경상남도	4800	함양군	33470	25093	24507	586	8377	4794	이회창	무소속
경상남도	4800	산청군	30086	21140	20604	536	8946	4037	이회창	무소속
경상남도	4800	거창군	50823	34594	33881	713	16229	6982	이회창	무소속
경상남도	4800	합천군	45959	31741	30910	831	14218	6339	이회창	무소속
제주특별자치도	4900	제주시	296325	181304	179604	1700	115021	56798	정동영	대통합민주신당
제주특별자치도	4900	서귀포시	117697	70807	69918	889	46890	24772	정동영	대통합민주신당
제주특별자치도	4900	제주시	296325	181304	179604	1700	115021	70297	이명박	한나라당
제주특별자치도	4900	서귀포시	117697	70807	69918	889	46890	26198	이명박	한나라당
제주특별자치도	4900	제주시	296325	181304	179604	1700	115021	7059	권영길	민주노동당
제주특별자치도	4900	서귀포시	117697	70807	69918	889	46890	3895	권영길	민주노동당
제주특별자치도	4900	제주시	296325	181304	179604	1700	115021	1124	이인제	민주당
제주특별자치도	4900	서귀포시	117697	70807	69918	889	46890	550	이인제	민주당
제주특별자치도	4900	제주시	296325	181304	179604	1700	115021	15142	문국현	창조한국당
제주특별자치도	4900	서귀포시	117697	70807	69918	889	46890	4279	문국현	창조한국당
제주특별자치도	4900	제주시	296325	181304	179604	1700	115021	114	정근모	참주인연합
제주특별자치도	4900	서귀포시	117697	70807	69918	889	46890	38	정근모	참주인연합
제주특별자치도	4900	제주시	296325	181304	179604	1700	115021	929	허경영	경제공화당
제주특별자치도	4900	서귀포시	117697	70807	69918	889	46890	344	허경영	경제공화당
제주특별자치도	4900	제주시	296325	181304	179604	1700	115021	90	전관	새시대참사람연합
제주특별자치도	4900	서귀포시	117697	70807	69918	889	46890	54	전관	새시대참사람연합
제주특별자치도	4900	제주시	296325	181304	179604	1700	115021	227	금민	한국사회당
제주특별자치도	4900	서귀포시	117697	70807	69918	889	46890	117	금민	한국사회당
제주특별자치도	4900	제주시	296325	181304	179604	1700	115021	27824	이회창	무소속
제주특별자치도	4900	서귀포시	117697	70807	69918	889	46890	9671	이회창	무소속
