광역	시군구	읍면동	투표소	선거인수	투표수	기권수	무효표	유효투표수	박근혜	문재인	박종선	김소연	강지원	김순자
서울특별시	종로구	계	계	141447	103189	38258	553	102636	49422	52747	73	86	211	97
서울특별시	종로구	재외투표	재외투표	2138	1626	512	9	1617	798	807	1	0	5	6
서울특별시	종로구	국내부재자투표	국내부재자투표	2689	2507	182	48	2459	1167	1274	2	3	6	7
서울특별시	종로구	청운효자동	소계	11605	8907	2698	40	8867	4233	4598	4	10	18	4
서울특별시	종로구	청운효자동	청운효자동제1투	3596	2631	965	8	2623	1302	1307	1	4	8	1
서울특별시	종로구	청운효자동	청운효자동제2투	4068	3159	909	15	3144	1576	1556	3	3	4	2
서울특별시	종로구	청운효자동	청운효자동제3투	3941	3117	824	17	3100	1355	1735	0	3	6	1
서울특별시	종로구	사직동	소계	8342	6040	2302	20	6020	3448	2551	4	5	10	2
서울특별시	종로구	사직동	사직동제1투	3799	2637	1162	10	2627	1272	1346	2	2	4	1
서울특별시	종로구	사직동	사직동제2투	4543	3403	1140	10	3393	2176	1205	2	3	6	1
서울특별시	종로구	삼청동	소계	2767	2032	735	12	2020	1099	909	0	1	9	2
서울특별시	종로구	삼청동	삼청동투표소	2767	2032	735	12	2020	1099	909	0	1	9	2
서울특별시	종로구	부암동	소계	8897	6688	2209	30	6658	3381	3256	3	6	9	3
서울특별시	종로구	부암동	부암동제1투	3500	2460	1040	13	2447	1200	1239	1	2	4	1
서울특별시	종로구	부암동	부암동제2투	2731	2162	569	8	2154	1086	1058	2	3	3	2
서울특별시	종로구	부암동	부암동제3투	2666	2066	600	9	2057	1095	959	0	1	2	0
서울특별시	종로구	평창동	소계	15575	11753	3822	48	11705	6958	4700	1	8	31	7
서울특별시	종로구	평창동	평창동제1투	3113	2222	891	7	2215	1291	910	0	3	10	1
서울특별시	종로구	평창동	평창동제2투	4605	3448	1157	17	3431	2188	1230	1	3	8	1
서울특별시	종로구	평창동	평창동제3투	2516	1912	604	9	1903	1134	761	0	1	6	1
서울특별시	종로구	평창동	평창동제4투	2498	2010	488	5	2005	1110	889	0	0	4	2
서울특별시	종로구	평창동	평창동제5투	2843	2161	682	10	2151	1235	910	0	1	3	2
서울특별시	종로구	무악동	소계	6589	5117	1472	28	5089	2502	2568	2	1	12	4
서울특별시	종로구	무악동	무악동제1투	2358	1921	437	9	1912	950	956	0	1	2	3
서울특별시	종로구	무악동	무악동제2투	4231	3196	1035	19	3177	1552	1612	2	0	10	1
서울특별시	종로구	교남동	소계	7414	5100	2314	25	5075	2384	2665	4	8	6	8
서울특별시	종로구	교남동	교남동제1투	4349	2967	1382	13	2954	1360	1575	3	7	2	7
서울특별시	종로구	교남동	교남동제2투	3065	2133	932	12	2121	1024	1090	1	1	4	1
서울특별시	종로구	가회동	소계	4476	3403	1073	13	3390	1665	1705	1	3	7	9
서울특별시	종로구	가회동	가회동투표소	4476	3403	1073	13	3390	1665	1705	1	3	7	9
서울특별시	종로구	종로1·2·3·4가동	소계	7270	4440	2830	26	4414	2432	1957	7	4	10	4
서울특별시	종로구	종로1·2·3·4가동	종로1·2·3·4가동제1투	3949	2073	1876	14	2059	1205	842	4	1	5	2
서울특별시	종로구	종로1·2·3·4가동	종로1·2·3·4가동제2투	3321	2367	954	12	2355	1227	1115	3	3	5	2
서울특별시	종로구	종로5·6가동	소계	5213	3574	1639	6	3568	1715	1844	2	2	4	1
서울특별시	종로구	종로5·6가동	종로5·6가동제1투	2410	1577	833	3	1574	821	747	0	2	4	0
서울특별시	종로구	종로5·6가동	종로5·6가동제2투	2803	1997	806	3	1994	894	1097	2	0	0	1
서울특별시	종로구	이화동	소계	7697	5608	2089	23	5585	2318	3244	5	5	9	4
서울특별시	종로구	이화동	이화동제1투	3950	3016	934	16	3000	1204	1786	3	2	3	2
서울특별시	종로구	이화동	이화동제2투	3747	2592	1155	7	2585	1114	1458	2	3	6	2
서울특별시	종로구	혜화동	소계	15254	11642	3612	65	11577	4782	6728	6	15	33	13
서울특별시	종로구	혜화동	혜화동제1투	3537	2783	754	12	2771	1143	1617	2	2	5	2
서울특별시	종로구	혜화동	혜화동제2투	3081	2317	764	14	2303	986	1308	2	0	6	1
서울특별시	종로구	혜화동	혜화동제3투	3217	2487	730	12	2475	1157	1304	1	5	5	3
서울특별시	종로구	혜화동	혜화동제4투	2866	2138	728	11	2127	716	1394	0	4	10	3
서울특별시	종로구	혜화동	혜화동제5투	2553	1917	636	16	1901	780	1105	1	4	7	4
서울특별시	종로구	창신제1동	소계	5665	3680	1985	18	3662	1619	2018	7	1	12	5
서울특별시	종로구	창신제1동	창신제1동제1투	1924	998	926	6	992	496	487	2	0	5	2
서울특별시	종로구	창신제1동	창신제1동제2투	3741	2682	1059	12	2670	1123	1531	5	1	7	3
서울특별시	종로구	창신제2동	소계	9250	6435	2815	48	6387	2548	3811	8	4	11	5
서울특별시	종로구	창신제2동	창신제2동제1투	2555	1625	930	10	1615	658	948	0	2	7	0
서울특별시	종로구	창신제2동	창신제2동제2투	3296	2403	893	20	2383	1000	1378	3	0	1	1
서울특별시	종로구	창신제2동	창신제2동제3투	3399	2407	992	18	2389	890	1485	5	2	3	4
서울특별시	종로구	창신제3동	소계	6620	5020	1600	30	4990	2134	2838	5	3	7	3
서울특별시	종로구	창신제3동	창신제3동제1투	2583	1811	772	24	1787	723	1058	2	1	2	1
서울특별시	종로구	창신제3동	창신제3동제2투	4037	3209	828	6	3203	1411	1780	3	2	5	2
서울특별시	종로구	숭인제1동	소계	6051	4261	1790	23	4238	1877	2343	4	2	5	7
서울특별시	종로구	숭인제1동	숭인제1동제1투	3398	2229	1169	7	2222	1037	1178	1	1	1	4
서울특별시	종로구	숭인제1동	숭인제1동제2투	2653	2032	621	16	2016	840	1165	3	1	4	3
서울특별시	종로구	숭인제2동	소계	7935	5352	2583	41	5311	2362	2927	7	5	7	3
서울특별시	종로구	숭인제2동	숭인제2동제1투	1763	1136	627	11	1125	555	567	1	0	1	1
서울특별시	종로구	숭인제2동	숭인제2동제2투	3407	2199	1208	14	2185	965	1209	3	3	3	2
서울특별시	종로구	숭인제2동	숭인제2동제3투	2765	2017	748	16	2001	842	1151	3	2	3	0
서울특별시	종로구	잘못 투입·구분된 투표지	잘못 투입·구분된 투표지	0	4	-4	0	4	0	4	0	0	0	0
서울특별시	중구	계	계	115277	83095	32182	542	82553	40289	41919	67	56	151	71
서울특별시	중구	재외투표	재외투표	1534	1162	372	10	1152	658	490	0	2	2	0
서울특별시	중구	국내부재자투표	국내부재자투표	1986	1852	134	48	1804	862	921	4	3	9	5
서울특별시	중구	소공동	소계	1153	782	371	1	781	375	399	2	1	2	2
서울특별시	중구	소공동	소공동제1투	540	327	213	1	326	145	178	1	1	0	1
서울특별시	중구	소공동	소공동제2투	613	455	158	0	455	230	221	1	0	2	1
서울특별시	중구	회현동	소계	5262	3204	2058	25	3179	1872	1295	3	3	2	4
서울특별시	중구	회현동	회현동제1투	4043	2520	1523	18	2502	1467	1027	2	3	1	2
서울특별시	중구	회현동	회현동제2투	1219	684	535	7	677	405	268	1	0	1	2
서울특별시	중구	명동	소계	3038	2008	1030	11	1997	1020	969	2	1	3	2
서울특별시	중구	명동	명동제1투	2689	1796	893	9	1787	904	876	2	0	3	2
서울특별시	중구	명동	명동제2투	349	212	137	2	210	116	93	0	1	0	0
서울특별시	중구	필동	소계	3986	2788	1198	20	2768	1421	1333	2	2	7	3
서울특별시	중구	필동	필동제1투	1966	1313	653	10	1303	679	619	1	1	3	0
서울특별시	중구	필동	필동제2투	2020	1475	545	10	1465	742	714	1	1	4	3
서울특별시	중구	장충동	소계	4775	3467	1308	20	3447	1521	1912	1	5	7	1
서울특별시	중구	장충동	장충동제1투	2543	1800	743	10	1790	908	873	1	4	3	1
서울특별시	중구	장충동	장충동제2투	2232	1667	565	10	1657	613	1039	0	1	4	0
서울특별시	중구	광희동	소계	4971	3344	1627	20	3324	1798	1513	3	2	6	2
서울특별시	중구	광희동	광희동제1투	2622	1618	1004	14	1604	845	755	0	0	4	0
서울특별시	중구	광희동	광희동제2투	2349	1726	623	6	1720	953	758	3	2	2	2
서울특별시	중구	을지로동	소계	1796	1127	669	7	1120	669	446	1	1	1	2
서울특별시	중구	을지로동	을지로동제1투	1001	577	424	3	574	377	195	0	1	0	1
서울특별시	중구	을지로동	을지로동제2투	795	550	245	4	546	292	251	1	0	1	1
서울특별시	중구	신당제1동	소계	6661	4533	2128	32	4501	2180	2303	6	2	9	1
서울특별시	중구	신당제1동	신당제1동제1투	3009	1962	1047	15	1947	907	1032	3	1	3	1
서울특별시	중구	신당제1동	신당제1동제2투	745	533	212	3	530	280	248	2	0	0	0
서울특별시	중구	신당제1동	신당제1동제3투	2907	2038	869	14	2024	993	1023	1	1	6	0
서울특별시	중구	신당제2동	소계	13670	9734	3936	61	9673	4347	5296	5	10	8	7
서울특별시	중구	신당제2동	신당제2동제1투	3609	2508	1101	14	2494	1190	1294	1	5	1	3
서울특별시	중구	신당제2동	신당제2동제2투	3421	2473	948	14	2459	1147	1305	1	2	3	1
서울특별시	중구	신당제2동	신당제2동제3투	3366	2368	998	20	2348	981	1359	2	2	2	2
서울특별시	중구	신당제2동	신당제2동제4투	3274	2385	889	13	2372	1029	1338	1	1	2	1
서울특별시	중구	신당제3동	소계	15980	11778	4202	59	11719	5827	5844	10	7	21	10
서울특별시	중구	신당제3동	신당제3동제1투	2390	1573	817	19	1554	822	723	4	0	5	0
서울특별시	중구	신당제3동	신당제3동제2투	2378	1825	553	8	1817	826	982	1	4	2	2
서울특별시	중구	신당제3동	신당제3동제3투	3588	2693	895	8	2685	1443	1232	1	0	6	3
서울특별시	중구	신당제3동	신당제3동제4투	3743	2873	870	9	2864	1469	1391	0	1	2	1
서울특별시	중구	신당제3동	신당제3동제5투	3881	2814	1067	15	2799	1267	1516	4	2	6	4
서울특별시	중구	신당제4동	소계	12780	9809	2971	62	9747	4627	5081	4	7	19	9
서울특별시	중구	신당제4동	신당제4동제1투	1890	1366	524	10	1356	598	750	1	2	3	2
서울특별시	중구	신당제4동	신당제4동제2투	2461	1663	798	9	1654	732	914	1	2	5	0
서울특별시	중구	신당제4동	신당제4동제3투	2637	2200	437	12	2188	1165	1021	0	0	1	1
서울특별시	중구	신당제4동	신당제4동제4투	2472	1963	509	16	1947	829	1109	2	0	5	2
서울특별시	중구	신당제4동	신당제4동제5투	3320	2617	703	15	2602	1303	1287	0	3	5	4
서울특별시	중구	신당제5동	소계	8515	6047	2468	31	6016	2779	3208	4	2	13	10
서울특별시	중구	신당제5동	신당제5동제1투	2627	1699	928	15	1684	775	900	2	2	2	3
서울특별시	중구	신당제5동	신당제5동제2투	4304	3228	1076	10	3218	1485	1721	1	0	8	3
서울특별시	중구	신당제5동	신당제5동제3투	1584	1120	464	6	1114	519	587	1	0	3	4
서울특별시	중구	신당제6동	소계	9491	7358	2133	43	7315	3656	3634	6	3	13	3
서울특별시	중구	신당제6동	신당제6동제1투	1983	1416	567	12	1404	698	696	2	3	4	1
서울특별시	중구	신당제6동	신당제6동제2투	2609	2132	477	8	2124	1116	1002	1	0	5	0
서울특별시	중구	신당제6동	신당제6동제3투	2811	2248	563	12	2236	1138	1093	1	0	4	0
서울특별시	중구	신당제6동	신당제6동제4투	2088	1562	526	11	1551	704	843	2	0	0	2
서울특별시	중구	황학동	소계	10423	7434	2989	51	7383	3526	3828	6	4	13	6
서울특별시	중구	황학동	황학동제1투	4524	3038	1486	24	3014	1423	1579	4	2	6	0
서울특별시	중구	황학동	황학동제2투	2042	1467	575	8	1459	665	786	1	0	2	5
서울특별시	중구	황학동	황학동제3투	3857	2929	928	19	2910	1438	1463	1	2	5	1
서울특별시	중구	중림동	소계	9256	6667	2589	41	6626	3150	3447	8	1	16	4
서울특별시	중구	중림동	중림동제1투	2421	1568	853	9	1559	711	845	0	0	2	1
서울특별시	중구	중림동	중림동제2투	892	561	331	5	556	248	307	0	0	0	1
서울특별시	중구	중림동	중림동제3투	3494	2516	978	14	2502	1169	1323	6	0	3	1
서울특별시	중구	중림동	중림동제4투	2449	2022	427	13	2009	1022	972	2	1	11	1
서울특별시	중구	잘못 투입·구분된 투표지	잘못 투입·구분된 투표지	0	1	-1	0	1	1	0	0	0	0	0
서울특별시	용산구	계	계	206665	147849	58816	715	147134	76997	69572	87	96	261	121
서울특별시	용산구	재외투표	재외투표	2834	2181	653	8	2173	1175	989	0	3	2	4
서울특별시	용산구	국내부재자투표	국내부재자투표	3678	3412	266	54	3358	1752	1579	3	10	7	7
서울특별시	용산구	후암동	소계	16097	11420	4677	50	11370	5135	6187	11	10	17	10
서울특별시	용산구	후암동	후암동제1투	4399	2876	1523	11	2865	1200	1654	4	1	4	2
서울특별시	용산구	후암동	후암동제2투	3797	2703	1094	12	2691	1208	1470	4	3	2	4
서울특별시	용산구	후암동	후암동제3투	3925	2861	1064	13	2848	1369	1466	2	3	5	3
서울특별시	용산구	후암동	후암동제4투	3976	2980	996	14	2966	1358	1597	1	3	6	1
서울특별시	용산구	용산2가동	소계	10761	7552	3209	33	7519	3634	3859	6	7	7	6
서울특별시	용산구	용산2가동	용산2가동제1투	3574	2360	1214	9	2351	1134	1206	2	5	3	1
서울특별시	용산구	용산2가동	용산2가동제2투	2444	1765	679	9	1756	894	856	2	0	2	2
서울특별시	용산구	용산2가동	용산2가동제3투	2384	1740	644	8	1732	849	880	0	1	1	1
서울특별시	용산구	용산2가동	용산2가동제4투	2359	1687	672	7	1680	757	917	2	1	1	2
서울특별시	용산구	남영동	소계	6874	4304	2570	25	4279	1999	2269	2	1	8	0
서울특별시	용산구	남영동	남영동제1투	3775	2347	1428	7	2340	1075	1262	0	0	3	0
서울특별시	용산구	남영동	남영동제2투	3099	1957	1142	18	1939	924	1007	2	1	5	0
서울특별시	용산구	청파동	소계	19260	13754	5506	59	13695	5751	7893	8	11	18	14
서울특별시	용산구	청파동	청파동제1투	3382	2022	1360	10	2012	908	1098	1	1	1	3
서울특별시	용산구	청파동	청파동제2투	2802	2016	786	7	2009	829	1171	4	2	3	0
서울특별시	용산구	청파동	청파동제3투	3071	2286	785	11	2275	953	1320	0	0	0	2
서울특별시	용산구	청파동	청파동제4투	4008	2961	1047	15	2946	1214	1720	1	3	5	3
서울특별시	용산구	청파동	청파동제5투	2967	2167	800	7	2160	917	1234	1	3	2	3
서울특별시	용산구	청파동	청파동제6투	3030	2302	728	9	2293	930	1350	1	2	7	3
서울특별시	용산구	원효로제1동	소계	10351	7656	2695	40	7616	3654	3935	4	3	14	6
서울특별시	용산구	원효로제1동	원효로제1동제1투	3538	2634	904	17	2617	1192	1413	3	2	5	2
서울특별시	용산구	원효로제1동	원효로제1동제2투	3197	2409	788	14	2395	1116	1273	1	0	4	1
서울특별시	용산구	원효로제1동	원효로제1동제3투	3616	2613	1003	9	2604	1346	1249	0	1	5	3
서울특별시	용산구	원효로제2동	소계	12391	9468	2923	38	9430	4718	4684	4	5	15	4
서울특별시	용산구	원효로제2동	원효로제2동제1투	5056	3849	1207	13	3836	1967	1860	0	1	6	2
서울특별시	용산구	원효로제2동	원효로제2동제2투	3676	2843	833	11	2832	1496	1328	1	2	4	1
서울특별시	용산구	원효로제2동	원효로제2동제3투	3659	2776	883	14	2762	1255	1496	3	2	5	1
서울특별시	용산구	효창동	소계	8952	6960	1992	35	6925	3317	3587	0	4	13	4
서울특별시	용산구	효창동	효창동제1투	3458	2646	812	11	2635	1237	1388	0	2	8	0
서울특별시	용산구	효창동	효창동제2투	2832	2277	555	9	2268	1071	1191	0	1	2	3
서울특별시	용산구	효창동	효창동제3투	2662	2037	625	15	2022	1009	1008	0	1	3	1
서울특별시	용산구	용문동	소계	10395	7798	2597	29	7769	3686	4048	5	6	18	6
서울특별시	용산구	용문동	용문동제1투	3935	2728	1207	8	2720	1217	1490	4	2	5	2
서울특별시	용산구	용문동	용문동제2투	3139	2287	852	10	2277	1102	1169	1	0	4	1
서울특별시	용산구	용문동	용문동제3투	3321	2783	538	11	2772	1367	1389	0	4	9	3
서울특별시	용산구	한강로동	소계	13285	9251	4034	44	9207	5509	3653	9	4	21	11
서울특별시	용산구	한강로동	한강로동제1투	2904	2107	797	9	2098	1214	874	1	1	6	2
서울특별시	용산구	한강로동	한강로동제2투	1727	718	1009	6	712	391	317	0	0	1	3
서울특별시	용산구	한강로동	한강로동제3투	1817	1297	520	7	1290	638	644	3	0	2	3
서울특별시	용산구	한강로동	한강로동제4투	4575	3488	1087	13	3475	2412	1050	2	1	9	1
서울특별시	용산구	한강로동	한강로동제5투	2262	1641	621	9	1632	854	768	3	2	3	2
서울특별시	용산구	이촌제1동	소계	20504	15484	5020	53	15431	9979	5400	4	6	36	6
서울특별시	용산구	이촌제1동	이촌제1동제1투	4555	3543	1012	12	3531	2563	958	0	1	9	0
서울특별시	용산구	이촌제1동	이촌제1동제2투	5815	3960	1855	19	3941	2319	1601	3	2	12	4
서울특별시	용산구	이촌제1동	이촌제1동제3투	3861	3040	821	10	3030	2041	982	0	2	5	0
서울특별시	용산구	이촌제1동	이촌제1동제4투	4145	3356	789	7	3349	1943	1395	1	1	8	1
서울특별시	용산구	이촌제1동	이촌제1동제5투	2128	1585	543	5	1580	1113	464	0	0	2	1
서울특별시	용산구	이촌제2동	소계	8544	6522	2022	32	6490	3408	3058	4	2	11	7
서울특별시	용산구	이촌제2동	이촌제2동제1투	2991	2158	833	7	2151	1065	1077	2	1	2	4
서울특별시	용산구	이촌제2동	이촌제2동제2투	2783	2172	611	13	2159	1177	977	1	0	2	2
서울특별시	용산구	이촌제2동	이촌제2동제3투	2770	2192	578	12	2180	1166	1004	1	1	7	1
서울특별시	용산구	이태원제1동	소계	7334	4678	2656	31	4647	2661	1967	3	5	5	6
서울특별시	용산구	이태원제1동	이태원제1동제1투	4311	2587	1724	17	2570	1461	1103	0	3	1	2
서울특별시	용산구	이태원제1동	이태원제1동제2투	3023	2091	932	14	2077	1200	864	3	2	4	4
서울특별시	용산구	이태원제2동	소계	9365	6463	2902	28	6435	3355	3057	3	3	9	8
서울특별시	용산구	이태원제2동	이태원제2동제1투	3681	2406	1275	12	2394	1233	1155	0	1	4	1
서울특별시	용산구	이태원제2동	이태원제2동제2투	3149	2242	907	9	2233	1157	1064	2	2	4	4
서울특별시	용산구	이태원제2동	이태원제2동제3투	2535	1815	720	7	1808	965	838	1	0	1	3
서울특별시	용산구	한남동	소계	20317	12956	7361	59	12897	6840	6010	9	4	24	10
서울특별시	용산구	한남동	한남동제1투	3674	2610	1064	20	2590	1363	1215	4	0	4	4
서울특별시	용산구	한남동	한남동제2투	3690	2409	1281	10	2399	1049	1336	4	1	8	1
서울특별시	용산구	한남동	한남동제3투	4843	3257	1586	7	3250	2093	1149	0	2	5	1
서울특별시	용산구	한남동	한남동제4투	3694	2495	1199	9	2486	1272	1206	1	0	5	2
서울특별시	용산구	한남동	한남동제5투	4416	2185	2231	13	2172	1063	1104	0	1	2	2
서울특별시	용산구	서빙고동	소계	10940	8145	2795	33	8112	5396	2685	1	2	21	7
서울특별시	용산구	서빙고동	서빙고동제1투	3198	2569	629	10	2559	1715	837	0	2	5	0
서울특별시	용산구	서빙고동	서빙고동제2투	2883	2098	785	14	2084	1104	971	1	0	3	5
서울특별시	용산구	서빙고동	서빙고동제3투	3003	2320	683	7	2313	1876	428	0	0	8	1
서울특별시	용산구	서빙고동	서빙고동제4투	1856	1158	698	2	1156	701	449	0	0	5	1
서울특별시	용산구	보광동	소계	14783	9829	4954	64	9765	5021	4703	11	10	15	5
서울특별시	용산구	보광동	보광동제1투	4262	2590	1672	21	2569	1364	1195	1	2	5	2
서울특별시	용산구	보광동	보광동제2투	3484	2408	1076	15	2393	1131	1246	4	4	5	3
서울특별시	용산구	보광동	보광동제3투	3933	2585	1348	13	2572	1262	1300	4	3	3	0
서울특별시	용산구	보광동	보광동제4투	3104	2246	858	15	2231	1264	962	2	1	2	0
서울특별시	용산구	잘못 투입·구분된 투표지	잘못 투입·구분된 투표지	0	16	-16	0	16	7	9	0	0	0	0
서울특별시	성동구	계	계	249514	185566	63948	970	184596	88658	95239	112	113	315	159
서울특별시	성동구	재외투표	재외투표	2241	1638	603	10	1628	705	914	1	3	4	1
서울특별시	성동구	국내부재자투표	국내부재자투표	4651	4354	297	70	4284	2080	2174	4	8	7	11
서울특별시	성동구	금호1가동	소계	12899	9686	3213	47	9639	4590	5014	7	6	17	5
서울특별시	성동구	금호1가동	금호1가동제1투	4193	3014	1179	13	3001	1407	1587	1	1	3	2
서울특별시	성동구	금호1가동	금호1가동제2투	4556	3443	1113	24	3419	1595	1813	3	1	6	1
서울특별시	성동구	금호1가동	금호1가동제3투	4150	3229	921	10	3219	1588	1614	3	4	8	2
서울특별시	성동구	금호2·3가동	소계	18680	13284	5396	96	13188	6304	6840	9	3	22	10
서울특별시	성동구	금호2·3가동	금호2·3가동제1투	5082	3716	1366	31	3685	1781	1893	1	1	6	3
서울특별시	성동구	금호2·3가동	금호2·3가동제2투	4960	3257	1703	16	3241	1538	1689	4	0	7	3
서울특별시	성동구	금호2·3가동	금호2·3가동제3투	5457	3739	1718	32	3707	1695	2000	3	1	6	2
서울특별시	성동구	금호2·3가동	금호2·3가동제4투	3181	2572	609	17	2555	1290	1258	1	1	3	2
서울특별시	성동구	금호4가동	소계	11933	8824	3109	32	8792	4384	4383	7	3	11	4
서울특별시	성동구	금호4가동	금호4가동제1투	3910	2795	1115	7	2788	1460	1319	2	1	5	1
서울특별시	성동구	금호4가동	금호4가동제2투	3724	2951	773	8	2943	1468	1463	3	2	4	3
서울특별시	성동구	금호4가동	금호4가동제3투	4299	3078	1221	17	3061	1456	1601	2	0	2	0
서울특별시	성동구	옥수동	소계	16218	11960	4258	50	11910	6579	5286	7	6	25	7
서울특별시	성동구	옥수동	옥수동제1투	961	512	449	4	508	221	284	2	0	0	1
서울특별시	성동구	옥수동	옥수동제2투	3797	2800	997	11	2789	1620	1160	2	3	4	0
서울특별시	성동구	옥수동	옥수동제3투	3988	3164	824	13	3151	1624	1514	1	2	7	3
서울특별시	성동구	옥수동	옥수동제4투	4268	2959	1309	14	2945	1771	1162	1	1	8	2
서울특별시	성동구	옥수동	옥수동제5투	3204	2525	679	8	2517	1343	1166	1	0	6	1
서울특별시	성동구	응봉동	소계	13529	10287	3242	38	10249	5199	5015	5	4	21	5
서울특별시	성동구	응봉동	응봉동제1투	4532	3198	1334	14	3184	1519	1655	1	1	6	2
서울특별시	성동구	응봉동	응봉동제2투	4949	3860	1089	17	3843	1998	1835	1	2	7	0
서울특별시	성동구	응봉동	응봉동제3투	4048	3229	819	7	3222	1682	1525	3	1	8	3
서울특별시	성동구	성수1가제1동	소계	14221	10637	3584	36	10601	5190	5376	4	8	18	5
서울특별시	성동구	성수1가제1동	성수1가제1동제1투	3959	2710	1249	8	2702	1283	1412	1	1	4	1
서울특별시	성동구	성수1가제1동	성수1가제1동제2투	4054	3242	812	11	3231	1612	1608	2	1	6	2
서울특별시	성동구	성수1가제1동	성수1가제1동제3투	3285	2604	681	5	2599	1324	1266	1	2	5	1
서울특별시	성동구	성수1가제1동	성수1가제1동제4투	2923	2081	842	12	2069	971	1090	0	4	3	1
서울특별시	성동구	성수1가제2동	소계	15249	11626	3623	44	11582	5338	6192	5	10	25	12
서울특별시	성동구	성수1가제2동	성수1가제2동제1투	3441	2415	1026	10	2405	1114	1277	3	2	6	3
서울특별시	성동구	성수1가제2동	성수1가제2동제2투	3101	2346	755	11	2335	1137	1187	0	3	3	5
서울특별시	성동구	성수1가제2동	성수1가제2동제3투	4271	3318	953	10	3308	1487	1810	1	1	8	1
서울특별시	성동구	성수1가제2동	성수1가제2동제4투	4436	3547	889	13	3534	1600	1918	1	4	8	3
서울특별시	성동구	성수2가제1동	소계	16961	12107	4854	63	12044	6125	5879	7	6	12	15
서울특별시	성동구	성수2가제1동	성수2가제1동제1투	3965	2790	1175	9	2781	1429	1342	0	3	5	2
서울특별시	성동구	성수2가제1동	성수2가제1동제2투	4578	3407	1171	13	3394	1779	1609	2	0	0	4
서울특별시	성동구	성수2가제1동	성수2가제1동제3투	4338	2983	1355	20	2963	1476	1475	2	1	4	5
서울특별시	성동구	성수2가제1동	성수2가제1동제4투	4080	2927	1153	21	2906	1441	1453	3	2	3	4
서울특별시	성동구	성수2가제3동	소계	10096	7502	2594	36	7466	3774	3669	1	5	9	8
서울특별시	성동구	성수2가제3동	성수2가제3동제1투	4050	2831	1219	16	2815	1321	1482	1	2	4	5
서울특별시	성동구	성수2가제3동	성수2가제3동제2투	4165	3376	789	18	3358	1889	1462	0	1	4	2
서울특별시	성동구	성수2가제3동	성수2가제3동제3투	1881	1295	586	2	1293	564	725	0	2	1	1
서울특별시	성동구	왕십리도선동	소계	10745	7708	3037	56	7652	3766	3856	6	5	10	9
서울특별시	성동구	왕십리도선동	왕십리도선동제1투	4129	2999	1130	18	2981	1404	1571	2	2	1	1
서울특별시	성동구	왕십리도선동	왕십리도선동제2투	3369	2150	1219	14	2136	1053	1072	1	1	3	6
서울특별시	성동구	왕십리도선동	왕십리도선동제3투	3247	2559	688	24	2535	1309	1213	3	2	6	2
서울특별시	성동구	왕십리제2동	소계	13759	10229	3530	74	10155	4521	5594	8	7	19	6
서울특별시	성동구	왕십리제2동	왕십리제2동제1투	4980	3444	1536	31	3413	1461	1932	4	2	9	5
서울특별시	성동구	왕십리제2동	왕십리제2동제2투	3728	2781	947	26	2755	1278	1470	3	2	2	0
서울특별시	성동구	왕십리제2동	왕십리제2동제3투	1832	1415	417	7	1408	672	732	1	2	1	0
서울특별시	성동구	왕십리제2동	왕십리제2동제4투	3219	2589	630	10	2579	1110	1460	0	1	7	1
서울특별시	성동구	행당제1동	소계	14402	10622	3780	51	10571	5136	5388	4	8	20	15
서울특별시	성동구	행당제1동	행당제1동제1투	4052	2930	1122	11	2919	1502	1407	0	2	5	3
서울특별시	성동구	행당제1동	행당제1동제2투	4703	3644	1059	10	3634	1800	1814	1	4	9	6
서울특별시	성동구	행당제1동	행당제1동제3투	2549	1863	686	12	1851	819	1025	3	0	4	0
서울특별시	성동구	행당제1동	행당제1동제4투	3098	2185	913	18	2167	1015	1142	0	2	2	6
서울특별시	성동구	행당제2동	소계	20640	16150	4490	69	16081	7469	8555	11	7	28	11
서울특별시	성동구	행당제2동	행당제2동제1투	4560	3348	1212	15	3333	1652	1672	0	1	6	2
서울특별시	성동구	행당제2동	행당제2동제2투	4055	3156	899	15	3141	1401	1730	3	2	5	0
서울특별시	성동구	행당제2동	행당제2동제3투	4274	3327	947	15	3312	1481	1819	2	3	4	3
서울특별시	성동구	행당제2동	행당제2동제4투	3709	3073	636	11	3062	1440	1609	2	0	9	2
서울특별시	성동구	행당제2동	행당제2동제5투	4042	3246	796	13	3233	1495	1725	4	1	4	4
서울특별시	성동구	마장동	소계	20277	15384	4893	76	15308	7196	8057	7	9	25	14
서울특별시	성동구	마장동	마장동제1투	3553	2627	926	13	2614	1201	1403	1	2	6	1
서울특별시	성동구	마장동	마장동제2투	3347	2645	702	16	2629	1294	1326	2	1	4	2
서울특별시	성동구	마장동	마장동제3투	3973	3148	825	9	3139	1447	1685	0	2	4	1
서울특별시	성동구	마장동	마장동제4투	3096	2263	833	10	2253	1067	1176	2	0	3	5
서울특별시	성동구	마장동	마장동제5투	3331	2372	959	15	2357	1147	1199	1	3	3	4
서울특별시	성동구	마장동	마장동제6투	2977	2329	648	13	2316	1040	1268	1	1	5	1
서울특별시	성동구	사근동	소계	9157	6849	2308	45	6804	2783	3995	5	3	17	1
서울특별시	성동구	사근동	사근동제1투	2651	2098	553	13	2085	812	1264	2	1	6	0
서울특별시	성동구	사근동	사근동제2투	3192	2288	904	19	2269	1023	1238	3	1	4	0
서울특별시	성동구	사근동	사근동제3투	3314	2463	851	13	2450	948	1493	0	1	7	1
서울특별시	성동구	송정동	소계	10041	6987	3054	36	6951	3204	3716	4	6	12	9
서울특별시	성동구	송정동	송정동제1투	3598	2470	1128	12	2458	1076	1373	2	1	4	2
서울특별시	성동구	송정동	송정동제2투	3274	2303	971	13	2290	1073	1212	0	2	2	1
서울특별시	성동구	송정동	송정동제3투	3169	2214	955	11	2203	1055	1131	2	3	6	6
서울특별시	성동구	용답동	소계	13815	9719	4096	41	9678	4312	5326	10	6	13	11
서울특별시	성동구	용답동	용답동제1투	3644	2367	1277	10	2357	1036	1308	4	1	4	4
서울특별시	성동구	용답동	용답동제2투	3640	2619	1021	13	2606	1154	1442	3	0	4	3
서울특별시	성동구	용답동	용답동제3투	3299	2376	923	5	2371	1030	1334	2	2	2	1
서울특별시	성동구	용답동	용답동제4투	3232	2357	875	13	2344	1092	1242	1	3	3	3
서울특별시	성동구	잘못 투입·구분된 투표지	잘못 투입·구분된 투표지	0	13	-13	0	13	3	10	0	0	0	0
서울특별시	광진구	계	계	307590	231171	76419	1125	230046	106675	122537	118	131	385	200
서울특별시	광진구	재외투표	재외투표	2673	2055	618	9	2046	848	1186	0	2	8	2
서울특별시	광진구	국내부재자투표	국내부재자투표	5924	5558	366	88	5470	2577	2836	10	13	14	20
서울특별시	광진구	중곡제1동	소계	13959	10052	3907	69	9983	4411	5548	4	4	8	8
서울특별시	광진구	중곡제1동	중곡제1동제1투	3966	2728	1238	9	2719	1162	1550	1	1	3	2
서울특별시	광진구	중곡제1동	중곡제1동제2투	3031	2288	743	24	2264	1002	1254	1	1	1	5
서울특별시	광진구	중곡제1동	중곡제1동제3투	3657	2558	1099	19	2539	1160	1374	2	1	1	1
서울특별시	광진구	중곡제1동	중곡제1동제4투	3305	2478	827	17	2461	1087	1370	0	1	3	0
서울특별시	광진구	중곡제2동	소계	18621	13728	4893	61	13667	6104	7511	14	7	20	11
서울특별시	광진구	중곡제2동	중곡제2동제1투	3735	2621	1114	13	2608	1130	1468	3	4	2	1
서울특별시	광진구	중곡제2동	중곡제2동제2투	3892	2957	935	11	2946	1305	1628	3	1	6	3
서울특별시	광진구	중곡제2동	중곡제2동제3투	4067	3020	1047	13	3007	1370	1625	4	0	6	2
서울특별시	광진구	중곡제2동	중곡제2동제4투	3145	2265	880	12	2253	1061	1185	1	0	3	3
서울특별시	광진구	중곡제2동	중곡제2동제5투	3782	2865	917	12	2853	1238	1605	3	2	3	2
서울특별시	광진구	중곡제3동	소계	15437	11203	4234	56	11147	5099	6015	6	2	13	12
서울특별시	광진구	중곡제3동	중곡제3동제1투	2960	2238	722	11	2227	1030	1188	2	0	6	1
서울특별시	광진구	중곡제3동	중곡제3동제2투	2760	2073	687	9	2064	948	1113	1	0	0	2
서울특별시	광진구	중곡제3동	중곡제3동제3투	3230	2339	891	5	2334	1053	1276	0	1	0	4
서울특별시	광진구	중곡제3동	중곡제3동제4투	3702	2541	1161	15	2526	1128	1389	0	1	5	3
서울특별시	광진구	중곡제3동	중곡제3동제5투	2785	2012	773	16	1996	940	1049	3	0	2	2
서울특별시	광진구	중곡제4동	소계	25725	19235	6490	98	19137	8834	10242	10	8	27	16
서울특별시	광진구	중곡제4동	중곡제4동제1투	3157	2466	691	10	2456	1166	1283	0	1	4	2
서울특별시	광진구	중곡제4동	중곡제4동제2투	3504	2730	774	12	2718	1208	1500	2	1	3	4
서울특별시	광진구	중곡제4동	중곡제4동제3투	3642	2539	1103	17	2522	1225	1291	1	1	2	2
서울특별시	광진구	중곡제4동	중곡제4동제4투	3453	2536	917	15	2521	1162	1351	1	2	3	2
서울특별시	광진구	중곡제4동	중곡제4동제5투	3977	2938	1039	16	2922	1317	1595	0	1	8	1
서울특별시	광진구	중곡제4동	중곡제4동제6투	3927	2864	1063	17	2847	1332	1504	3	1	3	4
서울특별시	광진구	중곡제4동	중곡제4동제7투	4065	3162	903	11	3151	1424	1718	3	1	4	1
서울특별시	광진구	능동	소계	9389	7028	2361	36	6992	3099	3867	4	5	10	7
서울특별시	광진구	능동	능동제1투	2894	2050	844	6	2044	923	1112	0	1	3	5
서울특별시	광진구	능동	능동제2투	3109	2365	744	11	2354	1034	1312	2	3	3	0
서울특별시	광진구	능동	능동제3투	3386	2613	773	19	2594	1142	1443	2	1	4	2
서울특별시	광진구	구의제1동	소계	18926	13776	5150	55	13721	5875	7805	10	2	19	10
서울특별시	광진구	구의제1동	구의제1동제1투	3818	2688	1130	11	2677	1205	1467	0	0	4	1
서울특별시	광진구	구의제1동	구의제1동제2투	3824	2870	954	8	2862	1200	1652	2	1	4	3
서울특별시	광진구	구의제1동	구의제1동제3투	4144	3092	1052	7	3085	1342	1739	0	0	3	1
서울특별시	광진구	구의제1동	구의제1동제4투	3476	2585	891	19	2566	1036	1519	5	1	3	2
서울특별시	광진구	구의제1동	구의제1동제5투	3664	2541	1123	10	2531	1092	1428	3	0	5	3
서울특별시	광진구	구의제2동	소계	21740	16227	5513	74	16153	7599	8502	3	13	22	14
서울특별시	광진구	구의제2동	구의제2동제1투	3538	2536	1002	16	2520	1149	1362	1	1	4	3
서울특별시	광진구	구의제2동	구의제2동제2투	2985	2164	821	8	2156	1102	1044	1	2	6	1
서울특별시	광진구	구의제2동	구의제2동제3투	2798	2112	686	15	2097	942	1150	0	1	3	1
서울특별시	광진구	구의제2동	구의제2동제4투	4170	3144	1026	14	3130	1492	1632	0	1	1	4
서울특별시	광진구	구의제2동	구의제2동제5투	4069	3074	995	11	3063	1441	1612	0	4	2	4
서울특별시	광진구	구의제2동	구의제2동제6투	4180	3197	983	10	3187	1473	1702	1	4	6	1
서울특별시	광진구	구의제3동	소계	23452	18768	4684	67	18701	9574	9065	4	6	35	17
서울특별시	광진구	구의제3동	구의제3동제1투	2881	2461	420	6	2455	1334	1114	0	0	4	3
서울특별시	광진구	구의제3동	구의제3동제2투	3544	2753	791	14	2739	1227	1504	1	0	4	3
서울특별시	광진구	구의제3동	구의제3동제3투	3944	3025	919	9	3016	1352	1654	1	3	5	1
서울특별시	광진구	구의제3동	구의제3동제4투	4900	3826	1074	15	3811	2035	1764	0	2	8	2
서울특별시	광진구	구의제3동	구의제3동제5투	4248	3397	851	14	3383	1734	1634	2	1	8	4
서울특별시	광진구	구의제3동	구의제3동제6투	3935	3306	629	9	3297	1892	1395	0	0	6	4
서울특별시	광진구	광장동	소계	25918	21066	4852	51	21015	11028	9917	3	11	47	9
서울특별시	광진구	광장동	광장동제1투	4566	3359	1207	11	3348	1882	1457	1	0	6	2
서울특별시	광진구	광장동	광장동제2투	3597	2831	766	12	2819	1833	978	1	3	2	2
서울특별시	광진구	광장동	광장동제3투	4106	3454	652	3	3451	1602	1837	1	1	9	1
서울특별시	광진구	광장동	광장동제4투	4308	3668	640	5	3663	1705	1940	0	3	13	2
서울특별시	광진구	광장동	광장동제5투	4818	4007	811	9	3998	1922	2062	0	2	10	2
서울특별시	광진구	광장동	광장동제6투	4523	3747	776	11	3736	2084	1643	0	2	7	0
서울특별시	광진구	자양제1동	소계	19879	14221	5658	73	14148	6175	7916	8	9	30	10
서울특별시	광진구	자양제1동	자양제1동제1투	3556	2336	1220	10	2326	997	1316	0	1	11	1
서울특별시	광진구	자양제1동	자양제1동제2투	2945	2128	817	11	2117	951	1161	1	2	1	1
서울특별시	광진구	자양제1동	자양제1동제3투	4077	3046	1031	21	3025	1275	1733	1	2	10	4
서울특별시	광진구	자양제1동	자양제1동제4투	2994	2217	777	11	2206	999	1194	4	1	6	2
서울특별시	광진구	자양제1동	자양제1동제5투	3222	2303	919	12	2291	962	1327	1	0	0	1
서울특별시	광진구	자양제1동	자양제1동제6투	3085	2191	894	8	2183	991	1185	1	3	2	1
서울특별시	광진구	자양제2동	소계	22936	17247	5689	87	17160	7927	9179	7	7	19	21
서울특별시	광진구	자양제2동	자양제2동제1투	4377	3214	1163	11	3203	1476	1718	0	1	3	5
서울특별시	광진구	자양제2동	자양제2동제2투	4235	3328	907	24	3304	1732	1557	1	2	6	6
서울특별시	광진구	자양제2동	자양제2동제3투	3448	2594	854	19	2575	1169	1401	1	0	0	4
서울특별시	광진구	자양제2동	자양제2동제4투	3723	2862	861	6	2856	1310	1538	0	2	5	1
서울특별시	광진구	자양제2동	자양제2동제5투	3246	2410	836	16	2394	1019	1369	1	1	2	2
서울특별시	광진구	자양제2동	자양제2동제6투	3907	2839	1068	11	2828	1221	1596	4	1	3	3
서울특별시	광진구	자양제3동	소계	24753	19925	4828	84	19841	9965	9806	5	16	35	14
서울특별시	광진구	자양제3동	자양제3동제1투	3979	3053	926	22	3031	1446	1574	1	3	4	3
서울특별시	광진구	자양제3동	자양제3동제2투	4299	3362	937	12	3350	1668	1668	1	5	6	2
서울특별시	광진구	자양제3동	자양제3동제3투	3822	3172	650	7	3165	1426	1732	0	2	3	2
서울특별시	광진구	자양제3동	자양제3동제4투	3478	2905	573	13	2892	1324	1561	1	2	3	1
서울특별시	광진구	자양제3동	자양제3동제5투	3287	2757	530	5	2752	1187	1551	1	2	9	2
서울특별시	광진구	자양제3동	자양제3동제6투	2099	1542	557	10	1532	706	820	1	2	2	1
서울특별시	광진구	자양제3동	자양제3동제7투	3789	3134	655	15	3119	2208	900	0	0	8	3
서울특별시	광진구	자양제4동	소계	21675	15272	6403	80	15192	6820	8311	12	10	29	10
서울특별시	광진구	자양제4동	자양제4동제1투	3462	2183	1279	13	2170	1030	1129	1	2	5	3
서울특별시	광진구	자양제4동	자양제4동제2투	3680	2756	924	15	2741	1308	1427	2	0	4	0
서울특별시	광진구	자양제4동	자양제4동제3투	3765	2668	1097	9	2659	1201	1445	5	1	6	1
서울특별시	광진구	자양제4동	자양제4동제4투	3870	2671	1199	18	2653	1128	1514	2	2	3	4
서울특별시	광진구	자양제4동	자양제4동제5투	3654	2577	1077	14	2563	1124	1426	1	3	7	2
서울특별시	광진구	자양제4동	자양제4동제6투	3244	2417	827	11	2406	1029	1370	1	2	4	0
서울특별시	광진구	화양동	소계	18746	12830	5916	69	12761	5044	7665	10	9	23	10
서울특별시	광진구	화양동	화양동제1투	4038	2422	1616	13	2409	963	1436	1	2	6	1
서울특별시	광진구	화양동	화양동제2투	2968	2055	913	10	2045	822	1212	4	2	3	2
서울특별시	광진구	화양동	화양동제3투	3758	2672	1086	9	2663	1060	1599	0	2	1	1
서울특별시	광진구	화양동	화양동제4투	2856	2038	818	17	2021	783	1228	3	2	4	1
서울특별시	광진구	화양동	화양동제5투	2974	2095	879	14	2081	798	1274	1	0	6	2
서울특별시	광진구	화양동	화양동제6투	2152	1548	604	6	1542	618	916	1	1	3	3
서울특별시	광진구	군자동	소계	17837	12948	4889	68	12880	5680	7150	8	7	26	9
서울특별시	광진구	군자동	군자동제1투	3837	2645	1192	11	2634	1090	1532	2	3	5	2
서울특별시	광진구	군자동	군자동제2투	2347	1682	665	4	1678	720	952	1	1	2	2
서울특별시	광진구	군자동	군자동제3투	2822	2070	752	12	2058	890	1162	0	1	4	1
서울특별시	광진구	군자동	군자동제4투	3143	2251	892	20	2231	1018	1207	1	0	2	3
서울특별시	광진구	군자동	군자동제5투	2719	2101	618	5	2096	1012	1073	1	0	9	1
서울특별시	광진구	군자동	군자동제6투	2969	2199	770	16	2183	950	1224	3	2	4	0
서울특별시	광진구	잘못 투입·구분된 투표지	잘못 투입·구분된 투표지	0	32	-32	0	32	16	16	0	0	0	0
서울특별시	동대문구	계	계	305303	227177	78126	1387	225790	107972	116909	164	151	398	196
서울특별시	동대문구	재외투표	재외투표	2408	1800	608	10	1790	781	998	4	1	5	1
서울특별시	동대문구	국내부재자투표	국내부재자투표	5693	5327	366	124	5203	2383	2767	12	6	11	24
서울특별시	동대문구	용신동	소계	27204	19282	7922	109	19173	9206	9910	7	8	29	13
서울특별시	동대문구	용신동	용신동제1투	4577	3027	1550	19	3008	1454	1548	1	1	3	1
서울특별시	동대문구	용신동	용신동제2투	3549	2711	838	16	2695	1282	1406	1	1	4	1
서울특별시	동대문구	용신동	용신동제3투	3599	2532	1067	16	2516	1239	1265	2	3	4	3
서울특별시	동대문구	용신동	용신동제4투	2010	1465	545	7	1458	705	750	0	0	3	0
서울특별시	동대문구	용신동	용신동제5투	3077	2213	864	10	2203	980	1219	0	0	2	2
서울특별시	동대문구	용신동	용신동제6투	3284	2319	965	12	2307	1102	1195	1	2	7	0
서울특별시	동대문구	용신동	용신동제7투	3543	2342	1201	14	2328	1225	1095	0	1	4	3
서울특별시	동대문구	용신동	용신동제8투	3565	2673	892	15	2658	1219	1432	2	0	2	3
서울특별시	동대문구	제기동	소계	23496	16899	6597	125	16774	8117	8584	14	10	35	14
서울특별시	동대문구	제기동	제기동제1투	4699	2916	1783	25	2891	1622	1247	4	2	11	5
서울특별시	동대문구	제기동	제기동제2투	4131	3085	1046	12	3073	1479	1580	2	2	8	2
서울특별시	동대문구	제기동	제기동제3투	4529	3145	1384	25	3120	1472	1635	3	2	5	3
서울특별시	동대문구	제기동	제기동제4투	3572	2625	947	20	2605	1220	1376	3	2	4	0
서울특별시	동대문구	제기동	제기동제5투	3307	2561	746	23	2538	1106	1423	0	2	6	1
서울특별시	동대문구	제기동	제기동제6투	3258	2567	691	20	2547	1218	1323	2	0	1	3
서울특별시	동대문구	전농제1동	소계	22202	15588	6614	121	15467	7560	7844	13	12	19	19
서울특별시	동대문구	전농제1동	전농제1동제1투	4378	2816	1562	24	2792	1337	1448	1	0	5	1
서울특별시	동대문구	전농제1동	전농제1동제2투	3240	2331	909	13	2318	1088	1223	0	3	2	2
서울특별시	동대문구	전농제1동	전농제1동제3투	4222	2837	1385	28	2809	1460	1334	3	5	4	3
서울특별시	동대문구	전농제1동	전농제1동제4투	3076	2217	859	11	2206	1060	1136	3	1	2	4
서울특별시	동대문구	전농제1동	전농제1동제5투	3545	2618	927	16	2602	1258	1330	4	3	3	4
서울특별시	동대문구	전농제1동	전농제1동제6투	3741	2769	972	29	2740	1357	1373	2	0	3	5
서울특별시	동대문구	전농제2동	소계	16861	13200	3661	64	13136	6521	6573	7	7	19	9
서울특별시	동대문구	전농제2동	전농제2동제1투	2729	2138	591	11	2127	1048	1074	0	0	3	2
서울특별시	동대문구	전농제2동	전농제2동제2투	3529	2891	638	14	2877	1500	1368	3	2	3	1
서울특별시	동대문구	전농제2동	전농제2동제3투	3198	2465	733	11	2454	1207	1241	0	1	2	3
서울특별시	동대문구	전농제2동	전농제2동제4투	4534	3559	975	14	3545	1724	1803	3	4	8	3
서울특별시	동대문구	전농제2동	전농제2동제5투	2871	2147	724	14	2133	1042	1087	1	0	3	0
서울특별시	동대문구	답십리제1동	소계	16353	12084	4269	79	12005	5755	6210	4	4	23	9
서울특별시	동대문구	답십리제1동	답십리제1동제1투	2210	1291	919	8	1283	623	652	1	1	5	1
서울특별시	동대문구	답십리제1동	답십리제1동제2투	1653	1252	401	9	1243	606	634	0	0	2	1
서울특별시	동대문구	답십리제1동	답십리제1동제3투	2325	1762	563	6	1756	838	914	0	0	4	0
서울특별시	동대문구	답십리제1동	답십리제1동제4투	2174	1662	512	16	1646	831	811	0	1	3	0
서울특별시	동대문구	답십리제1동	답십리제1동제5투	3474	2814	660	14	2800	1251	1540	2	0	6	1
서울특별시	동대문구	답십리제1동	답십리제1동제6투	2786	2047	739	16	2031	998	1026	0	2	2	3
서울특별시	동대문구	답십리제1동	답십리제1동제7투	1731	1256	475	10	1246	608	633	1	0	1	3
서울특별시	동대문구	답십리제2동	소계	25466	19604	5862	122	19482	9206	10193	21	9	37	16
서울특별시	동대문구	답십리제2동	답십리제2동제1투	3453	2321	1132	15	2306	1065	1226	3	1	8	3
서울특별시	동대문구	답십리제2동	답십리제2동제2투	3699	2881	818	19	2862	1350	1498	2	2	7	3
서울특별시	동대문구	답십리제2동	답십리제2동제3투	2689	2143	546	13	2130	1021	1103	1	1	3	1
서울특별시	동대문구	답십리제2동	답십리제2동제4투	3477	2824	653	12	2812	1274	1536	0	1	0	1
서울특별시	동대문구	답십리제2동	답십리제2동제5투	3823	3083	740	22	3061	1412	1627	9	2	8	3
서울특별시	동대문구	답십리제2동	답십리제2동제6투	3956	3233	723	17	3216	1577	1625	3	1	6	4
서울특별시	동대문구	답십리제2동	답십리제2동제7투	4369	3119	1250	24	3095	1507	1578	3	1	5	1
서울특별시	동대문구	장안제1동	소계	30496	22725	7771	117	22608	11017	11529	13	14	24	11
서울특별시	동대문구	장안제1동	장안제1동제1투	3796	2435	1361	16	2419	1132	1275	2	2	5	3
서울특별시	동대문구	장안제1동	장안제1동제2투	4075	2975	1100	20	2955	1372	1575	3	0	2	3
서울특별시	동대문구	장안제1동	장안제1동제3투	3947	2712	1235	17	2695	1240	1449	1	3	2	0
서울특별시	동대문구	장안제1동	장안제1동제4투	4326	3262	1064	20	3242	1587	1649	1	3	2	0
서울특별시	동대문구	장안제1동	장안제1동제5투	3334	2486	848	10	2476	1206	1262	3	2	3	0
서울특별시	동대문구	장안제1동	장안제1동제6투	3923	2912	1011	15	2897	1353	1536	1	3	3	1
서울특별시	동대문구	장안제1동	장안제1동제7투	3562	2975	587	8	2967	1555	1408	1	0	3	0
서울특별시	동대문구	장안제1동	장안제1동제8투	3533	2968	565	11	2957	1572	1375	1	1	4	4
서울특별시	동대문구	장안제2동	소계	25928	19552	6376	96	19456	9431	9962	11	10	29	13
서울특별시	동대문구	장안제2동	장안제2동제1투	2645	1753	892	11	1742	906	832	0	1	1	2
서울특별시	동대문구	장안제2동	장안제2동제2투	3810	2915	895	18	2897	1468	1421	1	0	5	2
서울특별시	동대문구	장안제2동	장안제2동제3투	2673	1968	705	11	1957	962	986	5	1	1	2
서울특별시	동대문구	장안제2동	장안제2동제4투	3287	2423	864	13	2410	1141	1261	2	2	3	1
서울특별시	동대문구	장안제2동	장안제2동제5투	3517	2556	961	15	2541	1145	1382	1	4	7	2
서울특별시	동대문구	장안제2동	장안제2동제6투	2454	1841	613	3	1838	918	915	0	1	3	1
서울특별시	동대문구	장안제2동	장안제2동제7투	4294	3638	656	14	3624	1751	1862	2	0	6	3
서울특별시	동대문구	장안제2동	장안제2동제8투	3248	2458	790	11	2447	1140	1303	0	1	3	0
서울특별시	동대문구	청량리동	소계	20671	15093	5578	101	14992	8161	6761	8	15	30	17
서울특별시	동대문구	청량리동	청량리동제1투	3493	2151	1342	13	2138	1083	1047	0	2	2	4
서울특별시	동대문구	청량리동	청량리동제2투	3743	3033	710	11	3022	1574	1437	2	4	4	1
서울특별시	동대문구	청량리동	청량리동제3투	3001	2125	876	20	2105	1103	989	2	4	4	3
서울특별시	동대문구	청량리동	청량리동제4투	2896	2005	891	21	1984	1119	859	1	1	2	2
서울특별시	동대문구	청량리동	청량리동제5투	3429	2629	800	20	2609	1430	1162	2	3	8	4
서울특별시	동대문구	청량리동	청량리동제6투	4109	3150	959	16	3134	1852	1267	1	1	10	3
서울특별시	동대문구	회기동	소계	9328	6919	2409	36	6883	3038	3822	2	6	13	2
서울특별시	동대문구	회기동	회기동제1투	3532	2464	1068	12	2452	1099	1344	0	4	4	1
서울특별시	동대문구	회기동	회기동제2투	3134	2443	691	8	2435	1089	1342	1	2	1	0
서울특별시	동대문구	회기동	회기동제3투	2662	2012	650	16	1996	850	1136	1	0	8	1
서울특별시	동대문구	휘경제1동	소계	14136	10140	3996	57	10083	4644	5405	6	7	15	6
서울특별시	동대문구	휘경제1동	휘경제1동제1투	3830	2571	1259	18	2553	1261	1283	4	1	4	0
서울특별시	동대문구	휘경제1동	휘경제1동제2투	2885	2010	875	15	1995	907	1085	0	1	2	0
서울특별시	동대문구	휘경제1동	휘경제1동제3투	3554	2513	1041	9	2504	947	1544	0	4	7	2
서울특별시	동대문구	휘경제1동	휘경제1동제4투	3867	3046	821	15	3031	1529	1493	2	1	2	4
서울특별시	동대문구	휘경제2동	소계	20625	15953	4672	59	15894	7215	8613	9	13	31	13
서울특별시	동대문구	휘경제2동	휘경제2동제1투	2855	2063	792	6	2057	941	1111	1	1	2	1
서울특별시	동대문구	휘경제2동	휘경제2동제2투	2944	2461	483	9	2452	1070	1368	2	3	7	2
서울특별시	동대문구	휘경제2동	휘경제2동제3투	3799	2833	966	16	2817	1207	1600	1	2	7	0
서울특별시	동대문구	휘경제2동	휘경제2동제4투	4348	3209	1139	12	3197	1396	1790	2	3	3	3
서울특별시	동대문구	휘경제2동	휘경제2동제5투	3556	2937	619	8	2929	1415	1499	3	2	7	3
서울특별시	동대문구	휘경제2동	휘경제2동제6투	3123	2450	673	8	2442	1186	1245	0	2	5	4
서울특별시	동대문구	이문제1동	소계	26184	18943	7241	96	18847	8510	10223	23	21	52	18
서울특별시	동대문구	이문제1동	이문제1동제1투	3544	2227	1317	12	2215	1026	1178	2	3	3	3
서울특별시	동대문구	이문제1동	이문제1동제2투	3002	2237	765	18	2219	1021	1185	4	0	7	2
서울특별시	동대문구	이문제1동	이문제1동제3투	2510	1814	696	11	1803	785	1007	1	0	6	4
서울특별시	동대문구	이문제1동	이문제1동제4투	3213	2226	987	6	2220	956	1251	3	2	5	3
서울특별시	동대문구	이문제1동	이문제1동제5투	2888	2308	580	14	2294	1073	1212	2	4	3	0
서울특별시	동대문구	이문제1동	이문제1동제6투	3099	2323	776	12	2311	979	1318	2	6	4	2
서울특별시	동대문구	이문제1동	이문제1동제7투	2627	2059	568	8	2051	1033	1003	2	2	10	1
서울특별시	동대문구	이문제1동	이문제1동제8투	2448	1791	657	8	1783	732	1038	2	0	9	2
서울특별시	동대문구	이문제1동	이문제1동제9투	2853	1958	895	7	1951	905	1031	5	4	5	1
서울특별시	동대문구	이문제2동	소계	18252	14039	4213	69	13970	6411	7504	10	8	26	11
서울특별시	동대문구	이문제2동	이문제2동제1투	3579	2395	1184	17	2378	1125	1245	2	1	2	3
서울특별시	동대문구	이문제2동	이문제2동제2투	3653	2599	1054	19	2580	1169	1401	3	2	2	3
서울특별시	동대문구	이문제2동	이문제2동제3투	3797	3016	781	14	3002	1318	1669	1	3	9	2
서울특별시	동대문구	이문제2동	이문제2동제4투	3451	2868	583	5	2863	1310	1539	2	1	9	2
서울특별시	동대문구	이문제2동	이문제2동제5투	3772	3161	611	14	3147	1489	1650	2	1	4	1
서울특별시	동대문구	잘못 투입·구분된 투표지	잘못 투입·구분된 투표지	0	29	-29	2	27	16	11	0	0	0	0
서울특별시	중랑구	계	계	348329	253369	94960	1439	251930	121391	129630	152	138	364	255
서울특별시	중랑구	재외투표	재외투표	1851	1317	534	13	1304	495	805	1	0	2	1
서울특별시	중랑구	국내부재자투표	국내부재자투표	6853	6556	297	155	6401	3028	3283	12	21	18	39
서울특별시	중랑구	면목본동	소계	30005	20793	9212	124	20669	9790	10808	8	12	29	22
서울특별시	중랑구	면목본동	면목본동제1투	5350	3475	1875	10	3465	1648	1803	2	1	3	8
서울특별시	중랑구	면목본동	면목본동제2투	4175	2917	1258	24	2893	1330	1549	0	3	4	7
서울특별시	중랑구	면목본동	면목본동제3투	4353	3132	1221	18	3114	1452	1654	1	1	3	3
서울특별시	중랑구	면목본동	면목본동제4투	3932	2756	1176	11	2745	1340	1391	0	4	8	2
서울특별시	중랑구	면목본동	면목본동제5투	4038	2814	1224	13	2801	1364	1426	3	2	5	1
서울특별시	중랑구	면목본동	면목본동제6투	4428	3073	1355	28	3045	1413	1626	2	0	4	0
서울특별시	중랑구	면목본동	면목본동제7투	3729	2626	1103	20	2606	1243	1359	0	1	2	1
서울특별시	중랑구	면목제2동	소계	22544	15754	6790	81	15673	7364	8273	6	7	15	8
서울특별시	중랑구	면목제2동	면목제2동제1투	5184	3416	1768	16	3400	1659	1733	1	3	2	2
서울특별시	중랑구	면목제2동	면목제2동제2투	4286	3167	1119	14	3153	1450	1694	2	0	5	2
서울특별시	중랑구	면목제2동	면목제2동제3투	4573	3204	1369	18	3186	1515	1662	1	3	3	2
서울특별시	중랑구	면목제2동	면목제2동제4투	4312	2971	1341	10	2961	1386	1570	1	0	2	2
서울특별시	중랑구	면목제2동	면목제2동제5투	4189	2996	1193	23	2973	1354	1614	1	1	3	0
서울특별시	중랑구	면목제3·8동	소계	24234	17295	6939	90	17205	8195	8963	5	1	21	20
서울특별시	중랑구	면목제3·8동	면목제3·8동제1투	4165	2661	1504	15	2646	1265	1378	1	0	2	0
서울특별시	중랑구	면목제3·8동	면목제3·8동제2투	3308	2367	941	11	2356	1067	1283	1	0	4	1
서울특별시	중랑구	면목제3·8동	면목제3·8동제3투	3400	2402	998	14	2388	1074	1306	0	0	3	5
서울특별시	중랑구	면목제3·8동	면목제3·8동제4투	3469	2565	904	19	2546	1150	1390	0	0	4	2
서울특별시	중랑구	면목제3·8동	면목제3·8동제5투	3858	3000	858	11	2989	1455	1528	0	0	2	4
서울특별시	중랑구	면목제3·8동	면목제3·8동제6투	2954	2050	904	12	2038	1032	999	2	1	1	3
서울특별시	중랑구	면목제3·8동	면목제3·8동제7투	3080	2250	830	8	2242	1152	1079	1	0	5	5
서울특별시	중랑구	면목제4동	소계	18291	13043	5248	69	12974	6018	6903	12	8	20	13
서울특별시	중랑구	면목제4동	면목제4동제1투	3347	2369	978	19	2350	1104	1237	2	1	4	2
서울특별시	중랑구	면목제4동	면목제4동제2투	4322	3198	1124	16	3182	1488	1684	1	2	2	5
서울특별시	중랑구	면목제4동	면목제4동제3투	3669	2718	951	8	2710	1240	1463	4	1	1	1
서울특별시	중랑구	면목제4동	면목제4동제4투	3252	2070	1182	6	2064	888	1173	2	1	0	0
서울특별시	중랑구	면목제4동	면목제4동제5투	3701	2688	1013	20	2668	1298	1346	3	3	13	5
서울특별시	중랑구	면목제5동	소계	11552	7997	3555	45	7952	3616	4295	6	6	19	10
서울특별시	중랑구	면목제5동	면목제5동제1투	4122	2763	1359	19	2744	1238	1494	1	2	7	2
서울특별시	중랑구	면목제5동	면목제5동제2투	3461	2437	1024	13	2424	1127	1278	4	2	8	5
서울특별시	중랑구	면목제5동	면목제5동제3투	3969	2797	1172	13	2784	1251	1523	1	2	4	3
서울특별시	중랑구	면목제7동	소계	21215	15207	6008	81	15126	7254	7824	11	6	19	12
서울특별시	중랑구	면목제7동	면목제7동제1투	4098	2666	1432	17	2649	1168	1478	0	0	2	1
서울특별시	중랑구	면목제7동	면목제7동제2투	4427	3150	1277	19	3131	1519	1597	3	3	4	5
서울특별시	중랑구	면목제7동	면목제7동제3투	4175	3001	1174	16	2985	1430	1545	6	0	3	1
서울특별시	중랑구	면목제7동	면목제7동제4투	4315	3272	1043	11	3261	1625	1625	1	2	6	2
서울특별시	중랑구	면목제7동	면목제7동제5투	4200	3118	1082	18	3100	1512	1579	1	1	4	3
서울특별시	중랑구	상봉제1동	소계	19680	14749	4931	68	14681	7001	7624	11	2	27	16
서울특별시	중랑구	상봉제1동	상봉제1동제1투	4854	3301	1553	25	3276	1646	1615	5	1	4	5
서울특별시	중랑구	상봉제1동	상봉제1동제2투	4727	3733	994	9	3724	1776	1935	1	0	11	1
서울특별시	중랑구	상봉제1동	상봉제1동제3투	5053	3939	1114	15	3924	1832	2077	2	1	7	5
서울특별시	중랑구	상봉제1동	상봉제1동제4투	5046	3776	1270	19	3757	1747	1997	3	0	5	5
서울특별시	중랑구	상봉제2동	소계	15847	10826	5021	57	10769	5228	5517	5	4	9	6
서울특별시	중랑구	상봉제2동	상봉제2동제1투	4330	2821	1509	12	2809	1349	1455	2	0	0	3
서울특별시	중랑구	상봉제2동	상봉제2동제2투	4479	3192	1287	19	3173	1622	1544	1	3	2	1
서울특별시	중랑구	상봉제2동	상봉제2동제3투	4278	2948	1330	17	2931	1425	1497	0	1	7	1
서울특별시	중랑구	상봉제2동	상봉제2동제4투	2760	1865	895	9	1856	832	1021	2	0	0	1
서울특별시	중랑구	중화제1동	소계	17240	12834	4406	59	12775	6009	6716	6	5	25	14
서울특별시	중랑구	중화제1동	중화제1동제1투	4516	3185	1331	14	3171	1558	1605	1	0	4	3
서울특별시	중랑구	중화제1동	중화제1동제2투	4346	3147	1199	20	3127	1482	1633	0	2	8	2
서울특별시	중랑구	중화제1동	중화제1동제3투	4608	3386	1222	14	3372	1599	1758	2	1	7	5
서울특별시	중랑구	중화제1동	중화제1동제4투	3770	3116	654	11	3105	1370	1720	3	2	6	4
서울특별시	중랑구	중화제2동	소계	25857	17571	8286	107	17464	8412	8988	13	13	22	16
서울특별시	중랑구	중화제2동	중화제2동제1투	3214	1954	1260	13	1941	954	982	2	1	1	1
서울특별시	중랑구	중화제2동	중화제2동제2투	3078	2271	807	18	2253	1057	1189	1	3	2	1
서울특별시	중랑구	중화제2동	중화제2동제3투	3812	2607	1205	17	2590	1295	1285	0	1	6	3
서울특별시	중랑구	중화제2동	중화제2동제4투	4245	2938	1307	22	2916	1306	1597	1	4	4	4
서울특별시	중랑구	중화제2동	중화제2동제5투	3912	2628	1284	13	2615	1284	1324	2	1	1	3
서울특별시	중랑구	중화제2동	중화제2동제6투	3598	2521	1077	17	2504	1200	1298	1	0	3	2
서울특별시	중랑구	중화제2동	중화제2동제7투	3998	2652	1346	7	2645	1316	1313	6	3	5	2
서울특별시	중랑구	묵제1동	소계	28695	21741	6954	107	21634	10452	11118	6	10	30	18
서울특별시	중랑구	묵제1동	묵제1동제1투	3372	2651	721	11	2640	1261	1372	1	1	3	2
서울특별시	중랑구	묵제1동	묵제1동제2투	3873	2809	1064	19	2790	1369	1416	1	0	3	1
서울특별시	중랑구	묵제1동	묵제1동제3투	3476	2860	616	23	2837	1627	1197	0	2	8	3
서울특별시	중랑구	묵제1동	묵제1동제4투	4642	3595	1047	9	3586	1569	2002	1	4	6	4
서울특별시	중랑구	묵제1동	묵제1동제5투	5071	3796	1275	18	3778	1723	2050	1	0	2	2
서울특별시	중랑구	묵제1동	묵제1동제6투	4438	3435	1003	12	3423	1714	1698	0	2	5	4
서울특별시	중랑구	묵제1동	묵제1동제7투	3823	2595	1228	15	2580	1189	1383	2	1	3	2
서울특별시	중랑구	묵제2동	소계	16380	11815	4565	53	11762	5670	6050	7	8	15	12
서울특별시	중랑구	묵제2동	묵제2동제1투	4479	3213	1266	14	3199	1511	1681	0	1	5	1
서울특별시	중랑구	묵제2동	묵제2동제2투	3840	2718	1122	11	2707	1274	1422	2	2	2	5
서울특별시	중랑구	묵제2동	묵제2동제3투	3863	2852	1011	14	2838	1421	1405	2	3	2	5
서울특별시	중랑구	묵제2동	묵제2동제4투	4198	3032	1166	14	3018	1464	1542	3	2	6	1
서울특별시	중랑구	망우본동	소계	28309	20202	8107	104	20098	10768	9274	11	7	21	17
서울특별시	중랑구	망우본동	망우본동제1투	4438	2887	1551	12	2875	1574	1296	2	0	2	1
서울특별시	중랑구	망우본동	망우본동제2투	4238	3171	1067	14	3157	1689	1460	2	2	3	1
서울특별시	중랑구	망우본동	망우본동제3투	3815	2815	1000	19	2796	1545	1240	2	1	4	4
서울특별시	중랑구	망우본동	망우본동제4투	3202	2376	826	14	2362	1268	1089	1	0	2	2
서울특별시	중랑구	망우본동	망우본동제5투	3555	2550	1005	15	2535	1303	1224	1	1	3	3
서울특별시	중랑구	망우본동	망우본동제6투	4173	2859	1314	16	2843	1583	1254	0	3	2	1
서울특별시	중랑구	망우본동	망우본동제7투	4888	3544	1344	14	3530	1806	1711	3	0	5	5
서울특별시	중랑구	망우제3동	소계	15564	10720	4844	68	10652	5382	5236	8	10	10	6
서울특별시	중랑구	망우제3동	망우제3동제1투	3359	2237	1122	16	2221	1127	1088	2	2	1	1
서울특별시	중랑구	망우제3동	망우제3동제2투	4151	2867	1284	20	2847	1466	1369	3	2	6	1
서울특별시	중랑구	망우제3동	망우제3동제3투	4397	3057	1340	14	3043	1521	1516	0	3	1	2
서울특별시	중랑구	망우제3동	망우제3동제4투	3657	2559	1098	18	2541	1268	1263	3	3	2	2
서울특별시	중랑구	신내제1동	소계	24791	19535	5256	83	19452	9527	9851	13	11	39	11
서울특별시	중랑구	신내제1동	신내제1동제1투	4389	3338	1051	12	3326	1647	1667	3	0	5	4
서울특별시	중랑구	신내제1동	신내제1동제2투	3007	2496	511	8	2488	1244	1239	0	1	4	0
서울특별시	중랑구	신내제1동	신내제1동제3투	3251	2598	653	10	2588	1240	1335	1	2	9	1
서울특별시	중랑구	신내제1동	신내제1동제4투	4015	3174	841	12	3162	1412	1739	2	3	5	1
서울특별시	중랑구	신내제1동	신내제1동제5투	3890	3125	765	14	3111	1491	1610	1	1	5	3
서울특별시	중랑구	신내제1동	신내제1동제6투	2831	2062	769	15	2047	1070	967	4	1	4	1
서울특별시	중랑구	신내제1동	신내제1동제7투	3408	2742	666	12	2730	1423	1294	2	3	7	1
서울특별시	중랑구	신내제2동	소계	19421	15382	4039	75	15307	7166	8086	11	7	23	14
서울특별시	중랑구	신내제2동	신내제2동제1투	3716	2926	790	8	2918	1437	1466	0	3	9	3
서울특별시	중랑구	신내제2동	신내제2동제2투	3647	2952	695	12	2940	1222	1709	1	0	3	5
서울특별시	중랑구	신내제2동	신내제2동제3투	4204	3491	713	19	3472	1727	1738	2	1	2	2
서울특별시	중랑구	신내제2동	신내제2동제4투	3937	3046	891	20	3026	1366	1651	0	1	6	2
서울특별시	중랑구	신내제2동	신내제2동제5투	3917	2967	950	16	2951	1414	1522	8	2	3	2
서울특별시	중랑구	잘못 투입·구분된 투표지	잘못 투입·구분된 투표지	0	32	-32	0	32	16	16	0	0	0	0
서울특별시	성북구	계	계	396699	295525	101174	1474	294051	134557	158429	174	181	459	251
서울특별시	성북구	재외투표	재외투표	3457	2525	932	14	2511	1013	1489	0	2	6	1
서울특별시	성북구	국내부재자투표	국내부재자투표	7809	7282	527	126	7156	3266	3839	9	5	14	23
서울특별시	성북구	성북동	소계	15768	11512	4256	53	11459	5421	5988	6	12	25	7
서울특별시	성북구	성북동	성북동제1투	4407	3308	1099	14	3294	1413	1874	1	2	3	1
서울특별시	성북구	성북동	성북동제2투	4559	3027	1532	21	3006	1521	1472	2	4	6	1
서울특별시	성북구	성북동	성북동제3투	3257	2511	746	11	2500	1380	1106	2	3	5	4
서울특별시	성북구	성북동	성북동제4투	3545	2666	879	7	2659	1107	1536	1	3	11	1
서울특별시	성북구	삼선동	소계	22973	16841	6132	88	16753	7237	9454	9	14	23	16
서울특별시	성북구	삼선동	삼선동제1투	5097	3561	1536	15	3546	1655	1878	1	2	3	7
서울특별시	성북구	삼선동	삼선동제2투	3722	2643	1079	18	2625	1125	1488	2	4	3	3
서울특별시	성북구	삼선동	삼선동제3투	4107	3252	855	14	3238	1327	1900	2	3	5	1
서울특별시	성북구	삼선동	삼선동제4투	5397	4066	1331	18	4048	1779	2256	1	4	5	3
서울특별시	성북구	삼선동	삼선동제5투	4650	3319	1331	23	3296	1351	1932	3	1	7	2
서울특별시	성북구	동선동	소계	13735	10041	3694	48	9993	4264	5692	9	5	14	9
서울특별시	성북구	동선동	동선동제1투	2869	1951	918	12	1939	817	1113	3	2	2	2
서울특별시	성북구	동선동	동선동제2투	3595	2601	994	7	2594	1021	1567	3	0	2	1
서울특별시	성북구	동선동	동선동제3투	3239	2426	813	16	2410	1079	1323	2	1	3	2
서울특별시	성북구	동선동	동선동제4투	4032	3063	969	13	3050	1347	1689	1	2	7	4
서울특별시	성북구	돈암제1동	소계	13196	10248	2948	41	10207	4797	5367	7	7	15	14
서울특별시	성북구	돈암제1동	돈암제1동제1투	3330	2553	777	8	2545	1126	1407	0	2	6	4
서울특별시	성북구	돈암제1동	돈암제1동제2투	3393	2615	778	12	2603	1291	1305	1	0	2	4
서울특별시	성북구	돈암제1동	돈암제1동제3투	3282	2718	564	8	2710	1303	1395	2	4	3	3
서울특별시	성북구	돈암제1동	돈암제1동제4투	3191	2362	829	13	2349	1077	1260	4	1	4	3
서울특별시	성북구	돈암제2동	소계	17439	13939	3500	43	13896	6665	7171	10	11	28	11
서울특별시	성북구	돈암제2동	돈암제2동제1투	3460	2668	792	4	2664	1273	1377	0	1	9	4
서울특별시	성북구	돈암제2동	돈암제2동제2투	3529	2932	597	13	2919	1382	1525	1	1	6	4
서울특별시	성북구	돈암제2동	돈암제2동제3투	3321	2727	594	3	2724	1077	1631	4	5	5	2
서울특별시	성북구	돈암제2동	돈암제2동제4투	3828	3122	706	15	3107	1719	1383	0	3	2	0
서울특별시	성북구	돈암제2동	돈암제2동제5투	3301	2490	811	8	2482	1214	1255	5	1	6	1
서울특별시	성북구	안암동	소계	14268	10397	3871	57	10340	4444	5857	0	9	16	14
서울특별시	성북구	안암동	안암동제1투	3302	2210	1092	13	2197	981	1209	0	2	1	4
서울특별시	성북구	안암동	안암동제2투	3201	2336	865	16	2320	878	1432	0	2	4	4
서울특별시	성북구	안암동	안암동제3투	4386	3292	1094	15	3277	1411	1852	0	3	7	4
서울특별시	성북구	안암동	안암동제4투	3379	2559	820	13	2546	1174	1364	0	2	4	2
서울특별시	성북구	보문동	소계	11809	8371	3438	48	8323	3778	4513	2	6	18	6
서울특별시	성북구	보문동	보문동제1투	5000	3373	1627	13	3360	1506	1838	0	2	10	4
서울특별시	성북구	보문동	보문동제2투	4478	3300	1178	23	3277	1527	1737	2	3	6	2
서울특별시	성북구	보문동	보문동제3투	2331	1698	633	12	1686	745	938	0	1	2	0
서울특별시	성북구	정릉제1동	소계	15875	12221	3654	54	12167	5520	6600	5	7	23	12
서울특별시	성북구	정릉제1동	정릉제1동제1투	4431	3391	1040	14	3377	1532	1836	1	2	4	2
서울특별시	성북구	정릉제1동	정릉제1동제2투	4557	3418	1139	18	3400	1624	1760	3	3	7	3
서울특별시	성북구	정릉제1동	정릉제1동제3투	3316	2552	764	16	2536	1166	1357	0	1	7	5
서울특별시	성북구	정릉제1동	정릉제1동제4투	3571	2860	711	6	2854	1198	1647	1	1	5	2
서울특별시	성북구	정릉제2동	소계	19416	14042	5374	55	13987	6666	7276	8	11	20	6
서울특별시	성북구	정릉제2동	정릉제2동제1투	4575	3547	1028	11	3536	1681	1844	2	3	4	2
서울특별시	성북구	정릉제2동	정릉제2동제2투	4816	3475	1341	16	3459	1612	1830	1	4	8	4
서울특별시	성북구	정릉제2동	정릉제2동제3투	4946	3416	1530	12	3404	1670	1729	1	2	2	0
서울특별시	성북구	정릉제2동	정릉제2동제4투	5079	3604	1475	16	3588	1703	1873	4	2	6	0
서울특별시	성북구	정릉제3동	소계	14379	10289	4090	64	10225	5037	5146	7	8	23	4
서울특별시	성북구	정릉제3동	정릉제3동제1투	4602	3213	1389	21	3192	1539	1642	1	3	6	1
서울특별시	성북구	정릉제3동	정릉제3동제2투	2367	1633	734	15	1618	843	767	3	1	2	2
서울특별시	성북구	정릉제3동	정릉제3동제3투	4037	2960	1077	16	2944	1414	1515	1	1	12	1
서울특별시	성북구	정릉제3동	정릉제3동제4투	3373	2483	890	12	2471	1241	1222	2	3	3	0
서울특별시	성북구	정릉제4동	소계	21987	16243	5744	74	16169	7414	8694	11	11	24	15
서울특별시	성북구	정릉제4동	정릉제4동제1투	3965	3097	868	15	3082	1478	1587	3	0	12	2
서울특별시	성북구	정릉제4동	정릉제4동제2투	5304	3752	1552	20	3732	1681	2037	2	6	2	4
서울특별시	성북구	정릉제4동	정릉제4동제3투	4741	3243	1498	13	3230	1491	1727	3	1	6	2
서울특별시	성북구	정릉제4동	정릉제4동제4투	2828	2098	730	9	2089	1082	1002	1	1	1	2
서울특별시	성북구	정릉제4동	정릉제4동제5투	5149	4053	1096	17	4036	1682	2341	2	3	3	5
서울특별시	성북구	길음제1동	소계	27544	21935	5609	72	21863	9570	12227	9	6	37	14
서울특별시	성북구	길음제1동	길음제1동제1투	4270	3524	746	9	3515	1473	2030	2	2	6	2
서울특별시	성북구	길음제1동	길음제1동제2투	4962	3816	1146	12	3804	1630	2167	0	0	6	1
서울특별시	성북구	길음제1동	길음제1동제3투	4731	3515	1216	18	3497	1412	2072	2	0	6	5
서울특별시	성북구	길음제1동	길음제1동제4투	4738	3722	1016	10	3712	1799	1900	3	3	6	1
서울특별시	성북구	길음제1동	길음제1동제5투	3741	3110	631	10	3100	1383	1713	0	0	3	1
서울특별시	성북구	길음제1동	길음제1동제6투	2614	2179	435	8	2171	905	1256	1	0	8	1
서울특별시	성북구	길음제1동	길음제1동제7투	2488	2069	419	5	2064	968	1089	1	1	2	3
서울특별시	성북구	길음제2동	소계	17084	12095	4989	69	12026	5570	6417	4	3	21	11
서울특별시	성북구	길음제2동	길음제2동제1투	3767	2419	1348	19	2400	1094	1295	2	0	5	4
서울특별시	성북구	길음제2동	길음제2동제2투	5244	3734	1510	23	3711	1799	1901	1	0	8	2
서울특별시	성북구	길음제2동	길음제2동제3투	4005	2655	1350	18	2637	1231	1400	0	3	1	2
서울특별시	성북구	길음제2동	길음제2동제4투	4068	3287	781	9	3278	1446	1821	1	0	7	3
서울특별시	성북구	종암동	소계	33835	25721	8114	111	25610	11318	14204	14	19	32	23
서울특별시	성북구	종암동	종암동제1투	4696	3598	1098	10	3588	1577	2003	1	0	6	1
서울특별시	성북구	종암동	종암동제2투	4541	3593	948	11	3582	1610	1963	2	3	3	1
서울특별시	성북구	종암동	종암동제3투	4316	3362	954	19	3343	1556	1777	2	3	4	1
서울특별시	성북구	종암동	종암동제4투	4373	3388	985	14	3374	1431	1921	2	6	4	10
서울특별시	성북구	종암동	종암동제5투	3487	2227	1260	14	2213	1077	1130	2	1	1	2
서울특별시	성북구	종암동	종암동제6투	4300	3494	806	17	3477	1497	1968	2	1	7	2
서울특별시	성북구	종암동	종암동제7투	4554	3246	1308	15	3231	1408	1815	1	4	1	2
서울특별시	성북구	종암동	종암동제8투	3568	2813	755	11	2802	1162	1627	2	1	6	4
서울특별시	성북구	월곡제1동	소계	22760	17249	5511	96	17153	7224	9869	13	8	26	13
서울특별시	성북구	월곡제1동	월곡제1동제1투	4390	3131	1259	10	3121	1311	1803	1	0	3	3
서울특별시	성북구	월곡제1동	월곡제1동제2투	3301	2337	964	24	2313	937	1369	1	1	5	0
서울특별시	성북구	월곡제1동	월곡제1동제3투	3506	2565	941	14	2551	1181	1359	3	1	2	5
서울특별시	성북구	월곡제1동	월곡제1동제4투	3131	2464	667	15	2449	1074	1364	1	3	5	2
서울특별시	성북구	월곡제1동	월곡제1동제5투	3795	2993	802	15	2978	1274	1695	3	2	3	1
서울특별시	성북구	월곡제1동	월곡제1동제6투	4637	3759	878	18	3741	1447	2279	4	1	8	2
서울특별시	성북구	월곡제2동	소계	17439	13149	4290	56	13093	6081	6970	12	8	13	9
서울특별시	성북구	월곡제2동	월곡제2동제1투	4616	3233	1383	19	3214	1479	1720	5	3	2	5
서울특별시	성북구	월곡제2동	월곡제2동제2투	4175	3318	857	9	3309	1539	1760	4	2	4	0
서울특별시	성북구	월곡제2동	월곡제2동제3투	4111	3007	1104	12	2995	1370	1614	2	0	6	3
서울특별시	성북구	월곡제2동	월곡제2동제4투	4537	3591	946	16	3575	1693	1876	1	3	1	1
서울특별시	성북구	장위제1동	소계	21006	14600	6406	82	14518	6694	7782	9	7	18	8
서울특별시	성북구	장위제1동	장위제1동제1투	4263	2758	1505	11	2747	1286	1456	1	1	1	2
서울특별시	성북구	장위제1동	장위제1동제2투	3348	2378	970	14	2364	1113	1240	4	2	4	1
서울특별시	성북구	장위제1동	장위제1동제3투	3643	2600	1043	21	2579	1245	1329	0	2	3	0
서울특별시	성북구	장위제1동	장위제1동제4투	3013	2120	893	10	2110	1005	1101	0	1	1	2
서울특별시	성북구	장위제1동	장위제1동제5투	2988	2123	865	10	2113	944	1159	4	1	5	0
서울특별시	성북구	장위제1동	장위제1동제6투	3751	2621	1130	16	2605	1101	1497	0	0	4	3
서울특별시	성북구	장위제2동	소계	18621	13118	5503	63	13055	6491	6516	12	6	17	13
서울특별시	성북구	장위제2동	장위제2동제1투	3885	2888	997	11	2877	1432	1433	2	3	3	4
서울특별시	성북구	장위제2동	장위제2동제2투	3711	2455	1256	16	2439	1250	1174	2	0	8	5
서울특별시	성북구	장위제2동	장위제2동제3투	3214	2315	899	11	2304	1142	1158	0	2	2	0
서울특별시	성북구	장위제2동	장위제2동제4투	3845	2669	1176	13	2656	1389	1261	4	0	1	1
서울특별시	성북구	장위제2동	장위제2동제5투	3966	2791	1175	12	2779	1278	1490	4	1	3	3
서울특별시	성북구	장위제3동	소계	15448	11150	4298	71	11079	5461	5587	8	5	12	6
서울특별시	성북구	장위제3동	장위제3동제1투	4054	2772	1282	26	2746	1410	1327	3	1	3	2
서울특별시	성북구	장위제3동	장위제3동제2투	3919	2793	1126	23	2770	1345	1414	2	3	4	2
서울특별시	성북구	장위제3동	장위제3동제3투	3736	2614	1122	10	2604	1301	1297	2	0	4	0
서울특별시	성북구	장위제3동	장위제3동제4투	3739	2971	768	12	2959	1405	1549	1	1	1	2
서울특별시	성북구	석관동	소계	30851	22504	8347	89	22415	10600	11744	10	11	34	16
서울특별시	성북구	석관동	석관동제1투	4707	3124	1583	12	3112	1452	1656	0	0	3	1
서울특별시	성북구	석관동	석관동제2투	3754	2714	1040	15	2699	1277	1412	1	3	5	1
서울특별시	성북구	석관동	석관동제3투	4839	3403	1436	20	3383	1642	1731	2	1	4	3
서울특별시	성북구	석관동	석관동제4투	3216	2370	846	6	2364	1196	1161	2	0	3	2
서울특별시	성북구	석관동	석관동제5투	5112	4137	975	9	4128	1969	2146	2	2	5	4
서울특별시	성북구	석관동	석관동제6투	2814	1987	827	10	1977	920	1050	1	3	3	0
서울특별시	성북구	석관동	석관동제7투	4140	3068	1072	8	3060	1355	1693	0	1	9	2
서울특별시	성북구	석관동	석관동제8투	2269	1701	568	9	1692	789	895	2	1	2	3
서울특별시	성북구	잘못 투입·구분된 투표지	잘못 투입·구분된 투표지	0	53	-53	0	53	26	27	0	0	0	0
서울특별시	강북구	계	계	286118	207927	78191	1187	206740	94479	111470	169	110	341	171
서울특별시	강북구	재외투표	재외투표	1870	1369	501	8	1361	549	807	2	1	2	0
서울특별시	강북구	국내부재자투표	국내부재자투표	5126	4847	279	113	4734	2179	2514	5	6	6	24
서울특별시	강북구	삼양동	소계	25442	17854	7588	107	17747	7659	10016	11	7	32	22
서울특별시	강북구	삼양동	삼양동제1투	3929	2394	1535	9	2385	1018	1362	0	0	3	2
서울특별시	강북구	삼양동	삼양동제2투	3269	2359	910	16	2343	1036	1293	1	2	5	6
서울특별시	강북구	삼양동	삼양동제3투	3195	2202	993	13	2189	935	1247	1	1	3	2
서울특별시	강북구	삼양동	삼양동제4투	3703	2617	1086	15	2602	1150	1439	4	1	5	3
서울특별시	강북구	삼양동	삼양동제5투	3705	2748	957	15	2733	1135	1589	0	1	6	2
서울특별시	강북구	삼양동	삼양동제6투	2812	1936	876	13	1923	812	1101	4	1	4	1
서울특별시	강북구	삼양동	삼양동제7투	1903	1308	595	12	1296	615	680	0	0	0	1
서울특별시	강북구	삼양동	삼양동제8투	2926	2290	636	14	2276	958	1305	1	1	6	5
서울특별시	강북구	미아동	소계	19823	14304	5519	66	14238	6400	7786	10	11	25	6
서울특별시	강북구	미아동	미아동제1투	4094	2759	1335	6	2753	1162	1583	2	1	5	0
서울특별시	강북구	미아동	미아동제2투	2130	1557	573	8	1549	667	872	2	2	6	0
서울특별시	강북구	미아동	미아동제3투	4007	2948	1059	16	2932	1415	1508	1	2	2	4
서울특별시	강북구	미아동	미아동제4투	3241	2365	876	13	2352	1110	1229	3	1	8	1
서울특별시	강북구	미아동	미아동제5투	3109	2314	795	13	2301	1022	1271	0	3	4	1
서울특별시	강북구	미아동	미아동제6투	3242	2361	881	10	2351	1024	1323	2	2	0	0
서울특별시	강북구	송중동	소계	28048	19937	8111	89	19848	8761	11021	15	10	26	15
서울특별시	강북구	송중동	송중동제1투	2905	1740	1165	9	1731	789	936	1	0	1	4
서울특별시	강북구	송중동	송중동제2투	3306	2300	1006	13	2287	1015	1261	2	3	5	1
서울특별시	강북구	송중동	송중동제3투	3783	2751	1032	6	2745	1224	1515	0	2	1	3
서울특별시	강북구	송중동	송중동제4투	3957	2912	1045	14	2898	1260	1629	2	2	4	1
서울특별시	강북구	송중동	송중동제5투	3829	2838	991	9	2829	1175	1645	1	1	4	3
서울특별시	강북구	송중동	송중동제6투	2968	2098	870	13	2085	954	1125	3	0	3	0
서울특별시	강북구	송중동	송중동제7투	3567	2662	905	15	2647	1201	1439	1	2	3	1
서울특별시	강북구	송중동	송중동제8투	3733	2636	1097	10	2626	1143	1471	5	0	5	2
서울특별시	강북구	송천동	소계	26658	18960	7698	109	18851	8316	10453	18	10	40	14
서울특별시	강북구	송천동	송천동제1투	4067	2532	1535	13	2519	1106	1401	2	1	7	2
서울특별시	강북구	송천동	송천동제2투	3134	2214	920	10	2204	925	1267	6	2	2	2
서울특별시	강북구	송천동	송천동제3투	3092	2277	815	13	2264	959	1292	0	3	8	2
서울특별시	강북구	송천동	송천동제4투	3122	2360	762	15	2345	1056	1284	0	1	4	0
서울특별시	강북구	송천동	송천동제5투	3326	2408	918	24	2384	1050	1325	2	0	3	4
서울특별시	강북구	송천동	송천동제6투	2972	2117	855	13	2104	963	1132	3	1	4	1
서울특별시	강북구	송천동	송천동제7투	3417	2490	927	10	2480	1119	1346	3	2	8	2
서울특별시	강북구	송천동	송천동제8투	3528	2562	966	11	2551	1138	1406	2	0	4	1
서울특별시	강북구	삼각산동	소계	25048	19784	5264	79	19705	8132	11507	9	6	43	8
서울특별시	강북구	삼각산동	삼각산동제1투	3380	2676	704	8	2668	1129	1528	1	2	7	1
서울특별시	강북구	삼각산동	삼각산동제2투	3590	2232	1358	17	2215	979	1230	2	0	4	0
서울특별시	강북구	삼각산동	삼각산동제3투	3739	3085	654	8	3077	1188	1879	3	0	5	2
서울특별시	강북구	삼각산동	삼각산동제4투	2707	2235	472	11	2224	1005	1215	0	0	3	1
서울특별시	강북구	삼각산동	삼각산동제5투	3593	2990	603	14	2976	1177	1793	1	1	4	0
서울특별시	강북구	삼각산동	삼각산동제6투	2763	2254	509	5	2249	951	1291	1	1	5	0
서울특별시	강북구	삼각산동	삼각산동제7투	2689	2216	473	7	2209	881	1315	0	1	10	2
서울특별시	강북구	삼각산동	삼각산동제8투	2587	2096	491	9	2087	822	1256	1	1	5	2
서울특별시	강북구	번제1동	소계	17274	11950	5324	65	11885	5519	6334	9	5	11	7
서울특별시	강북구	번제1동	번제1동제1투	4018	2546	1472	13	2533	1195	1335	0	1	1	1
서울특별시	강북구	번제1동	번제1동제2투	3219	2381	838	17	2364	1062	1292	2	1	4	3
서울특별시	강북구	번제1동	번제1동제3투	3863	2669	1194	11	2658	1265	1384	2	1	4	2
서울특별시	강북구	번제1동	번제1동제4투	3545	2511	1034	7	2504	1114	1382	4	1	2	1
서울특별시	강북구	번제1동	번제1동제5투	2629	1843	786	17	1826	883	941	1	1	0	0
서울특별시	강북구	번제2동	소계	16046	11757	4289	50	11707	5229	6423	15	8	21	11
서울특별시	강북구	번제2동	번제2동제1투	3758	2938	820	9	2929	1351	1568	1	2	6	1
서울특별시	강북구	번제2동	번제2동제2투	2823	2060	763	14	2046	924	1108	3	2	4	5
서울특별시	강북구	번제2동	번제2동제3투	3483	2493	990	6	2487	1137	1337	8	1	4	0
서울특별시	강북구	번제2동	번제2동제4투	2972	2131	841	16	2115	952	1148	2	3	5	5
서울특별시	강북구	번제2동	번제2동제5투	3010	2135	875	5	2130	865	1262	1	0	2	0
서울특별시	강북구	번제3동	소계	17162	12857	4305	82	12775	5831	6889	14	7	21	13
서울특별시	강북구	번제3동	번제3동제1투	3143	2196	947	17	2179	1057	1113	1	1	5	2
서울특별시	강북구	번제3동	번제3동제2투	3753	2932	821	8	2924	1244	1673	1	0	5	1
서울특별시	강북구	번제3동	번제3동제3투	2731	1970	761	22	1948	887	1048	2	3	4	4
서울특별시	강북구	번제3동	번제3동제4투	3680	2794	886	24	2770	1296	1460	6	0	3	5
서울특별시	강북구	번제3동	번제3동제5투	3855	2965	890	11	2954	1347	1595	4	3	4	1
서울특별시	강북구	수유제1동	소계	19092	13444	5648	71	13373	6100	7228	12	5	17	11
서울특별시	강북구	수유제1동	수유제1동제1투	3847	2554	1293	16	2538	1162	1369	2	1	2	2
서울특별시	강북구	수유제1동	수유제1동제2투	3954	2825	1129	22	2803	1221	1574	0	1	4	3
서울특별시	강북구	수유제1동	수유제1동제3투	3345	2404	941	9	2395	1050	1341	0	0	2	2
서울특별시	강북구	수유제1동	수유제1동제4투	3553	2566	987	12	2554	1208	1334	3	1	5	3
서울특별시	강북구	수유제1동	수유제1동제5투	4393	3095	1298	12	3083	1459	1610	7	2	4	1
서울특별시	강북구	수유제2동	소계	19067	14285	4782	78	14207	7224	6926	15	5	28	9
서울특별시	강북구	수유제2동	수유제2동제1투	4224	3177	1047	18	3159	1629	1519	3	1	6	1
서울특별시	강북구	수유제2동	수유제2동제2투	4106	2972	1134	13	2959	1465	1479	4	2	6	3
서울특별시	강북구	수유제2동	수유제2동제3투	3630	2972	658	15	2957	1605	1339	1	1	7	4
서울특별시	강북구	수유제2동	수유제2동제4투	3371	2464	907	6	2458	1179	1273	3	1	2	0
서울특별시	강북구	수유제2동	수유제2동제5투	3736	2700	1036	26	2674	1346	1316	4	0	7	1
서울특별시	강북구	수유제3동	소계	20137	13971	6166	74	13897	6698	7155	11	5	20	8
서울특별시	강북구	수유제3동	수유제3동제1투	2496	1752	744	7	1745	823	917	2	1	2	0
서울특별시	강북구	수유제3동	수유제3동제2투	3476	2412	1064	18	2394	1162	1224	2	0	5	1
서울특별시	강북구	수유제3동	수유제3동제3투	3464	2340	1124	12	2328	1140	1182	2	2	1	1
서울특별시	강북구	수유제3동	수유제3동제4투	3238	2393	845	13	2380	1128	1244	1	0	5	2
서울특별시	강북구	수유제3동	수유제3동제5투	3944	2526	1418	16	2510	1205	1296	1	1	4	3
서울특별시	강북구	수유제3동	수유제3동제6투	3519	2548	971	8	2540	1240	1292	3	1	3	1
서울특별시	강북구	우이동	소계	17733	12760	4973	79	12681	6370	6260	11	8	21	11
서울특별시	강북구	우이동	우이동제1투	4811	3217	1594	17	3200	1687	1497	4	2	8	2
서울특별시	강북구	우이동	우이동제2투	4560	3361	1199	18	3343	1628	1702	1	1	4	7
서울특별시	강북구	우이동	우이동제3투	4340	3163	1177	23	3140	1505	1619	4	4	7	1
서울특별시	강북구	우이동	우이동제4투	4022	3019	1003	21	2998	1550	1442	2	1	2	1
서울특별시	강북구	인수동	소계	27592	19824	7768	117	19707	9505	10134	12	16	28	12
서울특별시	강북구	인수동	인수동제1투	3353	2212	1141	10	2202	1092	1101	1	2	4	2
서울특별시	강북구	인수동	인수동제2투	3181	2380	801	13	2367	1136	1226	0	1	3	1
서울특별시	강북구	인수동	인수동제3투	3204	2375	829	18	2357	1141	1209	4	2	1	0
서울특별시	강북구	인수동	인수동제4투	2953	2169	784	10	2159	1081	1071	1	6	0	0
서울특별시	강북구	인수동	인수동제5투	3249	2137	1112	9	2128	1037	1083	1	0	6	1
서울특별시	강북구	인수동	인수동제6투	3726	2724	1002	12	2712	1323	1376	2	3	4	4
서울특별시	강북구	인수동	인수동제7투	3663	2737	926	15	2722	1268	1444	2	1	4	3
서울특별시	강북구	인수동	인수동제8투	4263	3090	1173	30	3060	1427	1624	1	1	6	1
서울특별시	강북구	잘못 투입·구분된 투표지	잘못 투입·구분된 투표지	0	24	-24	0	24	7	17	0	0	0	0
서울특별시	도봉구	계	계	296521	225230	71291	1147	224083	106942	116266	128	150	404	193
서울특별시	도봉구	재외투표	재외투표	1957	1415	542	10	1405	563	839	1	0	1	1
서울특별시	도봉구	국내부재자투표	국내부재자투표	6469	6088	381	124	5964	2871	3036	9	16	15	17
서울특별시	도봉구	쌍문1동	소계	17713	12950	4763	76	12874	6125	6700	9	4	27	9
서울특별시	도봉구	쌍문1동	쌍문1동제1투	3514	2370	1144	13	2357	1065	1281	5	0	1	5
서울특별시	도봉구	쌍문1동	쌍문1동제2투	3752	2676	1076	17	2659	1239	1413	1	1	4	1
서울특별시	도봉구	쌍문1동	쌍문1동제3투	3661	2806	855	14	2792	1303	1480	1	2	4	2
서울특별시	도봉구	쌍문1동	쌍문1동제4투	3204	2461	743	14	2447	1185	1253	0	0	8	1
서울특별시	도봉구	쌍문1동	쌍문1동제5투	3582	2637	945	18	2619	1333	1273	2	1	10	0
서울특별시	도봉구	쌍문2동	소계	17440	12795	4645	63	12732	6075	6599	9	16	23	10
서울특별시	도봉구	쌍문2동	쌍문2동제1투	4142	2812	1330	19	2793	1316	1468	1	2	3	3
서울특별시	도봉구	쌍문2동	쌍문2동제2투	3747	2708	1039	12	2696	1323	1351	4	5	8	5
서울특별시	도봉구	쌍문2동	쌍문2동제3투	2848	2145	703	11	2134	1077	1048	2	0	6	1
서울특별시	도봉구	쌍문2동	쌍문2동제4투	3388	2719	669	10	2709	1282	1416	0	6	4	1
서울특별시	도봉구	쌍문2동	쌍문2동제5투	3315	2411	904	11	2400	1077	1316	2	3	2	0
서울특별시	도봉구	쌍문3동	소계	15295	11308	3987	56	11252	5239	5977	1	5	19	11
서울특별시	도봉구	쌍문3동	쌍문3동제1투	4648	3403	1245	18	3385	1612	1769	0	0	4	0
서울특별시	도봉구	쌍문3동	쌍문3동제2투	3894	2855	1039	10	2845	1244	1589	0	3	4	5
서울특별시	도봉구	쌍문3동	쌍문3동제3투	3301	2380	921	15	2365	1103	1252	1	2	4	3
서울특별시	도봉구	쌍문3동	쌍문3동제4투	3452	2670	782	13	2657	1280	1367	0	0	7	3
서울특별시	도봉구	쌍문4동	소계	16781	13056	3725	46	13010	6343	6624	6	4	23	10
서울특별시	도봉구	쌍문4동	쌍문4동제1투	4135	3134	1001	9	3125	1514	1605	2	0	3	1
서울특별시	도봉구	쌍문4동	쌍문4동제2투	4299	3449	850	16	3433	1663	1763	1	1	3	2
서울특별시	도봉구	쌍문4동	쌍문4동제3투	3792	3019	773	12	3007	1492	1498	1	1	10	5
서울특별시	도봉구	쌍문4동	쌍문4동제4투	4555	3454	1101	9	3445	1674	1758	2	2	7	2
서울특별시	도봉구	방학1동	소계	25875	18983	6892	87	18896	9436	9395	8	9	32	16
서울특별시	도봉구	방학1동	방학1동제1투	3939	2618	1321	14	2604	1212	1377	3	2	5	5
서울특별시	도봉구	방학1동	방학1동제2투	3647	2662	985	21	2641	1342	1290	1	3	4	1
서울특별시	도봉구	방학1동	방학1동제3투	3932	2758	1174	18	2740	1267	1464	0	1	6	2
서울특별시	도봉구	방학1동	방학1동제4투	4475	3230	1245	14	3216	1614	1593	2	0	4	3
서울특별시	도봉구	방학1동	방학1동제5투	5045	3811	1234	13	3798	1863	1929	0	1	5	0
서울특별시	도봉구	방학1동	방학1동제6투	4837	3904	933	7	3897	2138	1742	2	2	8	5
서울특별시	도봉구	방학2동	소계	19098	13415	5683	91	13324	6371	6904	14	5	17	13
서울특별시	도봉구	방학2동	방학2동제1투	3563	2343	1220	12	2331	1117	1205	1	0	5	3
서울특별시	도봉구	방학2동	방학2동제2투	2889	2146	743	17	2129	1019	1103	1	0	4	2
서울특별시	도봉구	방학2동	방학2동제3투	3007	2176	831	17	2159	1048	1101	3	3	1	3
서울특별시	도봉구	방학2동	방학2동제4투	3183	2272	911	11	2261	1089	1163	3	2	3	1
서울특별시	도봉구	방학2동	방학2동제5투	3095	2126	969	16	2110	1015	1089	2	0	2	2
서울특별시	도봉구	방학2동	방학2동제6투	3361	2352	1009	18	2334	1083	1243	4	0	2	2
서울특별시	도봉구	방학3동	소계	24508	19376	5132	75	19301	9312	9923	10	17	32	7
서울특별시	도봉구	방학3동	방학3동제1투	3778	2956	822	10	2946	1309	1628	2	0	6	1
서울특별시	도봉구	방학3동	방학3동제2투	3713	2929	784	10	2919	1426	1483	1	6	3	0
서울특별시	도봉구	방학3동	방학3동제3투	4299	3250	1049	12	3238	1662	1568	1	2	4	1
서울특별시	도봉구	방학3동	방학3동제4투	3216	2482	734	13	2469	1193	1267	1	1	7	0
서울특별시	도봉구	방학3동	방학3동제5투	2935	2389	546	6	2383	1196	1175	4	1	4	3
서울특별시	도봉구	방학3동	방학3동제6투	3103	2559	544	11	2548	1153	1384	1	3	6	1
서울특별시	도봉구	방학3동	방학3동제7투	3464	2811	653	13	2798	1373	1418	0	4	2	1
서울특별시	도봉구	창1동	소계	22273	17310	4963	76	17234	7882	9294	8	9	30	11
서울특별시	도봉구	창1동	창1동제1투	4215	3225	990	10	3215	1509	1692	1	3	6	4
서울특별시	도봉구	창1동	창1동제2투	3023	2118	905	8	2110	971	1133	2	1	3	0
서울특별시	도봉구	창1동	창1동제3투	3156	2314	842	15	2299	1076	1217	2	0	2	2
서울특별시	도봉구	창1동	창1동제4투	4244	3413	831	16	3397	1528	1857	1	0	9	2
서울특별시	도봉구	창1동	창1동제5투	4245	3554	691	12	3542	1668	1866	0	1	6	1
서울특별시	도봉구	창1동	창1동제6투	3390	2686	704	15	2671	1130	1529	2	4	4	2
서울특별시	도봉구	창2동	소계	24866	18534	6332	86	18448	8497	9888	11	14	26	12
서울특별시	도봉구	창2동	창2동제1투	3644	2662	982	12	2650	1256	1388	1	1	3	1
서울특별시	도봉구	창2동	창2동제2투	4521	3255	1266	16	3239	1526	1702	1	3	4	3
서울특별시	도봉구	창2동	창2동제3투	4041	3176	865	20	3156	1396	1746	3	3	5	3
서울특별시	도봉구	창2동	창2동제4투	3837	3081	756	10	3071	1499	1560	0	3	8	1
서울특별시	도봉구	창2동	창2동제5투	4548	3343	1205	12	3331	1433	1884	3	3	5	3
서울특별시	도봉구	창2동	창2동제6투	4275	3017	1258	16	3001	1387	1608	3	1	1	1
서울특별시	도봉구	창3동	소계	12805	9113	3692	54	9059	4290	4734	4	8	15	8
서울특별시	도봉구	창3동	창3동제1투	3041	2075	966	13	2062	1055	1000	0	3	1	3
서울특별시	도봉구	창3동	창3동제2투	4129	2943	1186	15	2928	1304	1614	1	3	6	0
서울특별시	도봉구	창3동	창3동제3투	2565	1776	789	13	1763	817	940	1	0	3	2
서울특별시	도봉구	창3동	창3동제4투	3070	2319	751	13	2306	1114	1180	2	2	5	3
서울특별시	도봉구	창4동	소계	23489	18951	4538	67	18884	8641	10154	12	16	50	11
서울특별시	도봉구	창4동	창4동제1투	3983	3102	881	7	3095	1300	1778	2	1	13	1
서울특별시	도봉구	창4동	창4동제2투	3306	2491	815	18	2473	1038	1424	0	6	3	2
서울특별시	도봉구	창4동	창4동제3투	4368	3503	865	14	3489	1761	1711	5	2	8	2
서울특별시	도봉구	창4동	창4동제4투	4175	3534	641	7	3527	1646	1864	3	2	8	4
서울특별시	도봉구	창4동	창4동제5투	3552	2896	656	9	2887	1317	1560	1	2	5	2
서울특별시	도봉구	창4동	창4동제6투	4105	3425	680	12	3413	1579	1817	1	3	13	0
서울특별시	도봉구	창5동	소계	22050	17391	4659	57	17334	8506	8760	7	9	31	21
서울특별시	도봉구	창5동	창5동제1투	3563	2757	806	8	2749	1224	1514	0	2	5	4
서울특별시	도봉구	창5동	창5동제2투	3103	2432	671	11	2421	1034	1376	2	2	3	4
서울특별시	도봉구	창5동	창5동제3투	3564	2793	771	10	2783	1289	1483	1	1	4	5
서울특별시	도봉구	창5동	창5동제4투	4101	3071	1030	13	3058	1494	1555	2	3	0	4
서울특별시	도봉구	창5동	창5동제5투	2231	1914	317	7	1907	1060	842	0	0	4	1
서울특별시	도봉구	창5동	창5동제6투	3307	2772	535	6	2766	1573	1179	1	0	10	3
서울특별시	도봉구	창5동	창5동제7투	2181	1652	529	2	1650	832	811	1	1	5	0
서울특별시	도봉구	도봉1동	소계	20465	14797	5668	86	14711	7487	7160	11	9	22	22
서울특별시	도봉구	도봉1동	도봉1동제1투	3376	2147	1229	11	2136	1088	1041	1	1	2	3
서울특별시	도봉구	도봉1동	도봉1동제2투	4755	3614	1141	19	3595	1863	1715	5	1	6	5
서울특별시	도봉구	도봉1동	도봉1동제3투	2641	1924	717	11	1913	911	985	0	3	7	7
서울특별시	도봉구	도봉1동	도봉1동제4투	2009	1474	535	8	1466	787	672	0	2	1	4
서울특별시	도봉구	도봉1동	도봉1동제5투	3003	2332	671	15	2317	1244	1068	1	1	2	1
서울특별시	도봉구	도봉1동	도봉1동제6투	4681	3306	1375	22	3284	1594	1679	4	1	4	2
서울특별시	도봉구	도봉2동	소계	25437	19733	5704	92	19641	9295	10274	8	9	41	14
서울특별시	도봉구	도봉2동	도봉2동제1투	3186	2098	1088	10	2088	968	1110	0	3	4	3
서울특별시	도봉구	도봉2동	도봉2동제2투	3353	2676	677	13	2663	1290	1364	1	2	4	2
서울특별시	도봉구	도봉2동	도봉2동제3투	3095	2146	949	16	2130	1017	1104	1	1	4	3
서울특별시	도봉구	도봉2동	도봉2동제4투	3367	2627	740	13	2614	1122	1486	1	0	5	0
서울특별시	도봉구	도봉2동	도봉2동제5투	3928	3193	735	10	3183	1559	1613	1	1	6	3
서울특별시	도봉구	도봉2동	도봉2동제6투	3993	3269	724	16	3253	1513	1729	3	1	5	2
서울특별시	도봉구	도봉2동	도봉2동제7투	4515	3724	791	14	3710	1826	1868	1	1	13	1
서울특별시	도봉구	잘못 투입·구분된 투표지	잘못 투입·구분된 투표지	0	15	-15	1	14	9	5	0	0	0	0
서울특별시	노원구	계	계	473741	368003	105738	1905	366098	170114	194546	220	203	689	326
서울특별시	노원구	재외투표	재외투표	3316	2373	943	21	2352	908	1430	1	4	6	3
서울특별시	노원구	국내부재자투표	국내부재자투표	12033	11257	776	189	11068	5292	5677	17	20	29	33
서울특별시	노원구	월계1동	소계	18607	14090	4517	68	14022	6597	7385	10	6	14	10
서울특별시	노원구	월계1동	월계1동제1투	4006	3015	991	7	3008	1425	1574	2	2	2	3
서울특별시	노원구	월계1동	월계1동제2투	3591	2782	809	18	2764	1363	1394	2	0	2	3
서울특별시	노원구	월계1동	월계1동제3투	4640	3601	1039	18	3583	1637	1937	2	2	4	1
서울특별시	노원구	월계1동	월계1동제4투	3899	2944	955	12	2932	1324	1598	3	2	3	2
서울특별시	노원구	월계1동	월계1동제5투	2471	1748	723	13	1735	848	882	1	0	3	1
서울특별시	노원구	월계2동	소계	24427	18218	6209	102	18116	8683	9359	10	11	32	21
서울특별시	노원구	월계2동	월계2동제1투	4442	3214	1228	16	3198	1668	1516	4	0	8	2
서울특별시	노원구	월계2동	월계2동제2투	3825	2920	905	6	2914	1255	1651	0	2	3	3
서울특별시	노원구	월계2동	월계2동제3투	3830	3052	778	15	3037	1458	1563	1	1	8	6
서울특별시	노원구	월계2동	월계2동제4투	5005	3892	1113	26	3866	1723	2131	0	4	5	3
서울특별시	노원구	월계2동	월계2동제5투	4049	2756	1293	27	2729	1421	1295	3	4	3	3
서울특별시	노원구	월계2동	월계2동제6투	3276	2384	892	12	2372	1158	1203	2	0	5	4
서울특별시	노원구	월계3동	소계	28201	22373	5828	110	22263	10120	12062	16	11	30	24
서울특별시	노원구	월계3동	월계3동제1투	2709	1994	715	8	1986	842	1140	1	0	1	2
서울특별시	노원구	월계3동	월계3동제2투	3255	2662	593	9	2653	1167	1477	0	5	3	1
서울특별시	노원구	월계3동	월계3동제3투	3227	2614	613	10	2604	1165	1432	1	0	4	2
서울특별시	노원구	월계3동	월계3동제4투	3535	2889	646	15	2874	1156	1709	1	1	3	4
서울특별시	노원구	월계3동	월계3동제5투	3849	3221	628	9	3212	1489	1715	0	0	6	2
서울특별시	노원구	월계3동	월계3동제6투	3749	3142	607	10	3132	1596	1528	0	1	4	3
서울특별시	노원구	월계3동	월계3동제7투	2140	1769	371	6	1763	792	967	3	0	1	0
서울특별시	노원구	월계3동	월계3동제8투	2701	1943	758	15	1928	841	1071	3	3	5	5
서울특별시	노원구	월계3동	월계3동제9투	3036	2139	897	28	2111	1072	1023	7	1	3	5
서울특별시	노원구	공릉1동	소계	32454	24620	7834	127	24493	11181	13235	9	12	37	19
서울특별시	노원구	공릉1동	공릉1동제1투	3354	2358	996	6	2352	1129	1213	1	3	4	2
서울특별시	노원구	공릉1동	공릉1동제2투	4932	3774	1158	10	3764	1692	2061	3	0	6	2
서울특별시	노원구	공릉1동	공릉1동제3투	3913	2599	1314	12	2587	1132	1447	1	4	2	1
서울특별시	노원구	공릉1동	공릉1동제4투	3574	2677	897	18	2659	1243	1403	0	2	9	2
서울특별시	노원구	공릉1동	공릉1동제5투	3225	2369	856	33	2336	1168	1158	2	0	2	6
서울특별시	노원구	공릉1동	공릉1동제6투	2633	1997	636	10	1987	903	1078	0	1	1	4
서울특별시	노원구	공릉1동	공릉1동제7투	3589	2874	715	12	2862	1306	1551	1	1	3	0
서울특별시	노원구	공릉1동	공릉1동제8투	3494	2809	685	14	2795	1170	1620	0	0	4	1
서울특별시	노원구	공릉1동	공릉1동제9투	3740	3163	577	12	3151	1438	1704	1	1	6	1
서울특별시	노원구	공릉2동	소계	34945	27736	7209	120	27616	13076	14425	16	13	65	21
서울특별시	노원구	공릉2동	공릉2동제1투	4506	3460	1046	13	3447	1433	2003	0	1	7	3
서울특별시	노원구	공릉2동	공릉2동제2투	3994	3303	691	11	3292	1612	1669	2	1	8	0
서울특별시	노원구	공릉2동	공릉2동제3투	4107	3236	871	15	3221	1467	1734	2	3	11	4
서울특별시	노원구	공릉2동	공릉2동제4투	4288	3440	848	16	3424	1576	1837	2	2	7	0
서울특별시	노원구	공릉2동	공릉2동제5투	4258	3479	779	18	3461	1634	1813	4	2	7	1
서울특별시	노원구	공릉2동	공릉2동제6투	4214	3254	960	13	3241	1555	1674	1	1	8	2
서울특별시	노원구	공릉2동	공릉2동제7투	4006	3087	919	15	3072	1414	1639	2	1	11	5
서울특별시	노원구	공릉2동	공릉2동제8투	5572	4477	1095	19	4458	2385	2056	3	2	6	6
서울특별시	노원구	하계1동	소계	23646	18445	5201	100	18345	9041	9220	11	11	42	20
서울특별시	노원구	하계1동	하계1동제1투	3969	3178	791	10	3168	1779	1376	0	1	10	2
서울특별시	노원구	하계1동	하계1동제2투	3783	2899	884	34	2865	1338	1506	6	6	4	5
서울특별시	노원구	하계1동	하계1동제3투	3896	2809	1087	21	2788	1461	1312	3	2	6	4
서울특별시	노원구	하계1동	하계1동제4투	4068	3227	841	8	3219	1520	1686	1	1	7	4
서울특별시	노원구	하계1동	하계1동제5투	4601	3604	997	19	3585	1754	1817	0	0	10	4
서울특별시	노원구	하계1동	하계1동제6투	3329	2728	601	8	2720	1189	1523	1	1	5	1
서울특별시	노원구	하계2동	소계	19106	15247	3859	72	15175	6984	8131	12	11	30	7
서울특별시	노원구	하계2동	하계2동제1투	4059	3087	972	22	3065	1262	1794	3	1	2	3
서울특별시	노원구	하계2동	하계2동제2투	2937	2086	851	16	2070	1003	1049	5	4	7	2
서울특별시	노원구	하계2동	하계2동제3투	4284	3641	643	9	3632	1778	1847	2	1	4	0
서울특별시	노원구	하계2동	하계2동제4투	3871	3166	705	11	3155	1377	1763	1	3	10	1
서울특별시	노원구	하계2동	하계2동제5투	3955	3267	688	14	3253	1564	1678	1	2	7	1
서울특별시	노원구	중계본동	소계	21189	16601	4588	67	16534	8024	8449	7	6	37	11
서울특별시	노원구	중계본동	중계본동제1투	3247	2434	813	6	2428	1266	1153	4	2	2	1
서울특별시	노원구	중계본동	중계본동제2투	2743	1719	1024	15	1704	848	852	0	1	1	2
서울특별시	노원구	중계본동	중계본동제3투	4159	3425	734	14	3411	1520	1884	1	1	4	1
서울특별시	노원구	중계본동	중계본동제4투	3827	3180	647	16	3164	1456	1695	1	0	9	3
서울특별시	노원구	중계본동	중계본동제5투	3187	2498	689	4	2494	1210	1268	1	1	12	2
서울특별시	노원구	중계본동	중계본동제6투	4026	3345	681	12	3333	1724	1597	0	1	9	2
서울특별시	노원구	중계1동	소계	20546	16707	3839	59	16648	7546	9046	9	6	34	7
서울특별시	노원구	중계1동	중계1동제1투	4284	3367	917	14	3353	1473	1867	2	1	8	2
서울특별시	노원구	중계1동	중계1동제2투	4164	3293	871	12	3281	1487	1790	0	1	2	1
서울특별시	노원구	중계1동	중계1동제3투	3767	3145	622	8	3137	1382	1746	2	1	5	1
서울특별시	노원구	중계1동	중계1동제4투	4331	3618	713	12	3606	1589	2004	2	2	8	1
서울특별시	노원구	중계1동	중계1동제5투	4000	3284	716	13	3271	1615	1639	3	1	11	2
서울특별시	노원구	중계2·3동	소계	32542	25109	7433	149	24960	11372	13472	20	13	51	32
서울특별시	노원구	중계2·3동	중계2·3동제1투	3391	2731	660	8	2723	1167	1547	0	1	7	1
서울특별시	노원구	중계2·3동	중계2·3동제2투	3743	3127	616	16	3111	1504	1597	2	0	7	1
서울특별시	노원구	중계2·3동	중계2·3동제3투	2953	2327	626	12	2315	919	1382	2	2	4	6
서울특별시	노원구	중계2·3동	중계2·3동제4투	3058	2251	807	12	2239	921	1307	1	3	3	4
서울특별시	노원구	중계2·3동	중계2·3동제5투	3786	2917	869	10	2907	1272	1623	2	0	8	2
서울특별시	노원구	중계2·3동	중계2·3동제6투	3205	2622	583	13	2609	1068	1533	1	2	4	1
서울특별시	노원구	중계2·3동	중계2·3동제7투	2752	2145	607	15	2130	1099	1016	5	1	7	2
서울특별시	노원구	중계2·3동	중계2·3동제8투	3301	2435	866	25	2410	1121	1279	3	3	1	3
서울특별시	노원구	중계2·3동	중계2·3동제9투	2303	1682	621	20	1662	895	755	2	1	4	5
서울특별시	노원구	중계2·3동	중계2·3동제10투	4050	2872	1178	18	2854	1406	1433	2	0	6	7
서울특별시	노원구	중계4동	소계	17418	13531	3887	72	13459	6244	7156	15	6	27	11
서울특별시	노원구	중계4동	중계4동제1투	4639	3442	1197	16	3426	1458	1959	2	2	4	1
서울특별시	노원구	중계4동	중계4동제2투	4072	3078	994	28	3050	1506	1525	4	4	5	6
서울특별시	노원구	중계4동	중계4동제3투	4329	3580	749	15	3565	1668	1882	4	0	8	3
서울특별시	노원구	중계4동	중계4동제4투	4378	3431	947	13	3418	1612	1790	5	0	10	1
서울특별시	노원구	상계1동	소계	34463	26512	7951	127	26385	12625	13654	7	22	51	26
서울특별시	노원구	상계1동	상계1동제1투	5098	3444	1654	18	3426	1559	1856	2	4	4	1
서울특별시	노원구	상계1동	상계1동제2투	3862	3001	861	11	2990	1284	1692	1	1	10	2
서울특별시	노원구	상계1동	상계1동제3투	4684	3742	942	16	3726	1529	2176	1	6	10	4
서울특별시	노원구	상계1동	상계1동제4투	4411	3416	995	15	3401	1951	1430	1	5	9	5
서울특별시	노원구	상계1동	상계1동제5투	4133	3168	965	23	3145	1465	1667	0	3	6	4
서울특별시	노원구	상계1동	상계1동제6투	4203	3411	792	17	3394	1680	1707	1	1	4	1
서울특별시	노원구	상계1동	상계1동제7투	3899	3027	872	18	3009	1539	1460	1	1	2	6
서울특별시	노원구	상계1동	상계1동제8투	4173	3303	870	9	3294	1618	1666	0	1	6	3
서울특별시	노원구	상계2동	소계	17929	13388	4541	75	13313	6531	6739	5	8	24	6
서울특별시	노원구	상계2동	상계2동제1투	4869	3356	1513	22	3334	1604	1706	3	4	15	2
서울특별시	노원구	상계2동	상계2동제2투	4477	3356	1121	15	3341	1679	1657	1	2	2	0
서울특별시	노원구	상계2동	상계2동제3투	4520	3448	1072	18	3430	1690	1739	1	0	0	0
서울특별시	노원구	상계2동	상계2동제4투	4063	3228	835	20	3208	1558	1637	0	2	7	4
서울특별시	노원구	상계3·4동	소계	31670	22579	9091	141	22438	10838	11502	26	9	41	22
서울특별시	노원구	상계3·4동	상계3·4동제1투	3117	2096	1021	14	2082	1065	1006	2	0	4	5
서울특별시	노원구	상계3·4동	상계3·4동제2투	3129	2251	878	9	2242	1156	1075	3	0	6	2
서울특별시	노원구	상계3·4동	상계3·4동제3투	3326	2739	587	7	2732	1309	1411	2	1	5	4
서울특별시	노원구	상계3·4동	상계3·4동제4투	3269	2430	839	14	2416	1151	1254	4	3	4	0
서울특별시	노원구	상계3·4동	상계3·4동제5투	3113	2167	946	13	2154	1075	1070	5	1	1	2
서울특별시	노원구	상계3·4동	상계3·4동제6투	3268	2599	669	17	2582	1260	1307	4	2	8	1
서울특별시	노원구	상계3·4동	상계3·4동제7투	3734	2622	1112	20	2602	1161	1435	1	1	3	1
서울특별시	노원구	상계3·4동	상계3·4동제8투	4543	2821	1722	26	2795	1299	1482	3	1	6	4
서울특별시	노원구	상계3·4동	상계3·4동제9투	4171	2854	1317	21	2833	1362	1462	2	0	4	3
서울특별시	노원구	상계5동	소계	19348	14344	5004	83	14261	6915	7293	7	9	23	14
서울특별시	노원구	상계5동	상계5동제1투	3838	2535	1303	13	2522	1234	1279	0	3	4	2
서울특별시	노원구	상계5동	상계5동제2투	4200	3164	1036	22	3142	1523	1610	5	1	2	1
서울특별시	노원구	상계5동	상계5동제3투	3533	2580	953	18	2562	1285	1268	0	2	4	3
서울특별시	노원구	상계5동	상계5동제4투	4153	3295	858	13	3282	1560	1711	1	0	6	4
서울특별시	노원구	상계5동	상계5동제5투	3624	2770	854	17	2753	1313	1425	1	3	7	4
서울특별시	노원구	상계6·7동	소계	28158	22086	6072	81	22005	9819	12113	9	5	49	10
서울특별시	노원구	상계6·7동	상계6·7동제1투	3969	3151	818	13	3138	1421	1708	0	0	7	2
서울특별시	노원구	상계6·7동	상계6·7동제2투	3947	3094	853	15	3079	1395	1676	0	1	6	1
서울특별시	노원구	상계6·7동	상계6·7동제3투	3973	3214	759	7	3207	1402	1785	5	2	10	3
서울특별시	노원구	상계6·7동	상계6·7동제4투	3758	3001	757	9	2992	1331	1648	0	1	11	1
서울특별시	노원구	상계6·7동	상계6·7동제5투	4368	3279	1089	15	3264	1434	1825	1	0	3	1
서울특별시	노원구	상계6·7동	상계6·7동제6투	4270	3149	1121	13	3136	1343	1780	2	1	9	1
서울특별시	노원구	상계6·7동	상계6·7동제7투	3873	3198	675	9	3189	1493	1691	1	0	3	1
서울특별시	노원구	상계8동	소계	19206	15400	3806	45	15355	6069	9227	8	9	32	10
서울특별시	노원구	상계8동	상계8동제1투	3588	2869	719	7	2862	1251	1597	1	6	4	3
서울특별시	노원구	상계8동	상계8동제2투	4037	3270	767	9	3261	1341	1905	2	1	11	1
서울특별시	노원구	상계8동	상계8동제3투	3986	3185	801	12	3173	1343	1821	2	0	4	3
서울특별시	노원구	상계8동	상계8동제4투	3631	2823	808	6	2817	751	2056	2	0	6	2
서울특별시	노원구	상계8동	상계8동제5투	3964	3253	711	11	3242	1383	1848	1	2	7	1
서울특별시	노원구	상계9동	소계	18544	14738	3806	54	14684	6580	8066	3	3	18	14
서울특별시	노원구	상계9동	상계9동제1투	4580	3566	1014	12	3554	1637	1907	2	1	4	3
서울특별시	노원구	상계9동	상계9동제2투	4822	3978	844	14	3964	1835	2117	0	0	8	4
서울특별시	노원구	상계9동	상계9동제3투	4273	3314	959	15	3299	1424	1868	0	0	4	3
서울특별시	노원구	상계9동	상계9동제4투	4869	3880	989	13	3867	1684	2174	1	2	2	4
서울특별시	노원구	상계10동	소계	15993	12605	3388	42	12563	5644	6887	2	8	17	5
서울특별시	노원구	상계10동	상계10동제1투	4261	3406	855	8	3398	1814	1573	0	2	7	2
서울특별시	노원구	상계10동	상계10동제2투	3762	2907	855	11	2896	1235	1654	1	4	2	0
서울특별시	노원구	상계10동	상계10동제3투	3893	3036	857	13	3023	1208	1812	0	1	2	0
서울특별시	노원구	상계10동	상계10동제4투	4077	3256	821	10	3246	1387	1848	1	1	6	3
서울특별시	노원구	잘못 투입·구분된 투표지	잘못 투입·구분된 투표지	0	44	-44	1	43	25	18	0	0	0	0
서울특별시	은평구	계	계	409466	300923	108543	1630	299293	135878	162177	213	212	543	270
서울특별시	은평구	재외투표	재외투표	3007	2226	781	10	2216	893	1308	0	4	10	1
서울특별시	은평구	국내부재자투표	국내부재자투표	8328	7817	511	158	7659	3601	3991	11	15	21	20
서울특별시	은평구	녹번동	소계	27062	19086	7976	102	18984	8508	10381	20	18	34	23
서울특별시	은평구	녹번동	녹번동제1투	4990	3199	1791	18	3181	1389	1778	3	3	3	5
서울특별시	은평구	녹번동	녹번동제2투	3981	2988	993	19	2969	1409	1546	0	2	8	4
서울특별시	은평구	녹번동	녹번동제3투	3444	2416	1028	14	2402	1003	1386	8	1	0	4
서울특별시	은평구	녹번동	녹번동제4투	3838	2822	1016	14	2808	1318	1479	1	2	6	2
서울특별시	은평구	녹번동	녹번동제5투	2076	1397	679	10	1387	637	742	2	2	4	0
서울특별시	은평구	녹번동	녹번동제6투	4223	2950	1273	15	2935	1318	1603	2	3	4	5
서울특별시	은평구	녹번동	녹번동제7투	4510	3314	1196	12	3302	1434	1847	4	5	9	3
서울특별시	은평구	응암제1동	소계	25156	17943	7213	91	17852	7843	9946	8	11	31	13
서울특별시	은평구	응암제1동	응암제1동제1투	4295	2966	1329	12	2954	1304	1638	0	1	9	2
서울특별시	은평구	응암제1동	응암제1동제2투	3323	2445	878	14	2431	1097	1332	0	0	1	1
서울특별시	은평구	응암제1동	응암제1동제3투	3841	2682	1159	16	2666	1189	1463	1	3	7	3
서울특별시	은평구	응암제1동	응암제1동제4투	4131	3048	1083	20	3028	1372	1646	1	0	5	4
서울특별시	은평구	응암제1동	응암제1동제5투	4760	3348	1412	14	3334	1494	1825	3	6	4	2
서울특별시	은평구	응암제1동	응암제1동제6투	4806	3454	1352	15	3439	1387	2042	3	1	5	1
서울특별시	은평구	응암제2동	소계	20736	14814	5922	92	14722	6521	8132	10	9	30	20
서울특별시	은평구	응암제2동	응암제2동제1투	5397	3646	1751	18	3628	1560	2053	3	1	7	4
서울특별시	은평구	응암제2동	응암제2동제2투	3808	2591	1217	27	2564	1211	1343	1	0	4	5
서울특별시	은평구	응암제2동	응암제2동제3투	4153	3088	1065	19	3069	1298	1758	4	2	4	3
서울특별시	은평구	응암제2동	응암제2동제4투	3856	2893	963	10	2883	1234	1632	1	3	9	4
서울특별시	은평구	응암제2동	응암제2동제5투	3522	2596	926	18	2578	1218	1346	1	3	6	4
서울특별시	은평구	응암제3동	소계	22725	15886	6839	94	15792	6985	8738	16	8	24	21
서울특별시	은평구	응암제3동	응암제3동제1투	4583	3105	1478	9	3096	1305	1779	3	0	5	4
서울특별시	은평구	응암제3동	응암제3동제2투	3977	2787	1190	25	2762	1258	1497	2	0	1	4
서울특별시	은평구	응암제3동	응암제3동제3투	4308	2982	1326	13	2969	1214	1741	2	2	6	4
서울특별시	은평구	응암제3동	응암제3동제4투	3003	2015	988	11	2004	909	1081	5	0	4	5
서울특별시	은평구	응암제3동	응암제3동제5투	3280	2482	798	17	2465	1138	1318	2	2	3	2
서울특별시	은평구	응암제3동	응암제3동제6투	3574	2515	1059	19	2496	1161	1322	2	4	5	2
서울특별시	은평구	증산동	소계	16945	12779	4166	74	12705	5784	6865	11	15	18	12
서울특별시	은평구	증산동	증산동제1투	4157	2979	1178	19	2960	1327	1619	3	2	5	4
서울특별시	은평구	증산동	증산동제2투	4484	3412	1072	25	3387	1541	1833	3	3	3	4
서울특별시	은평구	증산동	증산동제3투	4011	3073	938	12	3061	1443	1608	2	3	2	3
서울특별시	은평구	증산동	증산동제4투	4293	3315	978	18	3297	1473	1805	3	7	8	1
서울특별시	은평구	수색동	소계	16109	11980	4129	85	11895	5693	6148	11	7	23	13
서울특별시	은평구	수색동	수색동제1투	2946	2103	843	13	2090	999	1083	1	1	4	2
서울특별시	은평구	수색동	수색동제2투	3276	2481	795	25	2456	1171	1272	2	2	6	3
서울특별시	은평구	수색동	수색동제3투	3569	2602	967	20	2582	1214	1353	6	2	3	4
서울특별시	은평구	수색동	수색동제4투	3022	2144	878	18	2126	1055	1062	2	1	5	1
서울특별시	은평구	수색동	수색동제5투	3296	2650	646	9	2641	1254	1378	0	1	5	3
서울특별시	은평구	신사제1동	소계	22368	16840	5528	75	16765	7237	9465	12	15	21	15
서울특별시	은평구	신사제1동	신사제1동제1투	4982	3572	1410	19	3553	1479	2052	5	8	3	6
서울특별시	은평구	신사제1동	신사제1동제2투	4578	3524	1054	16	3508	1500	1992	2	5	7	2
서울특별시	은평구	신사제1동	신사제1동제3투	4715	3461	1254	20	3441	1422	2005	3	2	5	4
서울특별시	은평구	신사제1동	신사제1동제4투	3229	2478	751	11	2467	1088	1374	1	0	3	1
서울특별시	은평구	신사제1동	신사제1동제5투	4864	3805	1059	9	3796	1748	2042	1	0	3	2
서울특별시	은평구	신사제2동	소계	18205	13353	4852	57	13296	5935	7315	11	10	18	7
서울특별시	은평구	신사제2동	신사제2동제1투	3276	2471	805	14	2457	1109	1345	0	2	1	0
서울특별시	은평구	신사제2동	신사제2동제2투	3900	2961	939	6	2955	1352	1591	5	2	4	1
서울특별시	은평구	신사제2동	신사제2동제3투	3851	2627	1224	16	2611	1128	1470	4	5	3	1
서울특별시	은평구	신사제2동	신사제2동제4투	3407	2612	795	10	2602	1166	1426	1	0	6	3
서울특별시	은평구	신사제2동	신사제2동제5투	3771	2682	1089	11	2671	1180	1483	1	1	4	2
서울특별시	은평구	갈현제2동	소계	22430	16203	6227	64	16139	7696	8382	7	9	25	20
서울특별시	은평구	갈현제2동	갈현제2동제1투	4826	3317	1509	16	3301	1511	1781	2	0	3	4
서울특별시	은평구	갈현제2동	갈현제2동제2투	4466	3313	1153	11	3302	1620	1666	3	2	4	7
서울특별시	은평구	갈현제2동	갈현제2동제3투	5049	3546	1503	24	3522	1663	1847	0	2	7	3
서울특별시	은평구	갈현제2동	갈현제2동제4투	3897	2855	1042	7	2848	1427	1410	2	3	5	1
서울특별시	은평구	갈현제2동	갈현제2동제5투	4192	3172	1020	6	3166	1475	1678	0	2	6	5
서울특별시	은평구	구산동	소계	26827	18848	7979	116	18732	9038	9614	13	7	40	20
서울특별시	은평구	구산동	구산동제1투	5700	3697	2003	21	3676	1716	1945	0	2	11	2
서울특별시	은평구	구산동	구산동제2투	4860	3584	1276	24	3560	1660	1892	0	1	6	1
서울특별시	은평구	구산동	구산동제3투	4444	2712	1732	36	2676	1334	1320	5	4	5	8
서울특별시	은평구	구산동	구산동제4투	2424	1821	603	3	1818	850	963	2	0	2	1
서울특별시	은평구	구산동	구산동제5투	4827	3637	1190	17	3620	1778	1822	3	0	14	3
서울특별시	은평구	구산동	구산동제6투	4572	3397	1175	15	3382	1700	1672	3	0	2	5
서울특별시	은평구	갈현제1동	소계	21081	15036	6045	69	14967	6974	7937	6	13	30	7
서울특별시	은평구	갈현제1동	갈현제1동제1투	3972	2716	1256	19	2697	1263	1425	1	2	5	1
서울특별시	은평구	갈현제1동	갈현제1동제2투	3813	2740	1073	14	2726	1316	1400	1	4	3	2
서울특별시	은평구	갈현제1동	갈현제1동제3투	4239	3090	1149	12	3078	1370	1691	1	2	13	1
서울특별시	은평구	갈현제1동	갈현제1동제4투	4640	3264	1376	12	3252	1557	1686	1	0	6	2
서울특별시	은평구	갈현제1동	갈현제1동제5투	4417	3226	1191	12	3214	1468	1735	2	5	3	1
서울특별시	은평구	진관동	소계	35773	28713	7060	85	28628	12725	15788	16	21	59	19
서울특별시	은평구	진관동	진관동제1투	3888	3124	764	12	3112	1416	1677	2	4	11	2
서울특별시	은평구	진관동	진관동제2투	3749	3056	693	12	3044	1413	1620	1	3	7	0
서울특별시	은평구	진관동	진관동제3투	3459	2780	679	9	2771	1279	1487	2	1	2	0
서울특별시	은평구	진관동	진관동제4투	4934	3525	1409	14	3511	1634	1859	2	5	9	2
서울특별시	은평구	진관동	진관동제5투	3523	2895	628	6	2889	1268	1607	4	0	6	4
서울특별시	은평구	진관동	진관동제6투	4265	3517	748	12	3505	1729	1759	2	3	9	3
서울특별시	은평구	진관동	진관동제7투	2591	2087	504	3	2084	974	1102	0	2	4	2
서울특별시	은평구	진관동	진관동제8투	2564	2125	439	1	2124	954	1161	0	1	5	3
서울특별시	은평구	진관동	진관동제9투	3441	2870	571	8	2862	1103	1752	2	2	2	1
서울특별시	은평구	진관동	진관동제10투	3359	2734	625	8	2726	955	1764	1	0	4	2
서울특별시	은평구	불광제1동	소계	33221	25026	8195	106	24920	11517	13314	11	16	45	17
서울특별시	은평구	불광제1동	불광제1동제1투	3197	1872	1325	8	1864	864	994	0	2	4	0
서울특별시	은평구	불광제1동	불광제1동제2투	4967	4084	883	14	4070	1905	2148	3	2	11	1
서울특별시	은평구	불광제1동	불광제1동제3투	4257	3112	1145	20	3092	1372	1711	2	1	2	4
서울특별시	은평구	불광제1동	불광제1동제4투	3203	2687	516	14	2673	1374	1288	1	3	6	1
서울특별시	은평구	불광제1동	불광제1동제5투	4597	3693	904	10	3683	1558	2110	1	2	10	2
서울특별시	은평구	불광제1동	불광제1동제6투	3754	2736	1018	9	2727	1275	1448	0	1	2	1
서울특별시	은평구	불광제1동	불광제1동제7투	5512	4117	1395	16	4101	1903	2186	2	2	4	4
서울특별시	은평구	불광제1동	불광제1동제8투	3734	2725	1009	15	2710	1266	1429	2	3	6	4
서울특별시	은평구	불광제2동	소계	25065	17956	7109	98	17858	8510	9273	13	10	38	14
서울특별시	은평구	불광제2동	불광제2동제1투	3557	2412	1145	16	2396	1192	1196	1	1	5	1
서울특별시	은평구	불광제2동	불광제2동제2투	3668	2610	1058	16	2594	1251	1329	2	2	10	0
서울특별시	은평구	불광제2동	불광제2동제3투	3954	2858	1096	12	2846	1317	1515	3	5	4	2
서울특별시	은평구	불광제2동	불광제2동제4투	3204	2234	970	15	2219	999	1208	3	0	5	4
서울특별시	은평구	불광제2동	불광제2동제5투	3889	2798	1091	8	2790	1261	1517	2	0	5	5
서울특별시	은평구	불광제2동	불광제2동제6투	2996	2249	747	14	2235	1104	1127	0	0	3	1
서울특별시	은평구	불광제2동	불광제2동제7투	3797	2795	1002	17	2778	1386	1381	2	2	6	1
서울특별시	은평구	대조동	소계	25821	18322	7499	109	18213	8152	9988	17	13	35	8
서울특별시	은평구	대조동	대조동제1투	4697	3449	1248	24	3425	1578	1834	4	0	5	4
서울특별시	은평구	대조동	대조동제2투	5169	3530	1639	23	3507	1515	1978	2	4	6	2
서울특별시	은평구	대조동	대조동제3투	4272	3039	1233	12	3027	1424	1587	5	2	8	1
서울특별시	은평구	대조동	대조동제4투	4022	2837	1185	23	2814	1238	1567	2	2	4	1
서울특별시	은평구	대조동	대조동제5투	3066	2104	962	12	2092	907	1177	3	2	3	0
서울특별시	은평구	대조동	대조동제6투	4595	3363	1232	15	3348	1490	1845	1	3	9	0
서울특별시	은평구	역촌동	소계	38607	28076	10531	145	27931	12254	15585	20	11	41	20
서울특별시	은평구	역촌동	역촌동제1투	5240	3382	1858	19	3363	1471	1885	1	1	5	0
서울특별시	은평구	역촌동	역촌동제2투	4481	3426	1055	19	3407	1470	1925	2	1	7	2
서울특별시	은평구	역촌동	역촌동제3투	4128	3088	1040	16	3072	1403	1662	0	2	2	3
서울특별시	은평구	역촌동	역촌동제4투	4511	3252	1259	16	3236	1442	1783	3	1	4	3
서울특별시	은평구	역촌동	역촌동제5투	3661	2656	1005	18	2638	1169	1457	2	1	6	3
서울특별시	은평구	역촌동	역촌동제6투	3239	2363	876	12	2351	1132	1209	3	1	5	1
서울특별시	은평구	역촌동	역촌동제7투	3644	2643	1001	13	2630	1183	1438	1	1	5	2
서울특별시	은평구	역촌동	역촌동제8투	4640	3484	1156	14	3470	1390	2066	4	2	4	4
서울특별시	은평구	역촌동	역촌동제9투	5063	3782	1281	18	3764	1594	2160	4	1	3	2
서울특별시	은평구	잘못 투입·구분된 투표지	잘못 투입·구분된 투표지	0	19	-19	0	19	12	7	0	0	0	0
서울특별시	서대문구	계	계	261540	196130	65410	1072	195058	88811	105412	156	147	378	154
서울특별시	서대문구	재외투표	재외투표	2703	1995	708	12	1983	837	1134	0	5	5	2
서울특별시	서대문구	국내부재자투표	국내부재자투표	5259	4898	361	78	4820	2218	2573	3	6	15	5
서울특별시	서대문구	충현동	소계	16759	11940	4819	67	11873	5760	6060	11	8	26	8
서울특별시	서대문구	충현동	충현동제1투	4257	2801	1456	8	2793	1372	1414	3	0	3	1
서울특별시	서대문구	충현동	충현동제2투	3993	2904	1089	27	2877	1437	1423	4	1	10	2
서울특별시	서대문구	충현동	충현동제3투	1378	1015	363	3	1012	535	476	0	0	1	0
서울특별시	서대문구	충현동	충현동제4투	3802	2815	987	14	2801	1345	1441	2	6	4	3
서울특별시	서대문구	충현동	충현동제5투	3329	2405	924	15	2390	1071	1306	2	1	8	2
서울특별시	서대문구	천연동	소계	15993	12360	3633	64	12296	5655	6588	11	4	27	11
서울특별시	서대문구	천연동	천연동제1투	3848	2742	1106	12	2730	1358	1359	1	2	7	3
서울특별시	서대문구	천연동	천연동제2투	3928	3063	865	20	3043	1293	1741	2	1	3	3
서울특별시	서대문구	천연동	천연동제3투	3405	2671	734	12	2659	1180	1465	2	1	8	3
서울특별시	서대문구	천연동	천연동제4투	802	607	195	2	605	229	374	0	0	2	0
서울특별시	서대문구	천연동	천연동제5투	4010	3277	733	18	3259	1595	1649	6	0	7	2
서울특별시	서대문구	북아현동	소계	9051	6568	2483	37	6531	2858	3641	9	7	9	7
서울특별시	서대문구	북아현동	북아현동제1투	3475	2432	1043	14	2418	1140	1267	3	3	4	1
서울특별시	서대문구	북아현동	북아현동제2투	2844	2032	812	15	2017	817	1187	6	1	3	3
서울특별시	서대문구	북아현동	북아현동제3투	2732	2104	628	8	2096	901	1187	0	3	2	3
서울특별시	서대문구	신촌동	소계	15947	11180	4767	50	11130	4602	6483	6	11	22	6
서울특별시	서대문구	신촌동	신촌동제1투	2327	1663	664	3	1660	758	894	0	3	5	0
서울특별시	서대문구	신촌동	신촌동제2투	3319	2173	1146	12	2161	1043	1107	1	3	5	2
서울특별시	서대문구	신촌동	신촌동제3투	2789	1881	908	8	1873	795	1069	3	2	3	1
서울특별시	서대문구	신촌동	신촌동제4투	3922	2790	1132	17	2773	1072	1689	2	3	4	3
서울특별시	서대문구	신촌동	신촌동제5투	3590	2673	917	10	2663	934	1724	0	0	5	0
서울특별시	서대문구	연희동	소계	33644	25154	8490	125	25029	11617	13304	21	17	49	21
서울특별시	서대문구	연희동	연희동제1투	4351	2791	1560	12	2779	1402	1368	1	0	5	3
서울특별시	서대문구	연희동	연희동제2투	2740	2156	584	8	2148	1134	1007	0	1	6	0
서울특별시	서대문구	연희동	연희동제3투	3632	2700	932	11	2689	1270	1413	0	2	0	4
서울특별시	서대문구	연희동	연희동제4투	4170	3061	1109	16	3045	1363	1666	5	3	5	3
서울특별시	서대문구	연희동	연희동제5투	3806	2823	983	21	2802	1271	1517	2	2	6	4
서울특별시	서대문구	연희동	연희동제6투	3483	2749	734	14	2735	1282	1438	4	2	8	1
서울특별시	서대문구	연희동	연희동제7투	3810	3011	799	9	3002	1573	1420	1	1	7	0
서울특별시	서대문구	연희동	연희동제8투	3759	2882	877	14	2868	1153	1698	0	3	9	5
서울특별시	서대문구	연희동	연희동제9투	3893	2981	912	20	2961	1169	1777	8	3	3	1
서울특별시	서대문구	홍제제1동	소계	22125	16779	5346	90	16689	7481	9143	15	13	25	12
서울특별시	서대문구	홍제제1동	홍제제1동제1투	3001	1999	1002	12	1987	926	1058	1	0	1	1
서울특별시	서대문구	홍제제1동	홍제제1동제2투	3515	2775	740	16	2759	1308	1439	2	2	8	0
서울특별시	서대문구	홍제제1동	홍제제1동제3투	3093	2387	706	13	2374	1133	1232	3	3	2	1
서울특별시	서대문구	홍제제1동	홍제제1동제4투	2758	2103	655	7	2096	906	1183	2	2	1	2
서울특별시	서대문구	홍제제1동	홍제제1동제5투	3441	2578	863	8	2570	1066	1490	4	3	3	4
서울특별시	서대문구	홍제제1동	홍제제1동제6투	3509	2813	696	10	2803	1209	1582	1	2	7	2
서울특별시	서대문구	홍제제1동	홍제제1동제7투	2808	2124	684	24	2100	933	1159	2	1	3	2
서울특별시	서대문구	홍제제2동	소계	12586	9896	2690	50	9846	4745	5060	7	6	24	4
서울특별시	서대문구	홍제제2동	홍제제2동제1투	2491	1722	769	7	1715	799	907	1	2	6	0
서울특별시	서대문구	홍제제2동	홍제제2동제2투	3853	3174	679	12	3162	1616	1539	2	0	4	1
서울특별시	서대문구	홍제제2동	홍제제2동제3투	3235	2627	608	17	2610	1247	1343	4	3	11	2
서울특별시	서대문구	홍제제2동	홍제제2동제4투	3007	2373	634	14	2359	1083	1271	0	1	3	1
서울특별시	서대문구	홍제제3동	소계	16417	12269	4148	75	12194	5347	6784	12	10	29	12
서울특별시	서대문구	홍제제3동	홍제제3동제1투	3364	2277	1087	18	2259	1015	1231	4	1	6	2
서울특별시	서대문구	홍제제3동	홍제제3동제2투	3110	2364	746	11	2353	1103	1238	1	1	7	3
서울특별시	서대문구	홍제제3동	홍제제3동제3투	3758	3045	713	12	3033	1270	1748	2	4	6	3
서울특별시	서대문구	홍제제3동	홍제제3동제4투	3108	2310	798	19	2291	947	1331	2	1	8	2
서울특별시	서대문구	홍제제3동	홍제제3동제5투	3077	2273	804	15	2258	1012	1236	3	3	2	2
서울특별시	서대문구	홍은제1동	소계	21171	15906	5265	83	15823	7218	8524	17	14	27	23
서울특별시	서대문구	홍은제1동	홍은제1동제1투	3786	2540	1246	17	2523	1105	1407	1	4	4	2
서울특별시	서대문구	홍은제1동	홍은제1동제2투	3038	2332	706	16	2316	1112	1189	5	3	3	4
서울특별시	서대문구	홍은제1동	홍은제1동제3투	3848	3129	719	15	3114	1555	1551	0	1	4	3
서울특별시	서대문구	홍은제1동	홍은제1동제4투	2854	2158	696	12	2146	860	1275	3	2	5	1
서울특별시	서대문구	홍은제1동	홍은제1동제5투	3888	3031	857	9	3022	1371	1632	5	1	8	5
서울특별시	서대문구	홍은제1동	홍은제1동제6투	3757	2716	1041	14	2702	1215	1470	3	3	3	8
서울특별시	서대문구	홍은제2동	소계	23717	17477	6240	86	17391	8212	9116	9	8	35	11
서울특별시	서대문구	홍은제2동	홍은제2동제1투	4524	3126	1398	19	3107	1471	1625	2	1	7	1
서울특별시	서대문구	홍은제2동	홍은제2동제2투	3469	2683	786	7	2676	1217	1447	0	0	10	2
서울특별시	서대문구	홍은제2동	홍은제2동제3투	4207	3241	966	16	3225	1646	1570	2	0	5	2
서울특별시	서대문구	홍은제2동	홍은제2동제4투	3375	2439	936	6	2433	1111	1310	1	4	4	3
서울특별시	서대문구	홍은제2동	홍은제2동제5투	3777	2755	1022	20	2735	1218	1506	3	3	4	1
서울특별시	서대문구	홍은제2동	홍은제2동제6투	4365	3233	1132	18	3215	1549	1658	1	0	5	2
서울특별시	서대문구	남가좌제1동	소계	3328	2218	1110	19	2199	1059	1133	1	0	5	1
서울특별시	서대문구	남가좌제1동	남가좌제1동제1투	1660	1285	375	8	1277	597	676	1	0	2	1
서울특별시	서대문구	남가좌제1동	남가좌제1동제2투	1668	933	735	11	922	462	457	0	0	3	0
서울특별시	서대문구	남가좌제2동	소계	24477	18263	6214	114	18149	8368	9702	17	17	37	8
서울특별시	서대문구	남가좌제2동	남가좌제2동제1투	4009	2649	1360	21	2628	1192	1426	1	0	8	1
서울특별시	서대문구	남가좌제2동	남가좌제2동제2투	2885	2161	724	13	2148	1017	1120	0	4	5	2
서울특별시	서대문구	남가좌제2동	남가좌제2동제3투	3516	2873	643	23	2850	1409	1431	2	2	6	0
서울특별시	서대문구	남가좌제2동	남가좌제2동제4투	3888	2899	989	20	2879	1289	1577	7	2	4	0
서울특별시	서대문구	남가좌제2동	남가좌제2동제5투	3273	2387	886	13	2374	1108	1255	2	2	3	4
서울특별시	서대문구	남가좌제2동	남가좌제2동제6투	3198	2623	575	12	2611	1211	1386	3	3	8	0
서울특별시	서대문구	남가좌제2동	남가좌제2동제7투	3708	2671	1037	12	2659	1142	1507	2	4	3	1
서울특별시	서대문구	북가좌제1동	소계	11114	8712	2402	38	8674	3846	4793	4	5	17	9
서울특별시	서대문구	북가좌제1동	북가좌제1동제1투	1030	876	154	1	875	329	542	1	1	2	0
서울특별시	서대문구	북가좌제1동	북가좌제1동제2투	2789	2127	662	11	2116	931	1175	1	0	6	3
서울특별시	서대문구	북가좌제1동	북가좌제1동제3투	1662	1403	259	7	1396	713	675	0	1	4	3
서울특별시	서대문구	북가좌제1동	북가좌제1동제4투	3101	2336	765	8	2328	1037	1282	2	2	3	2
서울특별시	서대문구	북가좌제1동	북가좌제1동제5투	1207	1042	165	6	1036	422	611	0	1	2	0
서울특별시	서대문구	북가좌제1동	북가좌제1동제6투	1325	928	397	5	923	414	508	0	0	0	1
서울특별시	서대문구	북가좌제2동	소계	27249	20510	6739	84	20426	8986	11371	13	16	26	14
서울특별시	서대문구	북가좌제2동	북가좌제2동제1투	4379	3011	1368	25	2986	1256	1712	1	3	11	3
서울특별시	서대문구	북가좌제2동	북가좌제2동제2투	4284	3182	1102	13	3169	1366	1795	4	0	2	2
서울특별시	서대문구	북가좌제2동	북가좌제2동제3투	3235	2453	782	11	2442	1073	1362	2	3	1	1
서울특별시	서대문구	북가좌제2동	북가좌제2동제4투	4040	3268	772	7	3261	1561	1691	3	1	4	1
서울특별시	서대문구	북가좌제2동	북가좌제2동제5투	3249	2526	723	5	2521	1121	1390	1	3	2	4
서울특별시	서대문구	북가좌제2동	북가좌제2동제6투	3733	2764	969	6	2758	1175	1578	0	1	3	1
서울특별시	서대문구	북가좌제2동	북가좌제2동제7투	4329	3306	1023	17	3289	1434	1843	2	5	3	2
서울특별시	서대문구	잘못 투입·구분된 투표지	잘못 투입·구분된 투표지	0	5	-5	0	5	2	3	0	0	0	0
서울특별시	마포구	계	계	319501	243026	76475	1174	241852	106921	133849	114	246	460	262
서울특별시	마포구	재외투표	재외투표	3315	2487	828	12	2475	1059	1399	2	2	6	7
서울특별시	마포구	국내부재자투표	국내부재자투표	5859	5454	405	102	5352	2430	2878	4	8	16	16
서울특별시	마포구	공덕동	소계	29982	22271	7711	110	22161	10047	12017	20	10	48	19
서울특별시	마포구	공덕동	공덕동제1투	3205	2336	869	14	2322	1028	1283	3	3	3	2
서울특별시	마포구	공덕동	공덕동제2투	2587	1893	694	15	1878	890	981	3	0	4	0
서울특별시	마포구	공덕동	공덕동제3투	2548	1765	783	10	1755	825	923	2	0	4	1
서울특별시	마포구	공덕동	공덕동제4투	4195	2561	1634	13	2548	1058	1473	2	2	7	6
서울특별시	마포구	공덕동	공덕동제5투	3551	2757	794	15	2742	1169	1564	1	1	5	2
서울특별시	마포구	공덕동	공덕동제6투	2739	2217	522	10	2207	1058	1135	1	2	9	2
서울특별시	마포구	공덕동	공덕동제7투	3574	2694	880	9	2685	1224	1452	5	1	0	3
서울특별시	마포구	공덕동	공덕동제8투	3276	2683	593	8	2675	1235	1428	2	1	7	2
서울특별시	마포구	공덕동	공덕동제9투	4307	3365	942	16	3349	1560	1778	1	0	9	1
서울특별시	마포구	아현동	소계	15662	11644	4018	54	11590	5789	5751	3	8	25	14
서울특별시	마포구	아현동	아현동제1투	3483	2349	1134	11	2338	1264	1063	1	2	6	2
서울특별시	마포구	아현동	아현동제2투	2920	2444	476	9	2435	1145	1282	1	1	3	3
서울특별시	마포구	아현동	아현동제3투	3278	2704	574	8	2696	1266	1420	1	2	6	1
서울특별시	마포구	아현동	아현동제4투	3076	2117	959	13	2104	1068	1029	0	1	4	2
서울특별시	마포구	아현동	아현동제5투	2905	2030	875	13	2017	1046	957	0	2	6	6
서울특별시	마포구	도화동	소계	18751	14717	4034	63	14654	7419	7168	2	14	32	19
서울특별시	마포구	도화동	도화동제1투	2691	2012	679	6	2006	920	1078	0	2	2	4
서울특별시	마포구	도화동	도화동제2투	3003	2455	548	8	2447	1267	1172	0	1	3	4
서울특별시	마포구	도화동	도화동제3투	2308	1943	365	13	1930	1031	890	0	1	6	2
서울특별시	마포구	도화동	도화동제4투	2295	1929	366	8	1921	1004	912	1	1	2	1
서울특별시	마포구	도화동	도화동제5투	2940	1910	1030	15	1895	924	956	0	4	7	4
서울특별시	마포구	도화동	도화동제6투	2995	2492	503	7	2485	1396	1074	0	2	10	3
서울특별시	마포구	도화동	도화동제7투	2519	1976	543	6	1970	877	1086	1	3	2	1
서울특별시	마포구	용강동	소계	14976	11797	3179	58	11739	5707	5983	7	6	28	8
서울특별시	마포구	용강동	용강동제1투	1927	1385	542	11	1374	637	731	1	1	4	0
서울특별시	마포구	용강동	용강동제2투	3323	2623	700	12	2611	1242	1355	2	2	7	3
서울특별시	마포구	용강동	용강동제3투	3673	2899	774	15	2884	1454	1421	1	2	4	2
서울특별시	마포구	용강동	용강동제4투	2945	2451	494	9	2442	1188	1247	0	1	5	1
서울특별시	마포구	용강동	용강동제5투	3108	2439	669	11	2428	1186	1229	3	0	8	2
서울특별시	마포구	대흥동	소계	12597	8686	3911	55	8631	3654	4942	3	5	14	13
서울특별시	마포구	대흥동	대흥동제1투	2032	1489	543	11	1478	696	778	0	0	1	3
서울특별시	마포구	대흥동	대흥동제2투	2574	1823	751	12	1811	764	1036	2	2	4	3
서울특별시	마포구	대흥동	대흥동제3투	4117	2640	1477	13	2627	1059	1557	0	1	4	6
서울특별시	마포구	대흥동	대흥동제4투	3874	2734	1140	19	2715	1135	1571	1	2	5	1
서울특별시	마포구	염리동	소계	14463	10453	4010	58	10395	4715	5640	6	6	21	7
서울특별시	마포구	염리동	염리동제1투	2761	1867	894	11	1856	922	926	1	1	5	1
서울특별시	마포구	염리동	염리동제2투	3016	2101	915	14	2087	934	1145	1	0	7	0
서울특별시	마포구	염리동	염리동제3투	2891	1987	904	10	1977	878	1091	2	0	3	3
서울특별시	마포구	염리동	염리동제4투	2767	2071	696	11	2060	829	1222	1	5	2	1
서울특별시	마포구	염리동	염리동제5투	3028	2427	601	12	2415	1152	1256	1	0	4	2
서울특별시	마포구	신수동	소계	17486	13628	3858	54	13574	6416	7098	4	16	26	14
서울특별시	마포구	신수동	신수동제1투	3332	2406	926	10	2396	1109	1278	1	2	4	2
서울특별시	마포구	신수동	신수동제2투	3769	2933	836	8	2925	1414	1500	2	2	5	2
서울특별시	마포구	신수동	신수동제3투	3430	2648	782	8	2640	1138	1488	1	4	5	4
서울특별시	마포구	신수동	신수동제4투	3515	2799	716	15	2784	1339	1433	0	2	7	3
서울특별시	마포구	신수동	신수동제5투	3440	2842	598	13	2829	1416	1399	0	6	5	3
서울특별시	마포구	서강동	소계	20526	15848	4678	52	15796	6876	8841	6	17	33	23
서울특별시	마포구	서강동	서강동제1투	3852	2851	1001	12	2839	1302	1524	2	1	6	4
서울특별시	마포구	서강동	서강동제2투	3649	2905	744	7	2898	1361	1522	0	2	9	4
서울특별시	마포구	서강동	서강동제3투	3758	2908	850	11	2897	1184	1695	0	6	7	5
서울특별시	마포구	서강동	서강동제4투	3023	2339	684	5	2334	892	1432	2	2	1	5
서울특별시	마포구	서강동	서강동제5투	4057	3129	928	9	3120	1226	1880	1	5	5	3
서울특별시	마포구	서강동	서강동제6투	2187	1716	471	8	1708	911	788	1	1	5	2
서울특별시	마포구	서교동	소계	24690	18013	6677	72	17941	7177	10673	10	27	29	25
서울특별시	마포구	서교동	서교동제1투	3411	2461	950	9	2452	1061	1380	2	4	3	2
서울특별시	마포구	서교동	서교동제2투	3804	2892	912	5	2887	1256	1619	1	3	4	4
서울특별시	마포구	서교동	서교동제3투	3990	2627	1363	8	2619	985	1620	2	5	6	1
서울특별시	마포구	서교동	서교동제4투	3906	2959	947	14	2945	1177	1749	1	5	5	8
서울특별시	마포구	서교동	서교동제5투	2862	2103	759	7	2096	844	1247	0	1	2	2
서울특별시	마포구	서교동	서교동제6투	3014	2250	764	6	2244	852	1376	3	4	5	4
서울특별시	마포구	서교동	서교동제7투	3703	2721	982	23	2698	1002	1682	1	5	4	4
서울특별시	마포구	합정동	소계	16726	12547	4179	59	12488	5346	7086	3	25	21	7
서울특별시	마포구	합정동	합정동제1투	3436	2338	1098	10	2328	908	1409	1	6	4	0
서울특별시	마포구	합정동	합정동제2투	3368	2607	761	9	2598	1072	1515	0	7	3	1
서울특별시	마포구	합정동	합정동제3투	2990	2305	685	10	2295	962	1326	0	5	2	0
서울특별시	마포구	합정동	합정동제4투	3429	2617	812	13	2604	1214	1375	2	3	7	3
서울특별시	마포구	합정동	합정동제5투	3503	2680	823	17	2663	1190	1461	0	4	5	3
서울특별시	마포구	망원1동	소계	19700	14473	5227	75	14398	5934	8418	2	20	16	8
서울특별시	마포구	망원1동	망원1동제1투	3869	2682	1187	18	2664	1116	1538	0	4	2	4
서울특별시	마포구	망원1동	망원1동제2투	4028	3063	965	16	3047	1239	1800	2	5	1	0
서울특별시	마포구	망원1동	망원1동제3투	3824	2840	984	14	2826	1119	1700	0	2	4	1
서울특별시	마포구	망원1동	망원1동제4투	4467	3216	1251	11	3205	1336	1860	0	5	3	1
서울특별시	마포구	망원1동	망원1동제5투	3512	2672	840	16	2656	1124	1520	0	4	6	2
서울특별시	마포구	망원2동	소계	16658	12915	3743	56	12859	5318	7487	14	7	21	12
서울특별시	마포구	망원2동	망원2동제1투	3672	2744	928	7	2737	1141	1587	3	1	4	1
서울특별시	마포구	망원2동	망원2동제2투	2989	2318	671	13	2305	942	1356	2	1	2	2
서울특별시	마포구	망원2동	망원2동제3투	3639	2832	807	19	2813	1174	1626	1	2	7	3
서울특별시	마포구	망원2동	망원2동제4투	3517	2731	786	9	2722	1145	1562	6	2	5	2
서울특별시	마포구	망원2동	망원2동제5투	2841	2290	551	8	2282	916	1356	2	1	3	4
서울특별시	마포구	연남동	소계	16216	12037	4179	57	11980	5063	6863	9	15	19	11
서울특별시	마포구	연남동	연남동제1투	3891	2747	1144	18	2729	1212	1511	1	1	3	1
서울특별시	마포구	연남동	연남동제2투	3707	2849	858	14	2835	1149	1670	1	8	5	2
서울특별시	마포구	연남동	연남동제3투	4108	3063	1045	11	3052	1265	1767	3	5	7	5
서울특별시	마포구	연남동	연남동제4투	4510	3378	1132	14	3364	1437	1915	4	1	4	3
서울특별시	마포구	성산1동	소계	17005	12659	4346	55	12604	5318	7215	8	22	28	13
서울특별시	마포구	성산1동	성산1동제1투	3233	2236	997	20	2216	915	1290	3	2	4	2
서울특별시	마포구	성산1동	성산1동제2투	3639	2831	808	11	2820	1131	1673	2	7	4	3
서울특별시	마포구	성산1동	성산1동제3투	3071	2272	799	8	2264	950	1303	0	3	5	3
서울특별시	마포구	성산1동	성산1동제4투	3439	2562	877	11	2551	1155	1381	1	5	6	3
서울특별시	마포구	성산1동	성산1동제5투	3623	2758	865	5	2753	1167	1568	2	5	9	2
서울특별시	마포구	성산2동	소계	31161	24367	6794	111	24256	10417	13745	5	21	35	33
서울특별시	마포구	성산2동	성산2동제1투	4080	3369	711	12	3357	1654	1692	1	2	5	3
서울특별시	마포구	성산2동	성산2동제2투	4138	2978	1160	12	2966	1297	1658	0	4	4	3
서울특별시	마포구	성산2동	성산2동제3투	4413	3376	1037	14	3362	1330	2022	1	4	2	3
서울특별시	마포구	성산2동	성산2동제4투	3895	3047	848	14	3033	1261	1765	1	0	1	5
서울특별시	마포구	성산2동	성산2동제5투	1704	1244	460	21	1223	623	588	1	3	1	7
서울특별시	마포구	성산2동	성산2동제6투	2011	1484	527	12	1472	671	792	0	1	3	5
서울특별시	마포구	성산2동	성산2동제7투	3292	2754	538	7	2747	1158	1583	0	0	4	2
서울특별시	마포구	성산2동	성산2동제8투	3880	3082	798	9	3073	1187	1871	1	4	8	2
서울특별시	마포구	성산2동	성산2동제9투	3748	3033	715	10	3023	1236	1774	0	3	7	3
서울특별시	마포구	상암동	소계	23728	19014	4714	71	18943	8231	10634	6	17	42	13
서울특별시	마포구	상암동	상암동제1투	3692	2643	1049	12	2631	1273	1346	0	1	7	4
서울특별시	마포구	상암동	상암동제2투	3230	2528	702	11	2517	1133	1375	2	2	4	1
서울특별시	마포구	상암동	상암동제3투	2615	2203	412	5	2198	950	1236	0	4	7	1
서울특별시	마포구	상암동	상암동제4투	4098	3482	616	19	3463	1631	1822	0	1	9	0
서울특별시	마포구	상암동	상암동제5투	3498	2833	665	8	2825	1194	1618	1	5	5	2
서울특별시	마포구	상암동	상암동제6투	2978	2430	548	8	2422	940	1473	2	1	4	2
서울특별시	마포구	상암동	상암동제7투	3617	2895	722	8	2887	1110	1764	1	3	6	3
서울특별시	마포구	잘못 투입·구분된 투표지	잘못 투입·구분된 투표지	0	16	-16	0	16	5	11	0	0	0	0
서울특별시	양천구	계	계	390352	298957	91395	1345	297612	141933	154539	164	152	576	248
서울특별시	양천구	재외투표	재외투표	3422	2494	928	11	2483	996	1477	0	2	6	2
서울특별시	양천구	국내부재자투표	국내부재자투표	8987	8408	579	128	8280	4067	4142	12	12	18	29
서울특별시	양천구	목1동	소계	23704	19060	4644	67	18993	9983	8945	2	11	43	9
서울특별시	양천구	목1동	목1동제1투	4010	3221	789	11	3210	1626	1574	0	1	8	1
서울특별시	양천구	목1동	목1동제2투	4288	3540	748	11	3529	1852	1668	1	0	6	2
서울특별시	양천구	목1동	목1동제3투	3841	2981	860	14	2967	1428	1527	0	2	8	2
서울특별시	양천구	목1동	목1동제4투	3658	3074	584	10	3064	1495	1559	0	3	6	1
서울특별시	양천구	목1동	목1동제5투	4128	3234	894	13	3221	1692	1515	1	3	8	2
서울특별시	양천구	목1동	목1동제6투	3779	3010	769	8	3002	1890	1102	0	2	7	1
서울특별시	양천구	목2동	소계	24994	18907	6087	77	18830	8520	10241	8	10	35	16
서울특별시	양천구	목2동	목2동제1투	4224	2975	1249	15	2960	1304	1648	1	3	3	1
서울특별시	양천구	목2동	목2동제2투	4321	3355	966	18	3337	1648	1674	1	3	7	4
서울특별시	양천구	목2동	목2동제3투	4158	3184	974	6	3178	1335	1832	3	1	6	1
서울특별시	양천구	목2동	목2동제4투	4483	3542	941	10	3532	1695	1833	0	0	4	0
서울특별시	양천구	목2동	목2동제5투	4258	3278	980	13	3265	1382	1866	1	2	9	5
서울특별시	양천구	목2동	목2동제6투	3550	2573	977	15	2558	1156	1388	2	1	6	5
서울특별시	양천구	목3동	소계	18549	13894	4655	79	13815	6712	7047	6	9	30	11
서울특별시	양천구	목3동	목3동제1투	3525	2880	645	13	2867	1616	1243	0	2	4	2
서울특별시	양천구	목3동	목3동제2투	3579	2624	955	12	2612	1218	1385	0	1	5	3
서울특별시	양천구	목3동	목3동제3투	4094	2805	1289	22	2783	1361	1413	1	2	3	3
서울특별시	양천구	목3동	목3동제4투	3821	2827	994	20	2807	1245	1545	3	3	8	3
서울특별시	양천구	목3동	목3동제5투	3530	2758	772	12	2746	1272	1461	2	1	10	0
서울특별시	양천구	목4동	소계	20831	15871	4960	58	15813	7372	8389	9	3	26	14
서울특별시	양천구	목4동	목4동제1투	3523	2553	970	7	2546	1253	1286	0	1	6	0
서울특별시	양천구	목4동	목4동제2투	3100	2234	866	6	2228	1057	1158	4	1	3	5
서울특별시	양천구	목4동	목4동제3투	3835	3037	798	10	3027	1467	1550	0	0	7	3
서울특별시	양천구	목4동	목4동제4투	3334	2571	763	15	2556	1114	1439	1	0	1	1
서울특별시	양천구	목4동	목4동제5투	3233	2449	784	12	2437	1136	1293	2	0	4	2
서울특별시	양천구	목4동	목4동제6투	3806	3027	779	8	3019	1345	1663	2	1	5	3
서울특별시	양천구	목5동	소계	32192	26432	5760	74	26358	14786	11466	7	10	71	18
서울특별시	양천구	목5동	목5동제1투	3522	2720	802	5	2715	1595	1107	1	0	8	4
서울특별시	양천구	목5동	목5동제2투	3866	3205	661	4	3201	1773	1414	0	0	12	2
서울특별시	양천구	목5동	목5동제3투	4168	3351	817	9	3342	1852	1475	0	4	8	3
서울특별시	양천구	목5동	목5동제4투	3382	2830	552	4	2826	1718	1100	1	0	5	2
서울특별시	양천구	목5동	목5동제5투	3666	2981	685	13	2968	1726	1231	2	0	8	1
서울특별시	양천구	목5동	목5동제6투	2773	2372	401	4	2368	1309	1053	0	1	4	1
서울특별시	양천구	목5동	목5동제7투	3482	2900	582	15	2885	1688	1184	1	0	10	2
서울특별시	양천구	목5동	목5동제8투	3207	2617	590	8	2609	1451	1143	0	2	13	0
서울특별시	양천구	목5동	목5동제9투	4126	3456	670	12	3444	1674	1759	2	3	3	3
서울특별시	양천구	신월1동	소계	19962	13757	6205	65	13692	6165	7475	12	6	20	14
서울특별시	양천구	신월1동	신월1동제1투	4567	3049	1518	13	3036	1329	1694	4	0	5	4
서울특별시	양천구	신월1동	신월1동제2투	3958	2792	1166	7	2785	1287	1485	2	2	6	3
서울특별시	양천구	신월1동	신월1동제3투	3358	2310	1048	13	2297	1030	1260	1	2	2	2
서울특별시	양천구	신월1동	신월1동제4투	3767	2590	1177	15	2575	1170	1392	4	1	5	3
서울특별시	양천구	신월1동	신월1동제5투	4312	3016	1296	17	2999	1349	1644	1	1	2	2
서울특별시	양천구	신월2동	소계	16610	12369	4241	64	12305	5632	6634	7	8	18	6
서울특별시	양천구	신월2동	신월2동제1투	3706	2659	1047	14	2645	1217	1417	3	4	3	1
서울특별시	양천구	신월2동	신월2동제2투	2776	2105	671	7	2098	967	1125	2	1	2	1
서울특별시	양천구	신월2동	신월2동제3투	3334	2496	838	8	2488	1089	1391	1	1	5	1
서울특별시	양천구	신월2동	신월2동제4투	3782	2893	889	20	2873	1351	1514	0	2	4	2
서울특별시	양천구	신월2동	신월2동제5투	3012	2216	796	15	2201	1008	1187	1	0	4	1
서울특별시	양천구	신월3동	소계	14454	9695	4759	60	9635	4358	5232	8	6	18	13
서울특별시	양천구	신월3동	신월3동제1투	3678	2331	1347	13	2318	1069	1233	4	2	6	4
서울특별시	양천구	신월3동	신월3동제2투	3383	2371	1012	13	2358	1038	1307	2	1	6	4
서울특별시	양천구	신월3동	신월3동제3투	3799	2485	1314	18	2467	1094	1366	1	2	3	1
서울특별시	양천구	신월3동	신월3동제4투	3594	2508	1086	16	2492	1157	1326	1	1	3	4
서울특별시	양천구	신월4동	소계	14846	11485	3361	54	11431	5085	6307	6	7	23	3
서울특별시	양천구	신월4동	신월4동제1투	4554	3421	1133	17	3404	1558	1839	0	1	5	1
서울특별시	양천구	신월4동	신월4동제2투	3635	2874	761	11	2863	1252	1597	4	2	8	0
서울특별시	양천구	신월4동	신월4동제3투	3745	2901	844	14	2887	1275	1603	1	3	5	0
서울특별시	양천구	신월4동	신월4동제4투	2912	2289	623	12	2277	1000	1268	1	1	5	2
서울특별시	양천구	신월5동	소계	12660	9138	3522	44	9094	4149	4910	8	4	12	11
서울특별시	양천구	신월5동	신월5동제1투	4031	3001	1030	12	2989	1404	1575	3	1	2	4
서울특별시	양천구	신월5동	신월5동제2투	4468	3132	1336	12	3120	1413	1696	3	1	3	4
서울특별시	양천구	신월5동	신월5동제3투	4161	3005	1156	20	2985	1332	1639	2	2	7	3
서울특별시	양천구	신월6동	소계	10519	7563	2956	39	7524	3537	3959	6	4	12	6
서울특별시	양천구	신월6동	신월6동제1투	3887	2714	1173	15	2699	1221	1472	1	1	4	0
서울특별시	양천구	신월6동	신월6동제2투	2820	2069	751	9	2060	1035	1018	1	0	4	2
서울특별시	양천구	신월6동	신월6동제3투	3812	2780	1032	15	2765	1281	1469	4	3	4	4
서울특별시	양천구	신월7동	소계	19892	14779	5113	59	14720	6698	7975	8	13	19	7
서울특별시	양천구	신월7동	신월7동제1투	3898	2686	1212	13	2673	1251	1414	2	3	2	1
서울특별시	양천구	신월7동	신월7동제2투	3253	2428	825	12	2416	1112	1295	2	2	5	0
서울특별시	양천구	신월7동	신월7동제3투	3131	2257	874	8	2249	1022	1224	0	1	1	1
서울특별시	양천구	신월7동	신월7동제4투	2901	2137	764	8	2129	1002	1117	1	3	3	3
서울특별시	양천구	신월7동	신월7동제5투	3532	2781	751	7	2774	1212	1549	3	3	5	2
서울특별시	양천구	신월7동	신월7동제6투	3177	2490	687	11	2479	1099	1376	0	1	3	0
서울특별시	양천구	신정1동	소계	14295	11416	2879	53	11363	5931	5399	9	2	18	4
서울특별시	양천구	신정1동	신정1동제1투	1155	653	502	7	646	295	348	3	0	0	0
서울특별시	양천구	신정1동	신정1동제2투	1227	861	366	10	851	405	445	0	0	0	1
서울특별시	양천구	신정1동	신정1동제3투	3123	2533	590	8	2525	1263	1255	1	2	4	0
서울특별시	양천구	신정1동	신정1동제4투	2962	2458	504	7	2451	1411	1030	2	0	6	2
서울특별시	양천구	신정1동	신정1동제5투	2973	2527	446	14	2513	1303	1205	1	0	4	0
서울특별시	양천구	신정1동	신정1동제6투	2855	2384	471	7	2377	1254	1116	2	0	4	1
서울특별시	양천구	신정2동	소계	16616	12858	3758	55	12803	6014	6728	4	6	30	21
서울특별시	양천구	신정2동	신정2동제1투	4606	3410	1196	25	3385	1548	1817	1	3	10	6
서울특별시	양천구	신정2동	신정2동제2투	3847	3031	816	9	3022	1441	1567	0	2	5	7
서울특별시	양천구	신정2동	신정2동제3투	4300	3389	911	8	3381	1538	1825	3	1	9	5
서울특별시	양천구	신정2동	신정2동제4투	3863	3028	835	13	3015	1487	1519	0	0	6	3
서울특별시	양천구	신정3동	소계	43074	32922	10152	142	32780	14355	18293	20	16	68	28
서울특별시	양천구	신정3동	신정3동제1투	3456	2748	708	9	2739	1124	1602	2	3	5	3
서울특별시	양천구	신정3동	신정3동제2투	2820	1931	889	14	1917	857	1052	1	1	4	2
서울특별시	양천구	신정3동	신정3동제3투	2994	2023	971	11	2012	922	1082	3	2	3	0
서울특별시	양천구	신정3동	신정3동제4투	2871	1888	983	12	1876	918	949	2	0	4	3
서울특별시	양천구	신정3동	신정3동제5투	3140	2025	1115	12	2013	1017	989	1	2	3	1
서울특별시	양천구	신정3동	신정3동제6투	3300	2466	834	15	2451	998	1439	4	2	4	4
서울특별시	양천구	신정3동	신정3동제7투	4131	3394	737	8	3386	1494	1879	2	1	10	0
서울특별시	양천구	신정3동	신정3동제8투	3368	2692	676	13	2679	1148	1521	1	1	6	2
서울특별시	양천구	신정3동	신정3동제9투	3552	2823	729	11	2812	1289	1513	0	0	8	2
서울특별시	양천구	신정3동	신정3동제10투	3100	2565	535	8	2557	1253	1292	2	1	6	3
서울특별시	양천구	신정3동	신정3동제11투	3058	2383	675	7	2376	960	1411	0	0	4	1
서울특별시	양천구	신정3동	신정3동제12투	2797	2219	578	6	2213	903	1300	0	2	5	3
서울특별시	양천구	신정3동	신정3동제13투	2294	1920	374	9	1911	746	1159	1	1	1	3
서울특별시	양천구	신정3동	신정3동제14투	2193	1845	348	7	1838	726	1105	1	0	5	1
서울특별시	양천구	신정4동	소계	30337	22356	7981	88	22268	9746	12466	14	6	25	11
서울특별시	양천구	신정4동	신정4동제1투	4295	3045	1250	12	3033	1263	1763	3	0	4	0
서울특별시	양천구	신정4동	신정4동제2투	3397	2547	850	4	2543	1139	1396	2	0	4	2
서울특별시	양천구	신정4동	신정4동제3투	3337	2455	882	13	2442	1099	1338	1	0	3	1
서울특별시	양천구	신정4동	신정4동제4투	3613	2790	823	13	2777	1194	1579	1	0	2	1
서울특별시	양천구	신정4동	신정4동제5투	4141	3114	1027	12	3102	1371	1719	3	2	6	1
서울특별시	양천구	신정4동	신정4동제6투	3744	2660	1084	22	2638	1153	1477	1	2	3	2
서울특별시	양천구	신정4동	신정4동제7투	3482	2535	947	8	2527	1088	1436	1	0	0	2
서울특별시	양천구	신정4동	신정4동제8투	4328	3210	1118	4	3206	1439	1758	2	2	3	2
서울특별시	양천구	신정6동	소계	19222	16005	3217	48	15957	8251	7653	2	4	41	6
서울특별시	양천구	신정6동	신정6동제1투	3271	2701	570	5	2696	1491	1191	2	1	10	1
서울특별시	양천구	신정6동	신정6동제2투	2656	2195	461	7	2188	1198	984	0	1	5	0
서울특별시	양천구	신정6동	신정6동제3투	4071	3426	645	15	3411	1855	1540	0	0	13	3
서울특별시	양천구	신정6동	신정6동제4투	3772	3139	633	10	3129	1429	1696	0	0	3	1
서울특별시	양천구	신정6동	신정6동제5투	3184	2720	464	5	2715	1236	1468	0	1	9	1
서울특별시	양천구	신정6동	신정6동제6투	2268	1824	444	6	1818	1042	774	0	1	1	0
서울특별시	양천구	신정7동	소계	25186	19516	5670	76	19440	9563	9786	16	13	43	19
서울특별시	양천구	신정7동	신정7동제1투	3186	2366	820	5	2361	1189	1161	2	2	6	1
서울특별시	양천구	신정7동	신정7동제2투	4140	3299	841	8	3291	1701	1581	1	2	5	1
서울특별시	양천구	신정7동	신정7동제3투	4772	3442	1330	21	3421	1735	1669	5	4	4	4
서울특별시	양천구	신정7동	신정7동제4투	3600	2966	634	5	2961	1259	1694	0	1	6	1
서울특별시	양천구	신정7동	신정7동제5투	2940	2139	801	15	2124	1093	1011	4	2	8	6
서울특별시	양천구	신정7동	신정7동제6투	3050	2316	734	10	2306	1174	1119	3	0	5	5
서울특별시	양천구	신정7동	신정7동제7투	3498	2988	510	12	2976	1412	1551	1	2	9	1
서울특별시	양천구	잘못 투입·구분된 투표지	잘못 투입·구분된 투표지	0	32	-32	4	28	13	15	0	0	0	0
서울특별시	강서구	계	계	463571	350023	113548	1652	348371	162212	184866	173	186	617	317
서울특별시	강서구	재외투표	재외투표	3653	2661	992	14	2647	1048	1589	1	1	5	3
서울특별시	강서구	국내부재자투표	국내부재자투표	9581	8933	648	171	8762	4202	4485	6	11	26	32
서울특별시	강서구	염창동	소계	31220	25367	5853	86	25281	11442	13743	4	11	62	19
서울특별시	강서구	염창동	염창동제1투	4107	3235	872	11	3224	1551	1658	1	2	9	3
서울특별시	강서구	염창동	염창동제2투	3652	3051	601	10	3041	1459	1566	1	3	8	4
서울특별시	강서구	염창동	염창동제3투	4601	3739	862	13	3726	1635	2080	0	1	8	2
서울특별시	강서구	염창동	염창동제4투	4045	3341	704	9	3332	1418	1902	0	0	11	1
서울특별시	강서구	염창동	염창동제5투	3749	2900	849	8	2892	1255	1622	2	2	9	2
서울특별시	강서구	염창동	염창동제6투	4196	3387	809	10	3377	1466	1902	0	2	6	1
서울특별시	강서구	염창동	염창동제7투	3161	2625	536	5	2620	1170	1439	0	1	6	4
서울특별시	강서구	염창동	염창동제8투	3709	3089	620	20	3069	1488	1574	0	0	5	2
서울특별시	강서구	등촌제1동	소계	17797	13652	4145	40	13612	6103	7467	6	7	21	8
서울특별시	강서구	등촌제1동	등촌제1동제1투	3969	3188	781	8	3180	1422	1750	1	2	3	2
서울특별시	강서구	등촌제1동	등촌제1동제2투	5112	3846	1266	20	3826	1909	1904	3	0	8	2
서울특별시	강서구	등촌제1동	등촌제1동제3투	4419	3411	1008	4	3407	1482	1914	0	2	7	2
서울특별시	강서구	등촌제1동	등촌제1동제4투	4297	3207	1090	8	3199	1290	1899	2	3	3	2
서울특별시	강서구	등촌제2동	소계	17527	13622	3905	50	13572	6754	6769	12	8	25	4
서울특별시	강서구	등촌제2동	등촌제2동제1투	4052	3115	937	11	3104	1423	1669	4	2	5	1
서울특별시	강서구	등촌제2동	등촌제2동제2투	4734	3625	1109	17	3608	1646	1943	3	3	10	3
서울특별시	강서구	등촌제2동	등촌제2동제3투	4214	3083	1131	13	3070	1488	1571	3	1	7	0
서울특별시	강서구	등촌제2동	등촌제2동제4투	4527	3799	728	9	3790	2197	1586	2	2	3	0
서울특별시	강서구	등촌제3동	소계	29630	22770	6860	138	22632	10559	11963	17	19	48	26
서울특별시	강서구	등촌제3동	등촌제3동제1투	3400	2419	981	22	2397	1149	1225	5	4	9	5
서울특별시	강서구	등촌제3동	등촌제3동제2투	4060	3377	683	14	3363	1547	1804	0	2	6	4
서울특별시	강서구	등촌제3동	등촌제3동제3투	3987	3280	707	10	3270	1554	1705	1	1	9	0
서울특별시	강서구	등촌제3동	등촌제3동제4투	2914	2065	849	25	2040	1028	997	3	3	5	4
서울특별시	강서구	등촌제3동	등촌제3동제5투	2920	2126	794	19	2107	945	1148	2	2	6	4
서울특별시	강서구	등촌제3동	등촌제3동제6투	3455	2499	956	7	2492	1233	1256	0	2	1	0
서울특별시	강서구	등촌제3동	등촌제3동제7투	3642	3046	596	7	3039	1276	1750	2	2	6	3
서울특별시	강서구	등촌제3동	등촌제3동제8투	2914	2059	855	29	2030	1035	983	3	3	1	5
서울특별시	강서구	등촌제3동	등촌제3동제9투	2338	1899	439	5	1894	792	1095	1	0	5	1
서울특별시	강서구	화곡본동	소계	29005	20382	8623	73	20309	8349	11896	12	11	29	12
서울특별시	강서구	화곡본동	화곡본동제1투	5074	3463	1611	11	3452	1450	1989	5	1	6	1
서울특별시	강서구	화곡본동	화곡본동제2투	5202	3485	1717	18	3467	1438	2022	2	2	2	1
서울특별시	강서구	화곡본동	화곡본동제3투	4827	3479	1348	12	3467	1426	2032	1	0	5	3
서울특별시	강서구	화곡본동	화곡본동제4투	3856	2916	940	13	2903	1229	1666	0	1	7	0
서울특별시	강서구	화곡본동	화곡본동제5투	4956	3461	1495	8	3453	1353	2091	2	2	2	3
서울특별시	강서구	화곡본동	화곡본동제6투	5090	3578	1512	11	3567	1453	2096	2	5	7	4
서울특별시	강서구	화곡제1동	소계	42593	30305	12288	127	30178	13174	16904	16	16	47	21
서울특별시	강서구	화곡제1동	화곡제1동제1투	5065	3140	1925	6	3134	1373	1752	1	0	6	2
서울특별시	강서구	화곡제1동	화곡제1동제2투	4618	3354	1264	21	3333	1365	1961	0	1	4	2
서울특별시	강서구	화곡제1동	화곡제1동제3투	5012	3522	1490	15	3507	1535	1962	0	3	3	4
서울특별시	강서구	화곡제1동	화곡제1동제4투	4555	3267	1288	11	3256	1535	1705	4	3	7	2
서울특별시	강서구	화곡제1동	화곡제1동제5투	3618	2759	859	13	2746	1256	1475	1	4	10	0
서울특별시	강서구	화곡제1동	화곡제1동제6투	3965	2836	1129	13	2823	1191	1622	3	1	3	3
서울특별시	강서구	화곡제1동	화곡제1동제7투	3969	2863	1106	8	2855	1242	1603	2	1	4	3
서울특별시	강서구	화곡제1동	화곡제1동제8투	3870	2805	1065	6	2799	1248	1543	1	2	4	1
서울특별시	강서구	화곡제1동	화곡제1동제9투	3788	2742	1046	13	2729	1164	1557	3	0	3	2
서울특별시	강서구	화곡제1동	화곡제1동제10투	4133	3017	1116	21	2996	1265	1724	1	1	3	2
서울특별시	강서구	화곡제2동	소계	16081	11474	4607	46	11428	4955	6442	6	4	15	6
서울특별시	강서구	화곡제2동	화곡제2동제1투	3049	2258	791	15	2243	1015	1223	1	0	4	0
서울특별시	강서구	화곡제2동	화곡제2동제2투	3898	2607	1291	10	2597	1129	1459	2	2	4	1
서울특별시	강서구	화곡제2동	화곡제2동제3투	4408	3224	1184	9	3215	1333	1872	2	0	5	3
서울특별시	강서구	화곡제2동	화곡제2동제4투	4726	3385	1341	12	3373	1478	1888	1	2	2	2
서울특별시	강서구	화곡제3동	소계	19551	15280	4271	48	15232	7764	7424	5	6	23	10
서울특별시	강서구	화곡제3동	화곡제3동제1투	3637	2752	885	10	2742	1264	1474	0	2	2	0
서울특별시	강서구	화곡제3동	화곡제3동제2투	4134	2903	1231	11	2892	1388	1499	2	1	1	1
서울특별시	강서구	화곡제3동	화곡제3동제3투	3914	3120	794	10	3110	1438	1664	1	0	5	2
서울특별시	강서구	화곡제3동	화곡제3동제4투	3889	3271	618	10	3261	2027	1222	0	1	10	1
서울특별시	강서구	화곡제3동	화곡제3동제5투	3977	3234	743	7	3227	1647	1565	2	2	5	6
서울특별시	강서구	화곡제4동	소계	18618	13198	5420	58	13140	5837	7257	6	8	26	6
서울특별시	강서구	화곡제4동	화곡제4동제1투	3872	2796	1076	11	2785	1236	1545	1	1	1	1
서울특별시	강서구	화곡제4동	화곡제4동제2투	3614	2517	1097	12	2505	1118	1377	2	1	6	1
서울특별시	강서구	화곡제4동	화곡제4동제3투	4330	2908	1422	10	2898	1271	1616	2	2	7	0
서울특별시	강서구	화곡제4동	화곡제4동제4투	3074	2204	870	17	2187	958	1219	0	3	4	3
서울특별시	강서구	화곡제4동	화곡제4동제5투	3728	2773	955	8	2765	1254	1500	1	1	8	1
서울특별시	강서구	화곡제6동	소계	20136	14994	5142	78	14916	7585	7283	3	5	30	10
서울특별시	강서구	화곡제6동	화곡제6동제1투	4859	3405	1454	13	3392	1750	1630	0	0	9	3
서울특별시	강서구	화곡제6동	화곡제6동제2투	3591	2562	1029	33	2529	1191	1328	3	2	2	3
서울특별시	강서구	화곡제6동	화곡제6동제3투	3662	2728	934	10	2718	1300	1410	0	2	5	1
서울특별시	강서구	화곡제6동	화곡제6동제4투	4940	3661	1279	16	3645	1699	1934	0	0	11	1
서울특별시	강서구	화곡제6동	화곡제6동제5투	3084	2638	446	6	2632	1645	981	0	1	3	2
서울특별시	강서구	화곡제8동	소계	22246	16290	5956	54	16236	6662	9522	2	16	20	14
서울특별시	강서구	화곡제8동	화곡제8동제1투	5224	3660	1564	9	3651	1516	2124	1	5	3	2
서울특별시	강서구	화곡제8동	화곡제8동제2투	4142	3103	1039	10	3093	1308	1773	0	3	4	5
서울특별시	강서구	화곡제8동	화곡제8동제3투	4280	3160	1120	12	3148	1332	1808	0	3	3	2
서울특별시	강서구	화곡제8동	화곡제8동제4투	3929	2907	1022	11	2896	1120	1767	0	3	2	4
서울특별시	강서구	화곡제8동	화곡제8동제5투	4671	3460	1211	12	3448	1386	2050	1	2	8	1
서울특별시	강서구	우장산동	소계	29969	23293	6676	92	23201	11194	11937	11	7	37	15
서울특별시	강서구	우장산동	우장산동제1투	5050	3665	1385	7	3658	1687	1958	0	0	10	3
서울특별시	강서구	우장산동	우장산동제2투	3715	2754	961	15	2739	1227	1504	0	2	5	1
서울특별시	강서구	우장산동	우장산동제3투	3083	2177	906	14	2163	1005	1150	2	1	2	3
서울특별시	강서구	우장산동	우장산동제4투	4074	3404	670	7	3397	1667	1721	1	0	6	2
서울특별시	강서구	우장산동	우장산동제5투	4567	3648	919	19	3629	1750	1871	4	2	1	1
서울특별시	강서구	우장산동	우장산동제6투	4816	3904	912	17	3887	2031	1846	1	2	7	0
서울특별시	강서구	우장산동	우장산동제7투	4664	3741	923	13	3728	1827	1887	3	0	6	5
서울특별시	강서구	가양제1동	소계	15917	12590	3327	53	12537	6029	6464	5	1	27	11
서울특별시	강서구	가양제1동	가양제1동제1투	3074	2411	663	7	2404	1149	1250	0	0	4	1
서울특별시	강서구	가양제1동	가양제1동제2투	2338	1805	533	10	1795	788	996	3	0	6	2
서울특별시	강서구	가양제1동	가양제1동제3투	3683	2810	873	12	2798	1613	1179	0	0	4	2
서울특별시	강서구	가양제1동	가양제1동제4투	4140	3282	858	16	3266	1395	1857	1	1	8	4
서울특별시	강서구	가양제1동	가양제1동제5투	2682	2282	400	8	2274	1084	1182	1	0	5	2
서울특별시	강서구	가양제2동	소계	15501	11589	3912	85	11504	5779	5668	11	9	19	18
서울특별시	강서구	가양제2동	가양제2동제1투	2822	2184	638	9	2175	1368	796	0	3	3	5
서울특별시	강서구	가양제2동	가양제2동제2투	3034	2413	621	13	2400	981	1414	0	2	2	1
서울특별시	강서구	가양제2동	가양제2동제3투	3553	2481	1072	30	2451	1177	1258	7	3	3	3
서울특별시	강서구	가양제2동	가양제2동제4투	2681	1972	709	12	1960	1011	937	1	0	5	6
서울특별시	강서구	가양제2동	가양제2동제5투	3411	2539	872	21	2518	1242	1263	3	1	6	3
서울특별시	강서구	가양제3동	소계	15426	11746	3680	73	11673	5428	6192	12	9	19	13
서울특별시	강서구	가양제3동	가양제3동제1투	3331	2607	724	18	2589	1296	1282	3	2	4	2
서울특별시	강서구	가양제3동	가양제3동제2투	3367	2416	951	14	2402	1145	1248	1	1	5	2
서울특별시	강서구	가양제3동	가양제3동제3투	3176	2501	675	12	2489	1083	1397	3	2	2	2
서울특별시	강서구	가양제3동	가양제3동제4투	2521	1746	775	18	1728	910	805	5	1	3	4
서울특별시	강서구	가양제3동	가양제3동제5투	3031	2476	555	11	2465	994	1460	0	3	5	3
서울특별시	강서구	발산제1동	소계	23810	18733	5077	82	18651	8273	10312	9	8	31	18
서울특별시	강서구	발산제1동	발산제1동제1투	3439	2707	732	7	2700	1225	1467	2	3	2	1
서울특별시	강서구	발산제1동	발산제1동제2투	3091	2265	826	9	2256	1117	1132	1	0	2	4
서울특별시	강서구	발산제1동	발산제1동제3투	3967	3134	833	12	3122	1524	1587	1	0	7	3
서울특별시	강서구	발산제1동	발산제1동제4투	4502	3652	850	20	3632	1619	2001	1	2	6	3
서울특별시	강서구	발산제1동	발산제1동제5투	4394	3423	971	24	3399	1448	1936	3	2	6	4
서울특별시	강서구	발산제1동	발산제1동제6투	4417	3552	865	10	3542	1340	2189	1	1	8	3
서울특별시	강서구	공항동	소계	17526	12039	5487	48	11991	5813	6130	6	6	23	13
서울특별시	강서구	공항동	공항동제1투	3559	2604	955	11	2593	1311	1272	2	2	5	1
서울특별시	강서구	공항동	공항동제2투	3842	2650	1192	7	2643	1229	1403	0	1	4	6
서울특별시	강서구	공항동	공항동제3투	3798	2412	1386	14	2398	1221	1165	2	2	6	2
서울특별시	강서구	공항동	공항동제4투	3049	2098	951	11	2087	990	1086	2	1	6	2
서울특별시	강서구	공항동	공항동제5투	3278	2275	1003	5	2270	1062	1204	0	0	2	2
서울특별시	강서구	방화제1동	소계	24210	18381	5829	79	18302	9067	9183	6	8	24	14
서울특별시	강서구	방화제1동	방화제1동제1투	2870	2224	646	12	2212	1158	1050	0	1	1	2
서울특별시	강서구	방화제1동	방화제1동제2투	4122	3099	1023	15	3084	1568	1504	2	3	5	2
서울특별시	강서구	방화제1동	방화제1동제3투	3140	2260	880	17	2243	1169	1063	0	0	6	5
서울특별시	강서구	방화제1동	방화제1동제4투	3347	2340	1007	10	2330	1171	1152	1	2	3	1
서울특별시	강서구	방화제1동	방화제1동제5투	3696	2845	851	3	2842	1307	1529	1	1	2	2
서울특별시	강서구	방화제1동	방화제1동제6투	3926	3157	769	15	3142	1483	1651	1	0	5	2
서울특별시	강서구	방화제1동	방화제1동제7투	3109	2456	653	7	2449	1211	1234	1	1	2	0
서울특별시	강서구	방화제2동	소계	21292	15533	5759	70	15463	7934	7461	12	8	25	23
서울특별시	강서구	방화제2동	방화제2동제1투	3516	2412	1104	10	2402	1173	1220	0	2	4	3
서울특별시	강서구	방화제2동	방화제2동제2투	3775	2461	1314	13	2448	1293	1143	1	2	5	4
서울특별시	강서구	방화제2동	방화제2동제3투	3673	2828	845	9	2819	1434	1373	3	0	4	5
서울특별시	강서구	방화제2동	방화제2동제4투	3097	2394	703	7	2387	1222	1157	1	1	5	1
서울특별시	강서구	방화제2동	방화제2동제5투	2801	2043	758	15	2028	970	1047	3	0	4	4
서울특별시	강서구	방화제2동	방화제2동제6투	1881	1414	467	9	1405	849	549	3	1	1	2
서울특별시	강서구	방화제2동	방화제2동제7투	2549	1981	568	7	1974	993	972	1	2	2	4
서울특별시	강서구	방화제3동	소계	22282	17171	5111	87	17084	8248	8768	5	7	35	21
서울특별시	강서구	방화제3동	방화제3동제1투	3918	2983	935	15	2968	1383	1572	0	2	10	1
서울특별시	강서구	방화제3동	방화제3동제2투	2764	2244	520	2	2242	875	1359	0	0	4	4
서울특별시	강서구	방화제3동	방화제3동제3투	2698	1932	766	27	1905	986	906	4	1	3	5
서울특별시	강서구	방화제3동	방화제3동제4투	3857	2943	914	7	2936	1509	1422	0	1	2	2
서울특별시	강서구	방화제3동	방화제3동제5투	3025	2516	509	9	2507	1363	1132	1	2	5	4
서울특별시	강서구	방화제3동	방화제3동제6투	2666	1968	698	15	1953	935	1009	0	0	5	4
서울특별시	강서구	방화제3동	방화제3동제7투	3354	2585	769	12	2573	1197	1368	0	1	6	1
서울특별시	강서구	잘못 투입·구분된 투표지	잘못 투입·구분된 투표지	0	20	-20	0	20	13	7	0	0	0	0
서울특별시	구로구	계	계	350373	269094	81279	1272	267822	123106	143695	151	182	439	249
서울특별시	구로구	재외투표	재외투표	2363	1713	650	10	1703	661	1037	0	2	2	1
서울특별시	구로구	국내부재자투표	국내부재자투표	6629	6253	376	116	6137	2916	3176	6	12	7	20
서울특별시	구로구	신도림동	소계	29041	23952	5089	89	23863	11374	12393	13	16	51	16
서울특별시	구로구	신도림동	신도림동제1투	3370	2663	707	17	2646	1288	1354	1	0	2	1
서울특별시	구로구	신도림동	신도림동제2투	3348	2844	504	10	2834	1386	1439	1	2	4	2
서울특별시	구로구	신도림동	신도림동제3투	3127	2651	476	11	2640	1116	1517	1	2	3	1
서울특별시	구로구	신도림동	신도림동제4투	3677	2872	805	7	2865	1290	1560	1	3	9	2
서울특별시	구로구	신도림동	신도림동제5투	3869	3231	638	10	3221	1430	1778	2	2	8	1
서울특별시	구로구	신도림동	신도림동제6투	3886	3298	588	7	3291	1558	1711	5	4	11	2
서울특별시	구로구	신도림동	신도림동제7투	4502	3646	856	12	3634	1768	1850	2	2	9	3
서울특별시	구로구	신도림동	신도림동제8투	3262	2747	515	15	2732	1538	1184	0	1	5	4
서울특별시	구로구	구로제1동	소계	17593	14417	3176	42	14375	6021	8297	3	10	30	14
서울특별시	구로구	구로제1동	구로제1동제1투	3783	3062	721	9	3053	1351	1694	1	3	3	1
서울특별시	구로구	구로제1동	구로제1동제2투	3411	2861	550	9	2852	1205	1634	1	2	9	1
서울특별시	구로구	구로제1동	구로제1동제3투	3452	2890	562	9	2881	1223	1650	1	3	3	1
서울특별시	구로구	구로제1동	구로제1동제4투	2940	2418	522	7	2411	999	1401	0	1	7	3
서울특별시	구로구	구로제1동	구로제1동제5투	4007	3186	821	8	3178	1243	1918	0	1	8	8
서울특별시	구로구	구로제2동	소계	26930	18820	8110	116	18704	8520	10113	11	19	19	22
서울특별시	구로구	구로제2동	구로제2동제1투	3871	2370	1501	14	2356	1025	1327	0	2	1	1
서울특별시	구로구	구로제2동	구로제2동제2투	2835	1953	882	13	1940	902	1028	0	1	5	4
서울특별시	구로구	구로제2동	구로제2동제3투	3097	2133	964	20	2113	967	1138	1	3	0	4
서울특별시	구로구	구로제2동	구로제2동제4투	3386	2353	1033	16	2337	1024	1300	3	2	5	3
서울특별시	구로구	구로제2동	구로제2동제5투	2541	1855	686	11	1844	909	924	3	3	3	2
서울특별시	구로구	구로제2동	구로제2동제6투	3965	3060	905	12	3048	1411	1632	0	3	2	0
서울특별시	구로구	구로제2동	구로제2동제7투	2732	1848	884	7	1841	840	995	0	3	0	3
서울특별시	구로구	구로제2동	구로제2동제8투	3433	2463	970	21	2442	1083	1349	2	1	2	5
서울특별시	구로구	구로제2동	구로제2동제9투	1070	785	285	2	783	359	420	2	1	1	0
서울특별시	구로구	구로제3동	소계	23077	17417	5660	56	17361	6044	11246	15	19	23	14
서울특별시	구로구	구로제3동	구로제3동제1투	2937	2199	738	11	2188	745	1434	1	4	3	1
서울특별시	구로구	구로제3동	구로제3동제2투	3332	2443	889	12	2431	936	1484	3	4	2	2
서울특별시	구로구	구로제3동	구로제3동제3투	3544	2847	697	7	2840	1142	1692	2	2	1	1
서울특별시	구로구	구로제3동	구로제3동제4투	3612	2533	1079	6	2527	904	1609	2	5	3	4
서울특별시	구로구	구로제3동	구로제3동제5투	2283	1719	564	4	1715	476	1230	2	0	5	2
서울특별시	구로구	구로제3동	구로제3동제6투	3100	2672	428	8	2664	1089	1565	2	1	5	2
서울특별시	구로구	구로제3동	구로제3동제7투	4269	3004	1265	8	2996	752	2232	3	3	4	2
서울특별시	구로구	구로제4동	소계	21739	15852	5887	100	15752	6396	9290	18	10	29	9
서울특별시	구로구	구로제4동	구로제4동제1투	3887	2807	1080	15	2792	1102	1679	5	0	5	1
서울특별시	구로구	구로제4동	구로제4동제2투	3307	2344	963	19	2325	979	1337	3	0	4	2
서울특별시	구로구	구로제4동	구로제4동제3투	3970	3122	848	22	3100	1197	1891	4	0	6	2
서울특별시	구로구	구로제4동	구로제4동제4투	3465	2314	1151	16	2298	978	1309	3	1	4	3
서울특별시	구로구	구로제4동	구로제4동제5투	4163	3055	1108	15	3040	1222	1807	1	4	5	1
서울특별시	구로구	구로제4동	구로제4동제6투	2947	2210	737	13	2197	918	1267	2	5	5	0
서울특별시	구로구	구로제5동	소계	25713	19832	5881	106	19726	8480	11162	8	11	46	19
서울특별시	구로구	구로제5동	구로제5동제1투	3891	2892	999	23	2869	1290	1562	0	3	10	4
서울특별시	구로구	구로제5동	구로제5동제2투	4226	3478	748	13	3465	1532	1921	1	1	7	3
서울특별시	구로구	구로제5동	구로제5동제3투	4425	3280	1145	22	3258	1388	1860	1	1	6	2
서울특별시	구로구	구로제5동	구로제5동제4투	4203	3018	1185	21	2997	1250	1736	2	2	1	6
서울특별시	구로구	구로제5동	구로제5동제5투	4871	3708	1163	16	3692	1401	2281	1	1	7	1
서울특별시	구로구	구로제5동	구로제5동제6투	4097	3456	641	11	3445	1619	1802	3	3	15	3
서울특별시	구로구	가리봉동	소계	11906	7526	4380	47	7479	3600	3853	6	4	7	9
서울특별시	구로구	가리봉동	가리봉동제1투	3910	2574	1336	17	2557	1222	1320	3	2	5	5
서울특별시	구로구	가리봉동	가리봉동제2투	4062	2642	1420	11	2631	1342	1282	2	1	1	3
서울특별시	구로구	가리봉동	가리봉동제3투	3934	2310	1624	19	2291	1036	1251	1	1	1	1
서울특별시	구로구	고척제1동	소계	20105	15506	4599	54	15452	7771	7636	7	4	19	15
서울특별시	구로구	고척제1동	고척제1동제1투	4168	3173	995	13	3160	1706	1442	0	1	8	3
서울특별시	구로구	고척제1동	고척제1동제2투	4530	3449	1081	10	3439	1701	1727	2	0	5	4
서울특별시	구로구	고척제1동	고척제1동제3투	4758	3832	926	8	3824	1883	1936	1	1	1	2
서울특별시	구로구	고척제1동	고척제1동제4투	3209	2348	861	9	2339	1145	1188	1	0	1	4
서울특별시	구로구	고척제1동	고척제1동제5투	3440	2704	736	14	2690	1336	1343	3	2	4	2
서울특별시	구로구	고척제2동	소계	24188	18470	5718	85	18385	8741	9574	10	11	33	16
서울특별시	구로구	고척제2동	고척제2동제1투	3618	2758	860	18	2740	1260	1470	1	4	2	3
서울특별시	구로구	고척제2동	고척제2동제2투	3734	2992	742	11	2981	1397	1578	3	1	2	0
서울특별시	구로구	고척제2동	고척제2동제3투	3811	2813	998	15	2798	1335	1449	2	5	5	2
서울특별시	구로구	고척제2동	고척제2동제4투	3230	2265	965	6	2259	1072	1173	1	0	7	6
서울특별시	구로구	고척제2동	고척제2동제5투	3315	2365	950	19	2346	1188	1148	1	0	5	4
서울특별시	구로구	고척제2동	고척제2동제6투	3612	3011	601	7	3004	1441	1553	2	0	8	0
서울특별시	구로구	고척제2동	고척제2동제7투	2868	2266	602	9	2257	1048	1203	0	1	4	1
서울특별시	구로구	개봉제1동	소계	27260	20611	6649	92	20519	9949	10508	9	9	29	15
서울특별시	구로구	개봉제1동	개봉제1동제1투	3566	2614	952	19	2595	1289	1293	1	2	6	4
서울특별시	구로구	개봉제1동	개봉제1동제2투	3050	2365	685	18	2347	1164	1176	0	1	3	3
서울특별시	구로구	개봉제1동	개봉제1동제3투	3094	2213	881	11	2202	1073	1123	1	1	2	2
서울특별시	구로구	개봉제1동	개봉제1동제4투	3451	2634	817	5	2629	1271	1350	1	2	2	3
서울특별시	구로구	개봉제1동	개봉제1동제5투	2501	1596	905	9	1587	806	770	3	1	5	2
서울특별시	구로구	개봉제1동	개봉제1동제6투	3384	2462	922	13	2449	1230	1216	1	0	2	0
서울특별시	구로구	개봉제1동	개봉제1동제7투	3182	2475	707	7	2468	1151	1311	1	1	4	0
서울특별시	구로구	개봉제1동	개봉제1동제8투	5032	4252	780	10	4242	1965	2269	1	1	5	1
서울특별시	구로구	개봉제2동	소계	27979	22461	5518	85	22376	10475	11821	5	13	39	23
서울특별시	구로구	개봉제2동	개봉제2동제1투	3695	2756	939	12	2744	1261	1476	1	1	3	2
서울특별시	구로구	개봉제2동	개봉제2동제2투	3469	2674	795	15	2659	1217	1433	0	2	4	3
서울특별시	구로구	개봉제2동	개봉제2동제3투	3493	2949	544	7	2942	1464	1470	0	1	4	3
서울특별시	구로구	개봉제2동	개봉제2동제4투	3985	3379	606	8	3371	1526	1830	3	0	9	3
서울특별시	구로구	개봉제2동	개봉제2동제5투	3738	3192	546	15	3177	1611	1555	0	1	8	2
서울특별시	구로구	개봉제2동	개봉제2동제6투	3547	2902	645	8	2894	1332	1552	1	3	4	2
서울특별시	구로구	개봉제2동	개봉제2동제7투	3392	2559	833	12	2547	1082	1453	0	3	3	6
서울특별시	구로구	개봉제2동	개봉제2동제8투	2660	2050	610	8	2042	982	1052	0	2	4	2
서울특별시	구로구	개봉제3동	소계	17653	13469	4184	43	13426	6287	7092	11	5	20	11
서울특별시	구로구	개봉제3동	개봉제3동제1투	3394	2512	882	14	2498	1196	1289	2	1	8	2
서울특별시	구로구	개봉제3동	개봉제3동제2투	3808	2797	1011	8	2789	1283	1501	1	1	0	3
서울특별시	구로구	개봉제3동	개봉제3동제3투	3821	2806	1015	8	2798	1360	1427	4	1	3	3
서울특별시	구로구	개봉제3동	개봉제3동제4투	3473	2937	536	6	2931	1409	1514	1	2	4	1
서울특별시	구로구	개봉제3동	개봉제3동제5투	3157	2417	740	7	2410	1039	1361	3	0	5	2
서울특별시	구로구	오류제1동	소계	17194	13016	4178	60	12956	6517	6402	5	4	18	10
서울특별시	구로구	오류제1동	오류제1동제1투	4943	3594	1349	16	3578	1631	1937	1	1	6	2
서울특별시	구로구	오류제1동	오류제1동제2투	4461	3401	1060	13	3388	1716	1666	0	1	2	3
서울특별시	구로구	오류제1동	오류제1동제3투	4304	3173	1131	15	3158	1726	1421	3	1	5	2
서울특별시	구로구	오류제1동	오류제1동제4투	3486	2848	638	16	2832	1444	1378	1	1	5	3
서울특별시	구로구	오류제2동	소계	30774	24074	6700	99	23975	11282	12601	18	18	37	19
서울특별시	구로구	오류제2동	오류제2동제1투	4678	3555	1123	24	3531	1847	1663	4	5	9	3
서울특별시	구로구	오류제2동	오류제2동제2투	4733	3437	1296	16	3421	1764	1653	1	0	1	2
서울특별시	구로구	오류제2동	오류제2동제3투	4159	3427	732	11	3416	1724	1687	0	0	3	2
서울특별시	구로구	오류제2동	오류제2동제4투	4279	3371	908	12	3359	1606	1737	5	3	7	1
서울특별시	구로구	오류제2동	오류제2동제5투	4554	3556	998	15	3541	1617	1906	2	5	7	4
서울특별시	구로구	오류제2동	오류제2동제6투	4258	3387	871	10	3377	1401	1962	5	2	5	2
서울특별시	구로구	오류제2동	오류제2동제7투	4113	3341	772	11	3330	1323	1993	1	3	5	5
서울특별시	구로구	수궁동	소계	20229	15682	4547	72	15610	8059	7484	6	15	30	16
서울특별시	구로구	수궁동	수궁동제1투	3781	2786	995	20	2766	1785	967	1	5	4	4
서울특별시	구로구	수궁동	수궁동제2투	3790	2950	840	7	2943	1517	1411	2	2	9	2
서울특별시	구로구	수궁동	수궁동제3투	4183	3296	887	21	3275	1671	1591	0	3	6	4
서울특별시	구로구	수궁동	수궁동제4투	3173	2603	570	10	2593	1216	1369	1	2	3	2
서울특별시	구로구	수궁동	수궁동제5투	3561	2717	844	12	2705	1286	1406	2	2	6	3
서울특별시	구로구	수궁동	수궁동제6투	1741	1330	411	2	1328	584	740	0	1	2	1
서울특별시	구로구	잘못 투입·구분된 투표지	잘못 투입·구분된 투표지	0	23	-23	0	23	13	10	0	0	0	0
서울특별시	금천구	계	계	202808	147632	55176	829	146803	66316	79933	97	112	213	132
서울특별시	금천구	재외투표	재외투표	1103	793	310	3	790	317	470	1	0	1	1
서울특별시	금천구	국내부재자투표	국내부재자투표	3852	3644	208	72	3572	1660	1873	6	11	7	15
서울특별시	금천구	가산동	소계	17074	12000	5074	60	11940	4787	7105	8	10	19	11
서울특별시	금천구	가산동	가산동제1투	3474	2171	1303	12	2159	941	1206	3	3	5	1
서울특별시	금천구	가산동	가산동제2투	3290	2245	1045	15	2230	799	1425	0	1	2	3
서울특별시	금천구	가산동	가산동제3투	3974	3232	742	10	3222	1431	1776	4	1	8	2
서울특별시	금천구	가산동	가산동제4투	3855	2647	1208	12	2635	896	1731	1	4	2	1
서울특별시	금천구	가산동	가산동제5투	1590	1085	505	11	1074	466	605	0	1	1	1
서울특별시	금천구	가산동	가산동제6투	891	620	271	0	620	254	362	0	0	1	3
서울특별시	금천구	독산제1동	소계	26225	19198	7027	102	19096	8195	10839	16	8	24	14
서울특별시	금천구	독산제1동	독산제1동제1투	3902	2487	1415	6	2481	1020	1459	1	1	0	0
서울특별시	금천구	독산제1동	독산제1동제2투	2856	1899	957	11	1888	751	1131	2	1	1	2
서울특별시	금천구	독산제1동	독산제1동제3투	5804	4099	1705	18	4081	1557	2512	1	1	6	4
서울특별시	금천구	독산제1동	독산제1동제4투	4760	3911	849	10	3901	1722	2166	5	2	4	2
서울특별시	금천구	독산제1동	독산제1동제5투	4221	3185	1036	35	3150	1390	1745	6	1	5	3
서울특별시	금천구	독산제1동	독산제1동제6투	4682	3617	1065	22	3595	1755	1826	1	2	8	3
서울특별시	금천구	독산제2동	소계	18555	12964	5591	75	12889	5758	7083	7	12	19	10
서울특별시	금천구	독산제2동	독산제2동제1투	2981	1944	1037	16	1928	884	1036	1	1	6	0
서울특별시	금천구	독산제2동	독산제2동제2투	3165	2177	988	15	2162	977	1173	2	2	4	4
서울특별시	금천구	독산제2동	독산제2동제3투	2903	2143	760	8	2135	943	1184	1	3	0	4
서울특별시	금천구	독산제2동	독산제2동제4투	2951	2149	802	19	2130	968	1158	0	0	2	2
서울특별시	금천구	독산제2동	독산제2동제5투	3192	2126	1066	7	2119	904	1209	1	2	3	0
서울특별시	금천구	독산제2동	독산제2동제6투	3363	2425	938	10	2415	1082	1323	2	4	4	0
서울특별시	금천구	독산제3동	소계	23409	16313	7096	83	16230	7231	8935	13	11	23	17
서울특별시	금천구	독산제3동	독산제3동제1투	3862	2768	1094	11	2757	1197	1543	3	3	5	6
서울특별시	금천구	독산제3동	독산제3동제2투	4209	2632	1577	11	2621	1212	1402	4	1	2	0
서울특별시	금천구	독산제3동	독산제3동제3투	4533	3225	1308	13	3212	1360	1843	1	3	4	1
서울특별시	금천구	독산제3동	독산제3동제4투	3483	2304	1179	16	2288	1060	1214	4	0	5	5
서울특별시	금천구	독산제3동	독산제3동제5투	3678	2659	1019	20	2639	1212	1422	0	1	3	1
서울특별시	금천구	독산제3동	독산제3동제6투	3644	2725	919	12	2713	1190	1511	1	3	4	4
서울특별시	금천구	독산제4동	소계	15525	10806	4719	55	10751	4749	5978	4	6	11	3
서울특별시	금천구	독산제4동	독산제4동제1투	4079	2640	1439	19	2621	1263	1354	1	1	2	0
서울특별시	금천구	독산제4동	독산제4동제2투	4036	2865	1171	10	2855	1225	1625	1	0	3	1
서울특별시	금천구	독산제4동	독산제4동제3투	3375	2299	1076	7	2292	1004	1282	1	2	2	1
서울특별시	금천구	독산제4동	독산제4동제4투	4035	3002	1033	19	2983	1257	1717	1	3	4	1
서울특별시	금천구	시흥제1동	소계	29116	20976	8140	110	20866	9823	10977	13	13	29	11
서울특별시	금천구	시흥제1동	시흥제1동제1투	3554	2743	811	16	2727	1283	1438	1	2	2	1
서울특별시	금천구	시흥제1동	시흥제1동제2투	3967	3040	927	17	3023	1417	1595	1	2	4	4
서울특별시	금천구	시흥제1동	시흥제1동제3투	5337	4275	1062	12	4263	2030	2224	0	2	5	2
서울특별시	금천구	시흥제1동	시흥제1동제4투	3226	2205	1021	11	2194	967	1220	1	1	5	0
서울특별시	금천구	시흥제1동	시흥제1동제5투	3526	2398	1128	18	2380	1178	1192	1	2	6	1
서울특별시	금천구	시흥제1동	시흥제1동제6투	3069	2161	908	10	2151	975	1167	3	3	2	1
서울특별시	금천구	시흥제1동	시흥제1동제7투	2927	2078	849	17	2061	986	1066	4	0	3	2
서울특별시	금천구	시흥제1동	시흥제1동제8투	3510	2076	1434	9	2067	987	1075	2	1	2	0
서울특별시	금천구	시흥제2동	소계	19248	15169	4079	70	15099	6955	8087	11	8	27	11
서울특별시	금천구	시흥제2동	시흥제2동제1투	3182	2443	739	11	2432	1185	1235	2	1	7	2
서울특별시	금천구	시흥제2동	시흥제2동제2투	3024	2339	685	13	2326	1035	1281	2	3	4	1
서울특별시	금천구	시흥제2동	시흥제2동제3투	3748	2830	918	18	2812	1467	1340	1	0	4	0
서울특별시	금천구	시흥제2동	시흥제2동제4투	3511	2964	547	13	2951	1411	1531	2	1	6	0
서울특별시	금천구	시흥제2동	시흥제2동제5투	3216	2668	548	5	2663	1026	1627	2	3	3	2
서울특별시	금천구	시흥제2동	시흥제2동제6투	2567	1925	642	10	1915	831	1073	2	0	3	6
서울특별시	금천구	시흥제3동	소계	10386	7956	2430	44	7912	3757	4118	5	10	17	5
서울특별시	금천구	시흥제3동	시흥제3동제1투	3333	2451	882	15	2436	1170	1257	1	2	6	0
서울특별시	금천구	시흥제3동	시흥제3동제2투	2657	1990	667	9	1981	901	1064	1	4	9	2
서울특별시	금천구	시흥제3동	시흥제3동제3투	2679	2136	543	12	2124	1021	1099	1	3	0	0
서울특별시	금천구	시흥제3동	시흥제3동제4투	1717	1379	338	8	1371	665	698	2	1	2	3
서울특별시	금천구	시흥제4동	소계	19189	13981	5208	68	13913	6501	7354	7	13	16	22
서울특별시	금천구	시흥제4동	시흥제4동제1투	3285	2353	932	15	2338	1144	1186	0	3	2	3
서울특별시	금천구	시흥제4동	시흥제4동제2투	3076	1996	1080	12	1984	963	1015	2	1	1	2
서울특별시	금천구	시흥제4동	시흥제4동제3투	2944	2132	812	13	2119	977	1138	0	1	1	2
서울특별시	금천구	시흥제4동	시흥제4동제4투	3304	2653	651	9	2644	1165	1464	3	3	4	5
서울특별시	금천구	시흥제4동	시흥제4동제5투	3369	2494	875	10	2484	1188	1285	1	1	4	5
서울특별시	금천구	시흥제4동	시흥제4동제6투	3211	2353	858	9	2344	1064	1266	1	4	4	5
서울특별시	금천구	시흥제5동	소계	19126	13799	5327	86	13713	6567	7098	6	10	20	12
서울특별시	금천구	시흥제5동	시흥제5동제1투	3754	2779	975	21	2758	1284	1463	0	4	5	2
서울특별시	금천구	시흥제5동	시흥제5동제2투	4224	2854	1370	15	2839	1339	1491	4	1	2	2
서울특별시	금천구	시흥제5동	시흥제5동제3투	4249	3186	1063	14	3172	1488	1674	0	1	6	3
서울특별시	금천구	시흥제5동	시흥제5동제4투	3588	2569	1019	20	2549	1251	1286	1	4	2	5
서울특별시	금천구	시흥제5동	시흥제5동제5투	3311	2411	900	16	2395	1205	1184	1	0	5	0
서울특별시	금천구	잘못 투입·구분된 투표지	잘못 투입·구분된 투표지	0	33	-33	1	32	16	16	0	0	0	0
서울특별시	영등포구	계	계	327297	245975	81322	1160	244815	118167	125657	134	149	498	210
서울특별시	영등포구	재외투표	재외투표	3083	2359	724	8	2351	1038	1308	0	1	4	0
서울특별시	영등포구	국내부재자투표	국내부재자투표	6059	5669	390	102	5567	2759	2765	4	15	12	12
서울특별시	영등포구	영등포본동	소계	20475	15260	5215	65	15195	6975	8170	9	4	25	12
서울특별시	영등포구	영등포본동	영등포본동제1투	3550	2702	848	14	2688	1277	1404	0	0	6	1
서울특별시	영등포구	영등포본동	영등포본동제2투	2958	2109	849	15	2094	1069	1016	1	1	5	2
서울특별시	영등포구	영등포본동	영등포본동제3투	2405	1616	789	4	1612	804	805	1	0	2	0
서울특별시	영등포구	영등포본동	영등포본동제4투	2650	1723	927	6	1717	753	958	2	0	3	1
서울특별시	영등포구	영등포본동	영등포본동제5투	2101	1452	649	11	1441	698	740	1	1	1	0
서울특별시	영등포구	영등포본동	영등포본동제6투	3180	2574	606	6	2568	1136	1420	2	1	4	5
서울특별시	영등포구	영등포본동	영등포본동제7투	3631	3084	547	9	3075	1238	1827	2	1	4	3
서울특별시	영등포구	영등포동	소계	16814	11334	5480	61	11273	5716	5506	5	9	23	14
서울특별시	영등포구	영등포동	영등포동제1투	3830	2104	1726	14	2090	1013	1069	1	1	6	0
서울특별시	영등포구	영등포동	영등포동제2투	2986	1711	1275	17	1694	883	799	2	3	4	3
서울특별시	영등포구	영등포동	영등포동제3투	3397	2528	869	6	2522	1330	1182	1	3	4	2
서울특별시	영등포구	영등포동	영등포동제4투	3325	2377	948	12	2365	1089	1267	0	2	2	5
서울특별시	영등포구	영등포동	영등포동제5투	3276	2614	662	12	2602	1401	1189	1	0	7	4
서울특별시	영등포구	여의동	소계	26856	20741	6115	68	20673	13547	7053	1	6	59	7
서울특별시	영등포구	여의동	여의동제1투	3562	2873	689	4	2869	1733	1119	0	2	13	2
서울특별시	영등포구	여의동	여의동제2투	4484	3045	1439	14	3031	2028	1001	0	0	2	0
서울특별시	영등포구	여의동	여의동제3투	3398	2770	628	10	2760	1778	973	0	2	7	0
서울특별시	영등포구	여의동	여의동제4투	3390	2659	731	12	2647	1789	853	0	1	4	0
서울특별시	영등포구	여의동	여의동제5투	3259	2592	667	9	2583	1601	968	1	1	11	1
서울특별시	영등포구	여의동	여의동제6투	3536	2813	723	8	2805	1839	954	0	0	10	2
서울특별시	영등포구	여의동	여의동제7투	3936	3080	856	8	3072	2314	746	0	0	10	2
서울특별시	영등포구	여의동	여의동제8투	1291	909	382	3	906	465	439	0	0	2	0
서울특별시	영등포구	당산제1동	소계	17221	12957	4264	56	12901	5963	6880	6	9	32	11
서울특별시	영등포구	당산제1동	당산제1동제1투	2363	1688	675	18	1670	787	879	2	0	2	0
서울특별시	영등포구	당산제1동	당산제1동제2투	3816	2951	865	13	2938	1416	1508	2	5	3	4
서울특별시	영등포구	당산제1동	당산제1동제3투	3789	2857	932	6	2851	1233	1603	0	1	11	3
서울특별시	영등포구	당산제1동	당산제1동제4투	3996	2956	1040	9	2947	1393	1536	1	2	12	3
서울특별시	영등포구	당산제1동	당산제1동제5투	3257	2505	752	10	2495	1134	1354	1	1	4	1
서울특별시	영등포구	당산제2동	소계	27417	21598	5819	70	21528	10248	11191	11	16	47	15
서울특별시	영등포구	당산제2동	당산제2동제1투	3848	2601	1247	14	2587	1135	1436	5	2	4	5
서울특별시	영등포구	당산제2동	당산제2동제2투	4690	3793	897	14	3779	1819	1946	0	3	10	1
서울특별시	영등포구	당산제2동	당산제2동제3투	4765	3753	1012	11	3742	1606	2114	3	5	10	4
서울특별시	영등포구	당산제2동	당산제2동제4투	4925	3885	1040	14	3871	1765	2094	1	0	8	3
서울특별시	영등포구	당산제2동	당산제2동제5투	3972	3370	602	9	3361	2094	1255	2	2	7	1
서울특별시	영등포구	당산제2동	당산제2동제6투	5217	4196	1021	8	4188	1829	2346	0	4	8	1
서울특별시	영등포구	도림동	소계	15705	11089	4616	49	11040	4975	6017	9	10	21	8
서울특별시	영등포구	도림동	도림동제1투	4492	3076	1416	13	3063	1522	1531	1	1	7	1
서울특별시	영등포구	도림동	도림동제2투	3715	2422	1293	14	2408	1164	1231	3	3	6	1
서울특별시	영등포구	도림동	도림동제3투	4343	3241	1102	12	3229	1320	1895	3	5	4	2
서울특별시	영등포구	도림동	도림동제4투	3155	2350	805	10	2340	969	1360	2	1	4	4
서울특별시	영등포구	문래동	소계	25299	20390	4909	61	20329	9755	10508	9	6	38	13
서울특별시	영등포구	문래동	문래동제1투	2922	1894	1028	11	1883	976	902	1	2	1	1
서울특별시	영등포구	문래동	문래동제2투	2672	2282	390	7	2275	1240	1029	0	0	4	2
서울특별시	영등포구	문래동	문래동제3투	4085	3300	785	10	3290	1485	1790	3	0	11	1
서울특별시	영등포구	문래동	문래동제4투	3444	2923	521	4	2919	1820	1092	0	2	3	2
서울특별시	영등포구	문래동	문래동제5투	4414	3567	847	18	3549	1674	1862	1	1	8	3
서울특별시	영등포구	문래동	문래동제6투	3811	3178	633	4	3174	1189	1975	2	0	6	2
서울특별시	영등포구	문래동	문래동제7투	3951	3246	705	7	3239	1371	1858	2	1	5	2
서울특별시	영등포구	양평제1동	소계	14002	10838	3164	49	10789	4699	6044	5	10	17	14
서울특별시	영등포구	양평제1동	양평제1동제1투	3618	2599	1019	16	2583	1331	1241	1	4	3	3
서울특별시	영등포구	양평제1동	양평제1동제2투	3689	2984	705	12	2972	1168	1795	1	1	4	3
서울특별시	영등포구	양평제1동	양평제1동제3투	3269	2529	740	15	2514	1186	1315	1	5	2	5
서울특별시	영등포구	양평제1동	양평제1동제4투	3426	2726	700	6	2720	1014	1693	2	0	8	3
서울특별시	영등포구	양평제2동	소계	17308	13681	3627	58	13623	5877	7692	5	10	27	12
서울특별시	영등포구	양평제2동	양평제2동제1투	3647	2987	660	4	2983	1279	1691	0	1	8	4
서울특별시	영등포구	양평제2동	양평제2동제2투	3491	2770	721	12	2758	1265	1475	2	4	7	5
서울특별시	영등포구	양평제2동	양평제2동제3투	3449	2496	953	14	2482	1049	1423	0	4	6	0
서울특별시	영등포구	양평제2동	양평제2동제4투	3540	2967	573	18	2949	1280	1662	0	0	4	3
서울특별시	영등포구	양평제2동	양평제2동제5투	3181	2461	720	10	2451	1004	1441	3	1	2	0
서울특별시	영등포구	신길제1동	소계	17436	12398	5038	68	12330	5684	6598	12	9	19	8
서울특별시	영등포구	신길제1동	신길제1동제1투	3486	2497	989	15	2482	1017	1453	2	5	4	1
서울특별시	영등포구	신길제1동	신길제1동제2투	3334	2410	924	14	2396	1125	1256	3	2	8	2
서울특별시	영등포구	신길제1동	신길제1동제3투	3798	2500	1298	16	2484	1152	1328	0	2	0	2
서울특별시	영등포구	신길제1동	신길제1동제4투	3393	2489	904	12	2477	1235	1231	6	0	3	2
서울특별시	영등포구	신길제1동	신길제1동제5투	3425	2502	923	11	2491	1155	1330	1	0	4	1
서울특별시	영등포구	신길제3동	소계	13530	9947	3583	52	9895	4782	5075	3	7	17	11
서울특별시	영등포구	신길제3동	신길제3동제1투	3049	2201	848	10	2191	1076	1103	1	0	6	5
서울특별시	영등포구	신길제3동	신길제3동제2투	3501	2454	1047	17	2437	1156	1274	0	2	5	0
서울특별시	영등포구	신길제3동	신길제3동제3투	3367	2695	672	10	2685	1313	1365	0	3	2	2
서울특별시	영등포구	신길제3동	신길제3동제4투	2684	1938	746	10	1928	933	985	2	2	3	3
서울특별시	영등포구	신길제3동	신길제3동제5투	929	659	270	5	654	304	348	0	0	1	1
서울특별시	영등포구	신길제4동	소계	10526	7600	2926	48	7552	3731	3787	7	6	12	9
서울특별시	영등포구	신길제4동	신길제4동제1투	3039	1974	1065	10	1964	936	1019	1	1	2	5
서울특별시	영등포구	신길제4동	신길제4동제2투	2558	1846	712	11	1835	955	869	2	2	4	3
서울특별시	영등포구	신길제4동	신길제4동제3투	2010	1420	590	13	1407	683	714	3	3	4	0
서울특별시	영등포구	신길제4동	신길제4동제4투	2919	2360	559	14	2346	1157	1185	1	0	2	1
서울특별시	영등포구	신길제5동	소계	13564	9618	3946	52	9566	4483	5030	10	3	25	15
서울특별시	영등포구	신길제5동	신길제5동제1투	3115	2046	1069	10	2036	952	1078	1	1	2	2
서울특별시	영등포구	신길제5동	신길제5동제2투	2502	1845	657	11	1834	890	932	2	1	6	3
서울특별시	영등포구	신길제5동	신길제5동제3투	3066	2285	781	10	2275	1058	1205	4	0	3	5
서울특별시	영등포구	신길제5동	신길제5동제4투	2428	1687	741	11	1676	771	893	2	0	7	3
서울특별시	영등포구	신길제5동	신길제5동제5투	2453	1755	698	10	1745	812	922	1	1	7	2
서울특별시	영등포구	신길제6동	소계	18764	13966	4798	65	13901	6539	7301	7	6	36	12
서울특별시	영등포구	신길제6동	신길제6동제1투	2616	1745	871	11	1734	868	860	2	1	1	2
서울특별시	영등포구	신길제6동	신길제6동제2투	2340	1398	942	8	1390	675	708	1	1	4	1
서울특별시	영등포구	신길제6동	신길제6동제3투	3455	2853	602	9	2844	1290	1542	2	2	7	1
서울특별시	영등포구	신길제6동	신길제6동제4투	3282	2672	610	8	2664	1271	1374	2	2	12	3
서울특별시	영등포구	신길제6동	신길제6동제5투	3956	2982	974	11	2971	1339	1622	0	0	5	5
서울특별시	영등포구	신길제6동	신길제6동제6투	3115	2316	799	18	2298	1096	1195	0	0	7	0
서울특별시	영등포구	신길제7동	소계	11862	9202	2660	35	9167	4905	4219	5	4	24	10
서울특별시	영등포구	신길제7동	신길제7동제1투	1774	1349	425	4	1345	807	534	1	0	3	0
서울특별시	영등포구	신길제7동	신길제7동제2투	3039	2377	662	11	2366	1213	1140	1	1	7	4
서울특별시	영등포구	신길제7동	신길제7동제3투	3177	2149	1028	10	2139	1016	1115	2	3	2	1
서울특별시	영등포구	신길제7동	신길제7동제4투	3872	3327	545	10	3317	1869	1430	1	0	12	5
서울특별시	영등포구	대림제1동	소계	13692	9771	3921	54	9717	4355	5332	5	3	13	9
서울특별시	영등포구	대림제1동	대림제1동제1투	3246	2182	1064	14	2168	1022	1138	2	1	4	1
서울특별시	영등포구	대림제1동	대림제1동제2투	2904	2201	703	13	2188	973	1205	1	2	5	2
서울특별시	영등포구	대림제1동	대림제1동제3투	2486	1888	598	6	1882	861	1016	1	0	1	3
서울특별시	영등포구	대림제1동	대림제1동제4투	2531	1770	761	15	1755	750	1002	1	0	1	1
서울특별시	영등포구	대림제1동	대림제1동제5투	2525	1730	795	6	1724	749	971	0	0	2	2
서울특별시	영등포구	대림제2동	소계	14675	10275	4400	55	10220	4606	5583	5	7	12	7
서울특별시	영등포구	대림제2동	대림제2동제1투	2343	1466	877	13	1453	671	778	1	0	0	3
서울특별시	영등포구	대림제2동	대림제2동제2투	2220	1561	659	9	1552	738	807	0	1	6	0
서울특별시	영등포구	대림제2동	대림제2동제3투	2980	2056	924	11	2045	934	1107	2	1	1	0
서울특별시	영등포구	대림제2동	대림제2동제4투	4140	3089	1051	10	3079	1350	1719	2	2	4	2
서울특별시	영등포구	대림제2동	대림제2동제5투	2992	2103	889	12	2091	913	1172	0	3	1	2
서울특별시	영등포구	대림제3동	소계	23009	17271	5738	84	17187	7521	9596	16	8	35	11
서울특별시	영등포구	대림제3동	대림제3동제1투	3412	2487	925	10	2477	1085	1387	2	1	0	2
서울특별시	영등포구	대림제3동	대림제3동제2투	3094	2273	821	9	2264	1080	1172	6	2	3	1
서울특별시	영등포구	대림제3동	대림제3동제3투	2730	2080	650	12	2068	902	1157	3	0	4	2
서울특별시	영등포구	대림제3동	대림제3동제4투	3017	2058	959	13	2045	846	1187	2	1	6	3
서울특별시	영등포구	대림제3동	대림제3동제5투	3434	2424	1010	14	2410	1059	1339	0	0	11	1
서울특별시	영등포구	대림제3동	대림제3동제6투	3285	2598	687	20	2578	1074	1490	3	3	6	2
서울특별시	영등포구	대림제3동	대림제3동제7투	4037	3351	686	6	3345	1475	1864	0	1	5	0
서울특별시	영등포구	잘못 투입·구분된 투표지	잘못 투입·구분된 투표지	0	11	-11	0	11	9	2	0	0	0	0
서울특별시	동작구	계	계	338206	260307	77899	1294	259013	117538	140437	154	143	514	227
서울특별시	동작구	재외투표	재외투표	3359	2496	863	13	2483	1032	1440	1	3	5	2
서울특별시	동작구	국내부재자투표	국내부재자투표	6874	6415	459	92	6323	2899	3376	9	11	15	13
서울특별시	동작구	노량진제1동	소계	28047	21901	6146	116	21785	10072	11624	14	15	48	12
서울특별시	동작구	노량진제1동	노량진제1동제1투	3847	3233	614	8	3225	1511	1700	0	1	11	2
서울특별시	동작구	노량진제1동	노량진제1동제2투	3844	2980	864	21	2959	1228	1718	4	3	3	3
서울특별시	동작구	노량진제1동	노량진제1동제3투	3192	2691	501	12	2679	1268	1400	3	1	7	0
서울특별시	동작구	노량진제1동	노량진제1동제4투	3678	2330	1348	22	2308	1027	1267	4	1	8	1
서울특별시	동작구	노량진제1동	노량진제1동제5투	2927	2278	649	12	2266	1143	1108	2	2	7	4
서울특별시	동작구	노량진제1동	노량진제1동제6투	4030	3039	991	20	3019	1336	1676	1	1	4	1
서울특별시	동작구	노량진제1동	노량진제1동제7투	1864	1582	282	7	1575	859	713	0	0	3	0
서울특별시	동작구	노량진제1동	노량진제1동제8투	2405	1901	504	12	1889	879	1007	0	2	1	0
서울특별시	동작구	노량진제1동	노량진제1동제9투	2260	1867	393	2	1865	821	1035	0	4	4	1
서울특별시	동작구	노량진제2동	소계	13403	9586	3817	47	9539	4276	5230	6	4	15	8
서울특별시	동작구	노량진제2동	노량진제2동제1투	2148	1604	544	4	1600	742	854	0	1	1	2
서울특별시	동작구	노량진제2동	노량진제2동제2투	4015	2760	1255	11	2749	1276	1467	3	0	3	0
서울특별시	동작구	노량진제2동	노량진제2동제3투	3720	2653	1067	10	2643	1150	1482	2	0	7	2
서울특별시	동작구	노량진제2동	노량진제2동제4투	3520	2569	951	22	2547	1108	1427	1	3	4	4
서울특별시	동작구	상도제1동	소계	33984	26169	7815	111	26058	11845	14111	13	17	53	19
서울특별시	동작구	상도제1동	상도제1동제1투	4968	3774	1194	27	3747	1596	2132	4	6	5	4
서울특별시	동작구	상도제1동	상도제1동제2투	5304	3942	1362	24	3918	1719	2181	3	0	11	4
서울특별시	동작구	상도제1동	상도제1동제3투	3806	2954	852	14	2940	1328	1598	1	3	8	2
서울특별시	동작구	상도제1동	상도제1동제4투	4442	3473	969	13	3460	1558	1888	1	0	9	4
서울특별시	동작구	상도제1동	상도제1동제5투	5101	3849	1252	11	3838	2050	1774	1	3	8	2
서울특별시	동작구	상도제1동	상도제1동제6투	4548	3540	1008	8	3532	1659	1866	1	1	4	1
서울특별시	동작구	상도제1동	상도제1동제7투	4030	3111	919	11	3100	1312	1774	2	3	7	2
서울특별시	동작구	상도제1동	상도제1동제8투	1785	1526	259	3	1523	623	898	0	1	1	0
서울특별시	동작구	상도제2동	소계	20855	15897	4958	82	15815	7451	8296	2	11	40	15
서울특별시	동작구	상도제2동	상도제2동제1투	4267	3289	978	25	3264	1493	1759	0	1	10	1
서울특별시	동작구	상도제2동	상도제2동제2투	5155	3744	1411	10	3734	1790	1931	0	3	8	2
서울특별시	동작구	상도제2동	상도제2동제3투	2923	2292	631	9	2283	1010	1262	1	1	5	4
서울특별시	동작구	상도제2동	상도제2동제4투	4701	3777	924	16	3761	1913	1825	1	6	13	3
서울특별시	동작구	상도제2동	상도제2동제5투	3809	2795	1014	22	2773	1245	1519	0	0	4	5
서울특별시	동작구	상도제3동	소계	20241	15243	4998	69	15174	6544	8565	11	7	34	13
서울특별시	동작구	상도제3동	상도제3동제1투	4886	3732	1154	18	3714	1737	1963	1	0	10	3
서울특별시	동작구	상도제3동	상도제3동제2투	4032	2864	1168	13	2851	1226	1616	1	1	6	1
서울특별시	동작구	상도제3동	상도제3동제3투	3450	2602	848	12	2590	1088	1486	3	3	5	5
서울특별시	동작구	상도제3동	상도제3동제4투	3306	2525	781	8	2517	1056	1449	3	1	7	1
서울특별시	동작구	상도제3동	상도제3동제5투	4567	3520	1047	18	3502	1437	2051	3	2	6	3
서울특별시	동작구	상도제4동	소계	23946	17662	6284	96	17566	7771	9721	6	8	41	19
서울특별시	동작구	상도제4동	상도제4동제1투	3530	2600	930	21	2579	1067	1504	2	2	3	1
서울특별시	동작구	상도제4동	상도제4동제2투	3868	2835	1033	11	2824	1160	1651	1	1	6	5
서울특별시	동작구	상도제4동	상도제4동제3투	3570	2506	1064	18	2488	1135	1343	0	1	5	4
서울특별시	동작구	상도제4동	상도제4동제4투	3785	2751	1034	23	2728	1217	1497	1	1	8	4
서울특별시	동작구	상도제4동	상도제4동제5투	4842	3688	1154	6	3682	1805	1860	1	0	14	2
서울특별시	동작구	상도제4동	상도제4동제6투	4351	3282	1069	17	3265	1387	1866	1	3	5	3
서울특별시	동작구	흑석동	소계	28724	21680	7044	132	21548	10607	10857	14	10	39	21
서울특별시	동작구	흑석동	흑석동제1투	4051	3269	782	17	3252	1903	1341	0	1	5	2
서울특별시	동작구	흑석동	흑석동제2투	4023	2588	1435	26	2562	1301	1250	4	0	4	3
서울특별시	동작구	흑석동	흑석동제3투	3593	2667	926	18	2649	1264	1379	0	0	4	2
서울특별시	동작구	흑석동	흑석동제4투	3342	2469	873	15	2454	1096	1351	2	0	4	1
서울특별시	동작구	흑석동	흑석동제5투	3971	3011	960	18	2993	1316	1660	2	2	9	4
서울특별시	동작구	흑석동	흑석동제6투	3647	2720	927	12	2708	1243	1444	1	4	9	7
서울특별시	동작구	흑석동	흑석동제7투	3036	2380	656	16	2364	1121	1236	2	1	2	2
서울특별시	동작구	흑석동	흑석동제8투	3061	2576	485	10	2566	1363	1196	3	2	2	0
서울특별시	동작구	사당제1동	소계	20164	15203	4961	56	15147	6004	9078	13	8	28	16
서울특별시	동작구	사당제1동	사당제1동제1투	4959	3799	1160	17	3782	1584	2177	4	3	10	4
서울특별시	동작구	사당제1동	사당제1동제2투	3953	3080	873	10	3070	1130	1928	4	1	3	4
서울특별시	동작구	사당제1동	사당제1동제3투	3549	2679	870	8	2671	1074	1584	2	0	6	5
서울특별시	동작구	사당제1동	사당제1동제4투	3475	2617	858	11	2606	1030	1571	0	1	3	1
서울특별시	동작구	사당제1동	사당제1동제5투	4228	3028	1200	10	3018	1186	1818	3	3	6	2
서울특별시	동작구	사당제2동	소계	24438	19098	5340	89	19009	8747	10202	8	11	29	12
서울특별시	동작구	사당제2동	사당제2동제1투	3370	2645	725	9	2636	1291	1340	0	0	3	2
서울특별시	동작구	사당제2동	사당제2동제2투	3706	2785	921	24	2761	1117	1635	2	1	5	1
서울특별시	동작구	사당제2동	사당제2동제3투	3188	2459	729	17	2442	989	1444	1	1	6	1
서울특별시	동작구	사당제2동	사당제2동제4투	4288	3099	1189	13	3086	1405	1671	1	5	1	3
서울특별시	동작구	사당제2동	사당제2동제5투	3058	2420	638	7	2413	1032	1373	1	0	5	2
서울특별시	동작구	사당제2동	사당제2동제6투	3288	2709	579	7	2702	1314	1380	0	2	4	2
서울특별시	동작구	사당제2동	사당제2동제7투	3540	2981	559	12	2969	1599	1359	3	2	5	1
서울특별시	동작구	사당제3동	소계	21339	16700	4639	69	16631	7589	8984	13	7	30	8
서울특별시	동작구	사당제3동	사당제3동제1투	4173	3360	813	7	3353	1445	1892	2	4	8	2
서울특별시	동작구	사당제3동	사당제3동제2투	3182	2422	760	11	2411	1029	1374	0	1	7	0
서울특별시	동작구	사당제3동	사당제3동제3투	3762	2881	881	13	2868	1507	1352	2	0	6	1
서울특별시	동작구	사당제3동	사당제3동제4투	2650	1925	725	18	1907	731	1171	3	0	1	1
서울특별시	동작구	사당제3동	사당제3동제5투	3831	3031	800	10	3021	1365	1647	4	1	2	2
서울특별시	동작구	사당제3동	사당제3동제6투	3741	3081	660	10	3071	1512	1548	2	1	6	2
서울특별시	동작구	사당제4동	소계	12587	9656	2931	43	9613	3977	5595	7	3	23	8
서울특별시	동작구	사당제4동	사당제4동제1투	3280	2455	825	15	2440	988	1437	4	0	8	3
서울특별시	동작구	사당제4동	사당제4동제2투	3071	2478	593	12	2466	1073	1378	2	1	9	3
서울특별시	동작구	사당제4동	사당제4동제3투	3570	2699	871	10	2689	1052	1631	1	1	3	1
서울특별시	동작구	사당제4동	사당제4동제4투	2666	2024	642	6	2018	864	1149	0	1	3	1
서울특별시	동작구	사당제5동	소계	12350	9567	2783	45	9522	3918	5570	8	6	13	7
서울특별시	동작구	사당제5동	사당제5동제1투	2814	2154	660	11	2143	935	1202	1	3	1	1
서울특별시	동작구	사당제5동	사당제5동제2투	3400	2754	646	16	2738	1120	1610	3	2	2	1
서울특별시	동작구	사당제5동	사당제5동제3투	3283	2466	817	13	2453	997	1447	4	0	2	3
서울특별시	동작구	사당제5동	사당제5동제4투	2853	2193	660	5	2188	866	1311	0	1	8	2
서울특별시	동작구	대방동	소계	31054	24322	6732	107	24215	11281	12842	9	9	51	23
서울특별시	동작구	대방동	대방동제1투	3782	2865	917	13	2852	1303	1539	0	2	3	5
서울특별시	동작구	대방동	대방동제2투	4048	3275	773	10	3265	1563	1690	3	0	9	0
서울특별시	동작구	대방동	대방동제3투	4772	3827	945	11	3816	1894	1912	1	0	7	2
서울특별시	동작구	대방동	대방동제4투	3865	2850	1015	21	2829	1229	1589	3	1	4	3
서울특별시	동작구	대방동	대방동제5투	4050	3344	706	13	3331	1792	1518	0	1	18	2
서울특별시	동작구	대방동	대방동제6투	2759	2147	612	9	2138	937	1191	0	0	3	7
서울특별시	동작구	대방동	대방동제7투	3623	2828	795	12	2816	1207	1601	1	1	4	2
서울특별시	동작구	대방동	대방동제8투	4155	3186	969	18	3168	1356	1802	1	4	3	2
서울특별시	동작구	신대방제1동	소계	20344	15924	4420	83	15841	7549	8225	11	9	30	17
서울특별시	동작구	신대방제1동	신대방제1동제1투	2761	2069	692	14	2055	879	1172	2	1	1	0
서울특별시	동작구	신대방제1동	신대방제1동제2투	3542	2550	992	20	2530	1244	1273	2	0	4	7
서울특별시	동작구	신대방제1동	신대방제1동제3투	4726	4001	725	15	3986	1863	2103	2	1	13	4
서울특별시	동작구	신대방제1동	신대방제1동제4투	4783	3529	1254	22	3507	1590	1904	2	2	4	5
서울특별시	동작구	신대방제1동	신대방제1동제5투	4532	3775	757	12	3763	1973	1773	3	5	8	1
서울특별시	동작구	신대방제2동	소계	16497	12766	3731	44	12722	5966	6709	9	4	20	14
서울특별시	동작구	신대방제2동	신대방제2동제1투	3883	3110	773	14	3096	1361	1719	1	2	7	6
서울특별시	동작구	신대방제2동	신대방제2동제2투	4076	3049	1027	15	3034	1329	1697	5	1	0	2
서울특별시	동작구	신대방제2동	신대방제2동제3투	4108	3165	943	9	3156	1360	1778	2	1	11	4
서울특별시	동작구	신대방제2동	신대방제2동제4투	4430	3442	988	6	3436	1916	1515	1	0	2	2
서울특별시	동작구	잘못 투입·구분된 투표지	잘못 투입·구분된 투표지	0	22	-22	0	22	10	12	0	0	0	0
서울특별시	관악구	계	계	446910	333640	113270	1597	332043	134105	196560	201	260	630	287
서울특별시	관악구	재외투표	재외투표	3329	2494	835	13	2481	928	1540	1	4	6	2
서울특별시	관악구	국내부재자투표	국내부재자투표	8124	7539	585	133	7406	3177	4190	6	6	20	7
서울특별시	관악구	보라매동	소계	21873	16379	5494	73	16306	6977	9286	6	7	25	5
서울특별시	관악구	보라매동	보라매동제1투	3971	3169	802	12	3157	1543	1603	1	1	8	1
서울특별시	관악구	보라매동	보라매동제2투	3844	2908	936	17	2891	1225	1657	1	2	5	1
서울특별시	관악구	보라매동	보라매동제3투	4651	3489	1162	16	3473	1540	1926	2	2	2	1
서울특별시	관악구	보라매동	보라매동제4투	4738	3372	1366	14	3358	1316	2036	1	1	2	2
서울특별시	관악구	보라매동	보라매동제5투	4669	3441	1228	14	3427	1353	2064	1	1	8	0
서울특별시	관악구	은천동	소계	29129	22304	6825	78	22226	9067	13057	19	12	48	23
서울특별시	관악구	은천동	은천동제1투	4260	3264	996	12	3252	1288	1953	2	4	2	3
서울특별시	관악구	은천동	은천동제2투	4338	3279	1059	10	3269	1366	1892	2	2	6	1
서울특별시	관악구	은천동	은천동제3투	4359	3439	920	13	3426	1423	1986	3	2	8	4
서울특별시	관악구	은천동	은천동제4투	4011	3377	634	9	3368	1312	2039	1	1	11	4
서울특별시	관악구	은천동	은천동제5투	3828	2999	829	10	2989	1276	1699	3	1	6	4
서울특별시	관악구	은천동	은천동제6투	3920	2911	1009	10	2901	1215	1667	6	1	9	3
서울특별시	관악구	은천동	은천동제7투	4413	3035	1378	14	3021	1187	1821	2	1	6	4
서울특별시	관악구	성현동	소계	26996	21323	5673	97	21226	9094	12032	17	15	45	23
서울특별시	관악구	성현동	성현동제1투	3657	2785	872	15	2770	1112	1641	2	4	5	6
서울특별시	관악구	성현동	성현동제2투	4364	3404	960	14	3390	1388	1983	6	1	7	5
서울특별시	관악구	성현동	성현동제3투	3108	2655	453	8	2647	1159	1477	1	2	6	2
서울특별시	관악구	성현동	성현동제4투	3960	3395	565	12	3383	1561	1806	1	1	11	3
서울특별시	관악구	성현동	성현동제5투	4030	3386	644	7	3379	1435	1930	2	3	8	1
서울특별시	관악구	성현동	성현동제6투	3778	2643	1135	20	2623	1091	1522	1	3	4	2
서울특별시	관악구	성현동	성현동제7투	4099	3055	1044	21	3034	1348	1673	4	1	4	4
서울특별시	관악구	중앙동	소계	12695	9191	3504	47	9144	3345	5764	10	5	15	5
서울특별시	관악구	중앙동	중앙동제1투	4118	2973	1145	14	2959	1082	1863	2	3	7	2
서울특별시	관악구	중앙동	중앙동제2투	3845	2950	895	17	2933	1128	1792	6	1	5	1
서울특별시	관악구	중앙동	중앙동제3투	4732	3268	1464	16	3252	1135	2109	2	1	3	2
서울특별시	관악구	청림동	소계	13268	10671	2597	46	10625	4356	6229	7	5	22	6
서울특별시	관악구	청림동	청림동제1투	4499	3665	834	10	3655	1709	1927	1	1	17	0
서울특별시	관악구	청림동	청림동제2투	4297	3156	1141	27	3129	1287	1829	5	2	1	5
서울특별시	관악구	청림동	청림동제3투	4472	3850	622	9	3841	1360	2473	1	2	4	1
서울특별시	관악구	행운동	소계	25679	19101	6578	87	19014	7126	11801	12	19	42	14
서울특별시	관악구	행운동	행운동제1투	4161	3158	1003	12	3146	1112	2023	0	5	5	1
서울특별시	관악구	행운동	행운동제2투	4902	3626	1276	15	3611	1226	2364	5	4	9	3
서울특별시	관악구	행운동	행운동제3투	3848	2857	991	12	2845	980	1854	2	3	3	3
서울특별시	관악구	행운동	행운동제4투	4319	2983	1336	18	2965	1137	1814	2	1	8	3
서울특별시	관악구	행운동	행운동제5투	3857	2858	999	7	2851	1081	1751	2	3	10	4
서울특별시	관악구	행운동	행운동제6투	4592	3619	973	23	3596	1590	1995	1	3	7	0
서울특별시	관악구	청룡동	소계	28416	20819	7597	109	20710	7594	13040	11	16	32	17
서울특별시	관악구	청룡동	청룡동제1투	4908	3563	1345	19	3544	1412	2121	3	2	3	3
서울특별시	관악구	청룡동	청룡동제2투	4797	3533	1264	16	3517	1327	2182	1	2	2	3
서울특별시	관악구	청룡동	청룡동제3투	5594	4045	1549	26	4019	1185	2817	0	6	6	5
서울특별시	관악구	청룡동	청룡동제4투	4346	2826	1520	14	2812	1134	1667	1	4	5	1
서울특별시	관악구	청룡동	청룡동제5투	4597	3602	995	18	3584	1319	2246	5	1	10	3
서울특별시	관악구	청룡동	청룡동제6투	4174	3250	924	16	3234	1217	2007	1	1	6	2
서울특별시	관악구	낙성대동	소계	15143	11256	3887	48	11208	3855	7309	3	12	20	9
서울특별시	관악구	낙성대동	낙성대동제1투	5270	3794	1476	18	3776	1306	2457	0	4	4	5
서울특별시	관악구	낙성대동	낙성대동제2투	5168	3799	1369	20	3779	1370	2393	2	3	9	2
서울특별시	관악구	낙성대동	낙성대동제3투	4705	3663	1042	10	3653	1179	2459	1	5	7	2
서울특별시	관악구	인헌동	소계	23329	17466	5863	76	17390	6663	10657	7	17	28	18
서울특별시	관악구	인헌동	인헌동제1투	4640	3475	1165	14	3461	1246	2204	0	1	4	6
서울특별시	관악구	인헌동	인헌동제2투	5168	3798	1370	17	3781	1363	2402	2	4	6	4
서울특별시	관악구	인헌동	인헌동제3투	4581	3453	1128	15	3438	1384	2045	0	3	4	2
서울특별시	관악구	인헌동	인헌동제4투	4336	3232	1104	12	3220	1299	1902	3	5	8	3
서울특별시	관악구	인헌동	인헌동제5투	4604	3508	1096	18	3490	1371	2104	2	4	6	3
서울특별시	관악구	남현동	소계	15112	11645	3467	45	11600	5239	6323	3	4	19	12
서울특별시	관악구	남현동	남현동제1투	3675	2821	854	11	2810	1171	1624	1	0	9	5
서울특별시	관악구	남현동	남현동제2투	3766	3003	763	11	2992	1374	1612	1	1	3	1
서울특별시	관악구	남현동	남현동제3투	3751	2727	1024	14	2713	1151	1553	0	2	5	2
서울특별시	관악구	남현동	남현동제4투	3920	3094	826	9	3085	1543	1534	1	1	2	4
서울특별시	관악구	신림동	소계	17471	11891	5580	41	11850	3986	7831	4	8	15	6
서울특별시	관악구	신림동	신림동제1투	4851	3243	1608	11	3232	1013	2208	1	2	6	2
서울특별시	관악구	신림동	신림동제2투	4426	2877	1549	8	2869	884	1974	1	3	6	1
서울특별시	관악구	신림동	신림동제3투	4080	2736	1344	13	2723	920	1800	0	1	2	0
서울특별시	관악구	신림동	신림동제4투	4114	3035	1079	9	3026	1169	1849	2	2	1	3
서울특별시	관악구	신사동	소계	20924	14787	6137	73	14714	5921	8744	3	11	27	8
서울특별시	관악구	신사동	신사동제1투	3695	2720	975	10	2710	1153	1545	3	2	7	0
서울특별시	관악구	신사동	신사동제2투	4569	3271	1298	16	3255	1248	1995	0	4	7	1
서울특별시	관악구	신사동	신사동제3투	4058	2935	1123	17	2918	1159	1751	0	1	5	2
서울특별시	관악구	신사동	신사동제4투	4100	2661	1439	12	2649	1069	1573	0	3	3	1
서울특별시	관악구	신사동	신사동제5투	4502	3200	1302	18	3182	1292	1880	0	1	5	4
서울특별시	관악구	조원동	소계	15520	11176	4344	53	11123	4783	6308	3	3	17	9
서울특별시	관악구	조원동	조원동제1투	4288	3068	1220	12	3056	1314	1732	2	0	5	3
서울특별시	관악구	조원동	조원동제2투	4460	3111	1349	18	3093	1371	1711	0	2	5	4
서울특별시	관악구	조원동	조원동제3투	3651	2623	1028	9	2614	1086	1521	1	1	4	1
서울특별시	관악구	조원동	조원동제4투	3121	2374	747	14	2360	1012	1344	0	0	3	1
서울특별시	관악구	미성동	소계	27736	20978	6758	99	20879	9603	11204	14	12	32	14
서울특별시	관악구	미성동	미성동제1투	4213	2962	1251	12	2950	1215	1722	1	2	9	1
서울특별시	관악구	미성동	미성동제2투	3852	2887	965	14	2873	1320	1540	3	2	5	3
서울특별시	관악구	미성동	미성동제3투	4015	3426	589	12	3414	1857	1544	5	2	5	1
서울특별시	관악구	미성동	미성동제4투	3895	2827	1068	15	2812	1260	1544	2	1	3	2
서울특별시	관악구	미성동	미성동제5투	4035	3032	1003	22	3010	1373	1630	1	3	2	1
서울특별시	관악구	미성동	미성동제6투	3906	2845	1061	15	2830	1294	1527	1	1	3	4
서울특별시	관악구	미성동	미성동제7투	3820	2999	821	9	2990	1284	1697	1	1	5	2
서울특별시	관악구	난곡동	소계	25023	17856	7167	90	17766	8082	9622	15	9	19	19
서울특별시	관악구	난곡동	난곡동제1투	4650	3130	1520	17	3113	1368	1739	1	1	1	3
서울특별시	관악구	난곡동	난곡동제2투	4496	3255	1241	18	3237	1483	1748	0	1	3	2
서울특별시	관악구	난곡동	난곡동제3투	4420	3325	1095	22	3303	1467	1822	4	3	2	5
서울특별시	관악구	난곡동	난곡동제4투	3598	2502	1096	9	2493	1124	1353	5	1	6	4
서울특별시	관악구	난곡동	난곡동제5투	3629	2703	926	14	2689	1293	1387	2	1	4	2
서울특별시	관악구	난곡동	난곡동제6투	4230	2941	1289	10	2931	1347	1573	3	2	3	3
서울특별시	관악구	난향동	소계	13780	10343	3437	48	10295	4380	5866	5	11	23	10
서울특별시	관악구	난향동	난향동제1투	4483	3293	1190	11	3282	1347	1919	1	5	6	4
서울특별시	관악구	난향동	난향동제2투	4708	3749	959	14	3735	1599	2115	1	4	11	5
서울특별시	관악구	난향동	난향동제3투	4589	3301	1288	23	3278	1434	1832	3	2	6	1
서울특별시	관악구	서원동	소계	20579	15037	5542	62	14975	5548	9358	11	11	33	14
서울특별시	관악구	서원동	서원동제1투	4331	3194	1137	16	3178	1135	2028	2	2	7	4
서울특별시	관악구	서원동	서원동제2투	3885	2893	992	10	2883	1122	1750	1	1	7	2
서울특별시	관악구	서원동	서원동제3투	4285	2923	1362	11	2912	1004	1897	0	4	3	4
서울특별시	관악구	서원동	서원동제4투	3627	2717	910	16	2701	1054	1633	3	2	6	3
서울특별시	관악구	서원동	서원동제5투	4451	3310	1141	9	3301	1233	2050	5	2	10	1
서울특별시	관악구	신원동	소계	16656	11933	4723	56	11877	4918	6912	4	9	21	13
서울특별시	관악구	신원동	신원동제1투	4668	3146	1522	19	3127	1361	1753	0	2	5	6
서울특별시	관악구	신원동	신원동제2투	3917	2961	956	13	2948	1218	1720	1	1	5	3
서울특별시	관악구	신원동	신원동제3투	3699	2692	1007	14	2678	1075	1591	2	1	7	2
서울특별시	관악구	신원동	신원동제4투	4372	3134	1238	10	3124	1264	1848	1	5	4	2
서울특별시	관악구	서림동	소계	21294	15913	5381	65	15848	6035	9722	16	22	31	22
서울특별시	관악구	서림동	서림동제1투	4362	2995	1367	10	2985	1176	1795	5	2	4	3
서울특별시	관악구	서림동	서림동제2투	3808	3154	654	8	3146	1471	1653	5	3	8	6
서울특별시	관악구	서림동	서림동제3투	4006	3015	991	15	3000	1069	1917	1	6	4	3
서울특별시	관악구	서림동	서림동제4투	4850	3587	1263	11	3576	1164	2384	2	8	13	5
서울특별시	관악구	서림동	서림동제5투	4268	3162	1106	21	3141	1155	1973	3	3	2	5
서울특별시	관악구	삼성동	소계	24360	18349	6011	95	18254	8013	10144	17	21	43	16
서울특별시	관악구	삼성동	삼성동제1투	4156	2734	1422	14	2720	1246	1456	3	3	8	4
서울특별시	관악구	삼성동	삼성동제2투	4323	3213	1110	15	3198	1356	1825	4	5	4	4
서울특별시	관악구	삼성동	삼성동제3투	4424	3470	954	24	3446	1475	1954	4	4	8	1
서울특별시	관악구	삼성동	삼성동제4투	3654	2743	911	12	2731	1288	1435	2	1	4	1
서울특별시	관악구	삼성동	삼성동제5투	3889	2919	970	15	2904	1181	1708	2	4	6	3
서울특별시	관악구	삼성동	삼성동제6투	3914	3270	644	15	3255	1467	1766	2	4	13	3
서울특별시	관악구	대학동	소계	20474	15184	5290	62	15122	5414	9618	7	21	47	15
서울특별시	관악구	대학동	대학동제1투	5552	3849	1703	24	3825	1297	2502	2	9	10	5
서울특별시	관악구	대학동	대학동제2투	4449	3569	880	11	3558	1407	2127	3	3	15	3
서울특별시	관악구	대학동	대학동제3투	5554	4080	1474	10	4070	1450	2592	0	6	17	5
서울특별시	관악구	대학동	대학동제4투	4919	3686	1233	17	3669	1260	2397	2	3	5	2
서울특별시	관악구	잘못 투입·구분된 투표지	잘못 투입·구분된 투표지	0	5	-5	1	4	1	3	0	0	0	0
서울특별시	서초구	계	계	352640	270848	81792	1063	269785	158112	110649	68	129	680	147
서울특별시	서초구	재외투표	재외투표	6009	4472	1537	13	4459	2249	2195	1	4	8	2
서울특별시	서초구	국내부재자투표	국내부재자투표	6920	6466	454	86	6380	3663	2672	7	7	17	14
서울특별시	서초구	서초1동	소계	17366	13223	4143	47	13176	7765	5366	6	7	25	7
서울특별시	서초구	서초1동	서초1동제1투	5052	3848	1204	22	3826	2334	1478	1	3	7	3
서울특별시	서초구	서초1동	서초1동제2투	4514	3512	1002	10	3502	2033	1456	1	2	7	3
서울특별시	서초구	서초1동	서초1동제3투	4127	3123	1004	10	3113	1926	1178	1	1	7	0
서울특별시	서초구	서초1동	서초1동제4투	3673	2740	933	5	2735	1472	1254	3	1	4	1
서울특별시	서초구	서초2동	소계	18189	14048	4141	56	13992	8677	5257	5	5	39	9
서울특별시	서초구	서초2동	서초2동제1투	3613	2719	894	12	2707	1724	963	1	1	14	4
서울특별시	서초구	서초2동	서초2동제2투	3546	2855	691	14	2841	1699	1131	2	1	7	1
서울특별시	서초구	서초2동	서초2동제3투	4252	3279	973	15	3264	1907	1350	2	0	4	1
서울특별시	서초구	서초2동	서초2동제4투	4070	3026	1044	5	3021	1926	1083	0	2	7	3
서울특별시	서초구	서초2동	서초2동제5투	2708	2169	539	10	2159	1421	730	0	1	7	0
서울특별시	서초구	서초3동	소계	25011	19093	5918	58	19035	11471	7479	8	13	54	10
서울특별시	서초구	서초3동	서초3동제1투	3833	2862	971	9	2853	2013	826	0	3	10	1
서울특별시	서초구	서초3동	서초3동제2투	3683	2865	818	3	2862	1632	1215	2	1	9	3
서울특별시	서초구	서초3동	서초3동제3투	3679	2887	792	14	2873	1750	1112	2	3	4	2
서울특별시	서초구	서초3동	서초3동제4투	3337	2562	775	3	2559	1425	1123	2	2	6	1
서울특별시	서초구	서초3동	서초3동제5투	3519	2598	921	8	2590	1461	1122	0	3	4	0
서울특별시	서초구	서초3동	서초3동제6투	3923	2858	1065	12	2846	1583	1248	1	1	10	3
서울특별시	서초구	서초3동	서초3동제7투	3037	2461	576	9	2452	1607	833	1	0	11	0
서울특별시	서초구	서초4동	소계	22865	17828	5037	67	17761	12018	5680	1	5	48	9
서울특별시	서초구	서초4동	서초4동제1투	4986	3363	1623	18	3345	2166	1164	0	1	11	3
서울특별시	서초구	서초4동	서초4동제2투	3970	3230	740	9	3221	2160	1048	0	0	10	3
서울특별시	서초구	서초4동	서초4동제3투	3735	2929	806	8	2921	2022	889	0	1	8	1
서울특별시	서초구	서초4동	서초4동제4투	3302	2744	558	9	2735	1969	753	0	2	10	1
서울특별시	서초구	서초4동	서초4동제5투	3737	2973	764	14	2959	1971	983	1	0	4	0
서울특별시	서초구	서초4동	서초4동제6투	3135	2589	546	9	2580	1730	843	0	1	5	1
서울특별시	서초구	잠원동	소계	28194	21265	6929	74	21191	12974	8145	2	10	55	5
서울특별시	서초구	잠원동	잠원동제1투	4028	2657	1371	5	2652	1619	1024	0	1	7	1
서울특별시	서초구	잠원동	잠원동제2투	3608	2699	909	7	2692	1794	889	0	1	7	1
서울특별시	서초구	잠원동	잠원동제3투	3250	2620	630	7	2613	1482	1124	0	2	5	0
서울특별시	서초구	잠원동	잠원동제4투	3221	2533	688	11	2522	1603	910	0	0	8	1
서울특별시	서초구	잠원동	잠원동제5투	3680	2587	1093	14	2573	1332	1238	0	0	1	2
서울특별시	서초구	잠원동	잠원동제6투	3453	2725	728	9	2716	1731	973	0	2	10	0
서울특별시	서초구	잠원동	잠원동제7투	3643	2804	839	6	2798	1752	1039	0	2	5	0
서울특별시	서초구	잠원동	잠원동제8투	3311	2640	671	15	2625	1661	948	2	2	12	0
서울특별시	서초구	반포본동	소계	9700	7714	1986	39	7675	5041	2612	2	1	15	4
서울특별시	서초구	반포본동	반포본동제1투	2869	2000	869	12	1988	1102	879	2	0	3	2
서울특별시	서초구	반포본동	반포본동제2투	2314	1937	377	8	1929	1408	516	0	0	4	1
서울특별시	서초구	반포본동	반포본동제3투	2682	2251	431	10	2241	1579	654	0	1	7	0
서울특별시	서초구	반포본동	반포본동제4투	1835	1526	309	9	1517	952	563	0	0	1	1
서울특별시	서초구	반포1동	소계	26701	18814	7887	46	18768	11047	7665	2	10	41	3
서울특별시	서초구	반포1동	반포1동제1투	2970	2422	548	5	2417	1566	847	0	0	4	0
서울특별시	서초구	반포1동	반포1동제2투	3742	3056	686	7	3049	1989	1045	1	3	10	1
서울특별시	서초구	반포1동	반포1동제3투	3655	2225	1430	7	2218	1093	1119	0	2	3	1
서울특별시	서초구	반포1동	반포1동제4투	3827	2213	1614	7	2206	981	1222	0	0	3	0
서울특별시	서초구	반포1동	반포1동제5투	3610	2173	1437	5	2168	984	1179	0	2	3	0
서울특별시	서초구	반포1동	반포1동제6투	4405	3144	1261	4	3140	2286	847	0	0	6	1
서울특별시	서초구	반포1동	반포1동제7투	4492	3581	911	11	3570	2148	1406	1	3	12	0
서울특별시	서초구	반포2동	소계	16518	13281	3237	45	13236	8940	4230	1	9	48	8
서울특별시	서초구	반포2동	반포2동제1투	3432	2564	868	12	2552	1704	837	0	2	8	1
서울특별시	서초구	반포2동	반포2동제2투	3094	2559	535	7	2552	1787	748	0	1	14	2
서울특별시	서초구	반포2동	반포2동제3투	3104	2475	629	9	2466	1546	904	1	2	10	3
서울특별시	서초구	반포2동	반포2동제4투	3634	2961	673	5	2956	1883	1060	0	2	10	1
서울특별시	서초구	반포2동	반포2동제5투	3254	2722	532	12	2710	2020	681	0	2	6	1
서울특별시	서초구	반포3동	소계	17971	14097	3874	51	14046	8935	5050	2	4	45	10
서울특별시	서초구	반포3동	반포3동제1투	4384	3204	1180	7	3197	2078	1109	0	0	6	4
서울특별시	서초구	반포3동	반포3동제2투	3660	2935	725	14	2921	1797	1111	0	2	11	0
서울특별시	서초구	반포3동	반포3동제3투	3202	2577	625	12	2565	1643	913	0	0	8	1
서울특별시	서초구	반포3동	반포3동제4투	3094	2478	616	10	2468	1652	806	1	1	7	1
서울특별시	서초구	반포3동	반포3동제5투	3631	2903	728	8	2895	1765	1111	1	1	13	4
서울특별시	서초구	반포4동	소계	15669	12245	3424	54	12191	7354	4784	2	5	36	10
서울특별시	서초구	반포4동	반포4동제1투	3392	2548	844	14	2534	1506	1011	0	3	12	2
서울특별시	서초구	반포4동	반포4동제2투	3690	2841	849	12	2829	1817	1002	2	0	5	3
서울특별시	서초구	반포4동	반포4동제3투	3238	2707	531	11	2696	1592	1097	0	2	3	2
서울특별시	서초구	반포4동	반포4동제4투	2259	1854	405	6	1848	1060	783	0	0	4	1
서울특별시	서초구	반포4동	반포4동제5투	3090	2295	795	11	2284	1379	891	0	0	12	2
서울특별시	서초구	방배본동	소계	16753	12962	3791	50	12912	7585	5284	7	2	28	6
서울특별시	서초구	방배본동	방배본동제1투	4278	3232	1046	12	3220	1915	1293	3	0	7	2
서울특별시	서초구	방배본동	방배본동제2투	3902	3089	813	16	3073	2150	912	0	0	10	1
서울특별시	서초구	방배본동	방배본동제3투	4559	3518	1041	10	3508	1992	1506	1	0	7	2
서울특별시	서초구	방배본동	방배본동제4투	4014	3123	891	12	3111	1528	1573	3	2	4	1
서울특별시	서초구	방배1동	소계	13912	10674	3238	35	10639	5879	4718	3	5	29	5
서울특별시	서초구	방배1동	방배1동제1투	3787	2739	1048	9	2730	1358	1361	0	3	7	1
서울특별시	서초구	방배1동	방배1동제2투	3913	3039	874	12	3027	1542	1474	1	2	7	1
서울특별시	서초구	방배1동	방배1동제3투	2797	2112	685	7	2105	1153	950	0	0	1	1
서울특별시	서초구	방배1동	방배1동제4투	3415	2784	631	7	2777	1826	933	2	0	14	2
서울특별시	서초구	방배2동	소계	22310	17176	5134	77	17099	8537	8500	4	8	39	11
서울특별시	서초구	방배2동	방배2동제1투	3897	2750	1147	11	2739	1335	1389	3	2	9	1
서울특별시	서초구	방배2동	방배2동제2투	3518	2729	789	12	2717	1291	1415	0	1	8	2
서울특별시	서초구	방배2동	방배2동제3투	3185	2475	710	9	2466	1254	1203	0	3	5	1
서울특별시	서초구	방배2동	방배2동제4투	3228	2416	812	17	2399	1221	1171	0	0	6	1
서울특별시	서초구	방배2동	방배2동제5투	1602	1262	340	7	1255	650	601	0	1	2	1
서울특별시	서초구	방배2동	방배2동제6투	2983	2316	667	10	2306	1010	1290	0	1	3	2
서울특별시	서초구	방배2동	방배2동제7투	2434	2052	382	4	2048	1166	874	0	0	5	3
서울특별시	서초구	방배2동	방배2동제8투	1463	1176	287	7	1169	610	557	1	0	1	0
서울특별시	서초구	방배3동	소계	20774	16077	4697	63	16014	9274	6677	6	6	46	5
서울특별시	서초구	방배3동	방배3동제1투	4270	3205	1065	12	3193	2109	1064	2	3	15	0
서울특별시	서초구	방배3동	방배3동제2투	3486	2824	662	12	2812	1721	1078	1	0	11	1
서울특별시	서초구	방배3동	방배3동제3투	3163	2550	613	10	2540	1592	943	0	0	5	0
서울특별시	서초구	방배3동	방배3동제4투	2999	2302	697	11	2291	1089	1193	0	3	5	1
서울특별시	서초구	방배3동	방배3동제5투	4059	3037	1022	15	3022	1671	1343	1	0	6	1
서울특별시	서초구	방배3동	방배3동제6투	2797	2159	638	3	2156	1092	1056	2	0	4	2
서울특별시	서초구	방배4동	소계	20059	15580	4479	52	15528	8541	6930	3	9	39	6
서울특별시	서초구	방배4동	방배4동제1투	3574	2633	941	12	2621	1352	1263	0	1	5	0
서울특별시	서초구	방배4동	방배4동제2투	5168	4059	1109	9	4050	2724	1309	0	1	15	1
서울특별시	서초구	방배4동	방배4동제3투	3341	2512	829	9	2503	1194	1303	1	3	2	0
서울특별시	서초구	방배4동	방배4동제4투	3317	2629	688	7	2622	1238	1367	2	3	8	4
서울특별시	서초구	방배4동	방배4동제5투	4659	3747	912	15	3732	2033	1688	0	1	9	1
서울특별시	서초구	양재1동	소계	24224	18619	5605	68	18551	9632	8859	3	11	36	10
서울특별시	서초구	양재1동	양재1동제1투	3049	2295	754	5	2290	1086	1194	0	4	6	0
서울특별시	서초구	양재1동	양재1동제2투	3790	2923	867	10	2913	1422	1483	1	1	4	2
서울특별시	서초구	양재1동	양재1동제3투	2978	2191	787	4	2187	1217	965	0	0	4	1
서울특별시	서초구	양재1동	양재1동제4투	3004	2432	572	5	2427	1321	1101	0	0	4	1
서울특별시	서초구	양재1동	양재1동제5투	2390	1843	547	7	1836	1037	794	0	1	3	1
서울특별시	서초구	양재1동	양재1동제6투	2549	1880	669	18	1862	980	875	2	1	1	3
서울특별시	서초구	양재1동	양재1동제7투	3252	2448	804	11	2437	1495	930	0	2	9	1
서울특별시	서초구	양재1동	양재1동제8투	3212	2607	605	8	2599	1074	1517	0	2	5	1
서울특별시	서초구	양재2동	소계	18667	13689	4978	58	13631	6341	7251	2	5	22	10
서울특별시	서초구	양재2동	양재2동제1투	3104	2134	970	10	2124	1104	1018	1	0	0	1
서울특별시	서초구	양재2동	양재2동제2투	3485	2626	859	20	2606	1202	1394	0	1	7	2
서울특별시	서초구	양재2동	양재2동제3투	4508	3371	1137	11	3360	1541	1808	0	1	8	2
서울특별시	서초구	양재2동	양재2동제4투	3899	2940	959	6	2934	1322	1603	1	2	3	3
서울특별시	서초구	양재2동	양재2동제5투	3671	2618	1053	11	2607	1172	1428	0	1	4	2
서울특별시	서초구	내곡동	소계	4828	3525	1303	24	3501	2189	1295	1	3	10	3
서울특별시	서초구	내곡동	내곡동제1투	1946	1392	554	10	1382	867	507	0	2	4	2
서울특별시	서초구	내곡동	내곡동제2투	1285	947	338	10	937	612	321	0	1	2	1
서울특별시	서초구	내곡동	내곡동제3투	1597	1186	411	4	1182	710	467	1	0	4	0
서울특별시	서초구	잘못 투입·구분된 투표지	잘못 투입·구분된 투표지	0	0	0	0	0	0	0	0	0	0	0
서울특별시	강남구	계	계	461592	343220	118372	1461	341759	205563	134880	111	142	829	234
서울특별시	강남구	재외투표	재외투표	7254	5367	1887	25	5342	2859	2463	1	4	11	4
서울특별시	강남구	국내부재자투표	국내부재자투표	9874	9138	736	138	9000	5383	3570	6	8	20	13
서울특별시	강남구	신사동	소계	16206	11965	4241	46	11919	7929	3962	1	4	20	3
서울특별시	강남구	신사동	신사동제1투	3576	2439	1137	2	2437	1549	884	0	1	3	0
서울특별시	강남구	신사동	신사동제2투	2870	2003	867	8	1995	994	999	0	0	2	0
서울특별시	강남구	신사동	신사동제3투	3084	2224	860	11	2213	1084	1121	1	0	5	2
서울특별시	강남구	신사동	신사동제4투	3569	2837	732	13	2824	2368	448	0	3	5	0
서울특별시	강남구	신사동	신사동제5투	3107	2462	645	12	2450	1934	510	0	0	5	1
서울특별시	강남구	논현1동	소계	23151	14281	8870	57	14224	7279	6893	4	6	34	8
서울특별시	강남구	논현1동	논현1동제1투	4907	2667	2240	7	2660	1246	1407	1	1	3	2
서울특별시	강남구	논현1동	논현1동제2투	4309	2762	1547	13	2749	1546	1192	0	1	9	1
서울특별시	강남구	논현1동	논현1동제3투	5078	3421	1657	14	3407	1908	1484	0	3	10	2
서울특별시	강남구	논현1동	논현1동제4투	4749	2835	1914	12	2823	1359	1456	1	1	5	1
서울특별시	강남구	논현1동	논현1동제5투	4108	2596	1512	11	2585	1220	1354	2	0	7	2
서울특별시	강남구	논현2동	소계	18998	12914	6084	48	12866	7482	5348	5	4	24	3
서울특별시	강남구	논현2동	논현2동제1투	4826	3048	1778	13	3035	1884	1143	1	0	6	1
서울특별시	강남구	논현2동	논현2동제2투	3505	2613	892	2	2611	1575	1026	3	0	7	0
서울특별시	강남구	논현2동	논현2동제3투	2683	1830	853	5	1825	976	846	0	1	2	0
서울특별시	강남구	논현2동	논현2동제4투	4015	2848	1167	21	2827	1721	1099	0	1	5	1
서울특별시	강남구	논현2동	논현2동제5투	3969	2575	1394	7	2568	1326	1234	1	2	4	1
서울특별시	강남구	압구정동	소계	23096	17292	5804	68	17224	13185	3983	4	8	42	2
서울특별시	강남구	압구정동	압구정동제1투	4127	2947	1180	11	2936	2464	467	0	0	5	0
서울특별시	강남구	압구정동	압구정동제2투	2820	2196	624	8	2188	1702	482	0	0	4	0
서울특별시	강남구	압구정동	압구정동제3투	3440	2749	691	11	2738	2244	479	1	1	13	0
서울특별시	강남구	압구정동	압구정동제4투	3133	2257	876	11	2246	1457	784	1	0	3	1
서울특별시	강남구	압구정동	압구정동제5투	3999	3065	934	10	3055	2321	722	0	2	10	0
서울특별시	강남구	압구정동	압구정동제6투	3736	2829	907	13	2816	2148	657	1	3	6	1
서울특별시	강남구	압구정동	압구정동제7투	1841	1249	592	4	1245	849	392	1	2	1	0
서울특별시	강남구	청담동	소계	25128	18283	6845	55	18228	12091	6088	8	6	26	9
서울특별시	강남구	청담동	청담동제1투	4649	3054	1595	13	3041	2020	1017	1	0	3	0
서울특별시	강남구	청담동	청담동제2투	3398	2515	883	8	2507	1824	678	0	1	3	1
서울특별시	강남구	청담동	청담동제3투	3141	2368	773	7	2361	1674	683	1	0	3	0
서울특별시	강남구	청담동	청담동제4투	3818	3011	807	5	3006	2133	860	0	3	6	4
서울특별시	강남구	청담동	청담동제5투	3718	2779	939	8	2771	1660	1103	2	0	4	2
서울특별시	강남구	청담동	청담동제6투	3937	2893	1044	6	2887	1707	1169	3	1	5	2
서울특별시	강남구	청담동	청담동제7투	2467	1663	804	8	1655	1073	578	1	1	2	0
서울특별시	강남구	삼성1동	소계	12354	9268	3086	22	9246	6060	3155	2	0	21	8
서울특별시	강남구	삼성1동	삼성1동제1투	3885	2813	1072	10	2803	1796	998	1	0	6	2
서울특별시	강남구	삼성1동	삼성1동제2투	4272	3311	961	4	3307	2323	974	0	0	5	5
서울특별시	강남구	삼성1동	삼성1동제3투	4197	3144	1053	8	3136	1941	1183	1	0	10	1
서울특별시	강남구	삼성2동	소계	25222	18239	6983	55	18184	10918	7206	4	12	34	10
서울특별시	강남구	삼성2동	삼성2동제1투	5139	3174	1965	13	3161	1617	1535	1	1	5	2
서울특별시	강남구	삼성2동	삼성2동제2투	5183	4176	1007	21	4155	2680	1459	1	2	8	5
서울특별시	강남구	삼성2동	삼성2동제3투	5737	4154	1583	8	4146	2496	1638	1	2	8	1
서울특별시	강남구	삼성2동	삼성2동제4투	3969	2696	1273	6	2690	1468	1214	1	2	3	2
서울특별시	강남구	삼성2동	삼성2동제5투	5194	4039	1155	7	4032	2657	1360	0	5	10	0
서울특별시	강남구	대치1동	소계	14029	11413	2616	42	11371	8285	3031	1	3	43	8
서울특별시	강남구	대치1동	대치1동제1투	2228	1835	393	3	1832	1283	541	0	1	6	1
서울특별시	강남구	대치1동	대치1동제2투	3546	2874	672	6	2868	1869	980	0	1	16	2
서울특별시	강남구	대치1동	대치1동제3투	2720	2299	421	13	2286	1743	531	0	1	10	1
서울특별시	강남구	대치1동	대치1동제4투	2950	2453	497	15	2438	1866	560	1	0	7	4
서울특별시	강남구	대치1동	대치1동제5투	2585	1952	633	5	1947	1524	419	0	0	4	0
서울특별시	강남구	대치2동	소계	32001	25538	6463	73	25465	16695	8650	4	8	89	19
서울특별시	강남구	대치2동	대치2동제1투	4808	3906	902	8	3898	2468	1411	1	2	13	3
서울특별시	강남구	대치2동	대치2동제2투	3683	3013	670	4	3009	1890	1100	0	3	15	1
서울특별시	강남구	대치2동	대치2동제3투	3975	3233	742	8	3225	2024	1190	0	0	9	2
서울특별시	강남구	대치2동	대치2동제4투	3335	2787	548	11	2776	2145	622	0	1	6	2
서울특별시	강남구	대치2동	대치2동제5투	3333	2811	522	7	2804	2140	648	0	1	14	1
서울특별시	강남구	대치2동	대치2동제6투	4144	3488	656	10	3478	2522	943	0	0	11	2
서울특별시	강남구	대치2동	대치2동제7투	4979	3575	1404	14	3561	2112	1431	2	0	14	2
서울특별시	강남구	대치2동	대치2동제8투	3744	2725	1019	11	2714	1394	1305	1	1	7	6
서울특별시	강남구	대치4동	소계	17729	11902	5827	45	11857	6152	5650	3	7	35	10
서울특별시	강남구	대치4동	대치4동제1투	4707	3126	1581	13	3113	1535	1562	1	2	10	3
서울특별시	강남구	대치4동	대치4동제2투	4814	3506	1308	16	3490	1776	1693	2	3	13	3
서울특별시	강남구	대치4동	대치4동제3투	3877	2564	1313	9	2555	1470	1076	0	1	6	2
서울특별시	강남구	대치4동	대치4동제4투	4331	2706	1625	7	2699	1371	1319	0	1	6	2
서울특별시	강남구	역삼1동	소계	30930	18818	12112	68	18750	9360	9328	4	10	40	8
서울특별시	강남구	역삼1동	역삼1동제1투	4112	2300	1812	13	2287	1152	1124	1	2	6	2
서울특별시	강남구	역삼1동	역삼1동제2투	3838	2403	1435	8	2395	1155	1234	0	2	4	0
서울특별시	강남구	역삼1동	역삼1동제3투	4047	2471	1576	2	2469	1210	1252	1	1	2	3
서울특별시	강남구	역삼1동	역삼1동제4투	4460	2656	1804	17	2639	1320	1314	0	2	3	0
서울특별시	강남구	역삼1동	역삼1동제5투	5262	2792	2470	8	2784	1366	1402	0	2	13	1
서울특별시	강남구	역삼1동	역삼1동제6투	4352	2902	1450	11	2891	1449	1434	2	1	5	0
서울특별시	강남구	역삼1동	역삼1동제7투	4859	3294	1565	9	3285	1708	1568	0	0	7	2
서울특별시	강남구	역삼2동	소계	26502	19160	7342	70	19090	11331	7693	3	4	49	10
서울특별시	강남구	역삼2동	역삼2동제1투	5143	3639	1504	20	3619	2250	1355	0	1	10	3
서울특별시	강남구	역삼2동	역삼2동제2투	3542	2684	858	5	2679	1778	891	0	0	10	0
서울특별시	강남구	역삼2동	역삼2동제3투	4602	2936	1666	12	2924	1536	1374	0	0	12	2
서울특별시	강남구	역삼2동	역삼2동제4투	4541	3133	1408	12	3121	1544	1572	2	0	2	1
서울특별시	강남구	역삼2동	역삼2동제5투	4194	3194	1000	12	3182	1820	1354	1	3	3	1
서울특별시	강남구	역삼2동	역삼2동제6투	4480	3574	906	9	3565	2403	1147	0	0	12	3
서울특별시	강남구	도곡1동	소계	17824	14178	3646	51	14127	8695	5384	4	5	33	6
서울특별시	강남구	도곡1동	도곡1동제1투	4352	3417	935	12	3405	2256	1135	1	1	10	2
서울특별시	강남구	도곡1동	도곡1동제2투	4045	3260	785	9	3251	2100	1141	0	1	7	2
서울특별시	강남구	도곡1동	도곡1동제3투	5008	4117	891	16	4101	2571	1515	1	3	10	1
서울특별시	강남구	도곡1동	도곡1동제4투	4419	3384	1035	14	3370	1768	1593	2	0	6	1
서울특별시	강남구	도곡2동	소계	25734	20484	5250	67	20417	15129	5202	6	9	56	15
서울특별시	강남구	도곡2동	도곡2동제1투	2832	2061	771	3	2058	1180	867	1	1	7	2
서울특별시	강남구	도곡2동	도곡2동제2투	3745	2988	757	8	2980	2119	841	1	4	13	2
서울특별시	강남구	도곡2동	도곡2동제3투	3134	2500	634	10	2490	2076	407	0	0	5	2
서울특별시	강남구	도곡2동	도곡2동제4투	4219	3341	878	12	3329	2871	446	3	0	8	1
서울특별시	강남구	도곡2동	도곡2동제5투	4283	3401	882	13	3388	2551	827	0	1	7	2
서울특별시	강남구	도곡2동	도곡2동제6투	4304	3569	735	11	3558	2586	960	0	1	9	2
서울특별시	강남구	도곡2동	도곡2동제7투	3217	2624	593	10	2614	1746	854	1	2	7	4
서울특별시	강남구	개포1동	소계	18490	14389	4101	78	14311	8630	5627	5	6	36	7
서울특별시	강남구	개포1동	개포1동제1투	3900	2946	954	5	2941	1784	1146	1	1	7	2
서울특별시	강남구	개포1동	개포1동제2투	4151	3447	704	19	3428	2509	906	1	2	10	0
서울특별시	강남구	개포1동	개포1동제3투	4339	3330	1009	13	3317	1873	1433	2	2	5	2
서울특별시	강남구	개포1동	개포1동제4투	4136	3181	955	19	3162	1705	1441	0	1	14	1
서울특별시	강남구	개포1동	개포1동제5투	1964	1485	479	22	1463	759	701	1	0	0	2
서울특별시	강남구	개포2동	소계	26212	20674	5538	74	20600	11078	9445	3	8	50	16
서울특별시	강남구	개포2동	개포2동제1투	4044	3132	912	9	3123	1629	1478	0	2	10	4
서울특별시	강남구	개포2동	개포2동제2투	4120	3061	1059	11	3050	1630	1406	1	1	9	3
서울특별시	강남구	개포2동	개포2동제3투	3016	2389	627	11	2378	1404	969	0	1	4	0
서울특별시	강남구	개포2동	개포2동제4투	2982	2327	655	9	2318	1454	857	0	1	6	0
서울특별시	강남구	개포2동	개포2동제5투	3650	2841	809	10	2831	1751	1063	2	1	10	4
서울특별시	강남구	개포2동	개포2동제6투	4254	3548	706	16	3532	2079	1445	0	2	5	1
서울특별시	강남구	개포2동	개포2동제7투	4146	3376	770	8	3368	1131	2227	0	0	6	4
서울특별시	강남구	개포4동	소계	18591	13573	5018	47	13526	7000	6477	5	11	22	11
서울특별시	강남구	개포4동	개포4동제1투	4882	3392	1490	14	3378	1598	1765	2	1	8	4
서울특별시	강남구	개포4동	개포4동제2투	4499	3434	1065	8	3426	2140	1275	0	4	4	3
서울특별시	강남구	개포4동	개포4동제3투	4373	3276	1097	10	3266	1661	1593	2	5	4	1
서울특별시	강남구	개포4동	개포4동제4투	4837	3471	1366	15	3456	1601	1844	1	1	6	3
서울특별시	강남구	일원본동	소계	17068	13958	3110	69	13889	7973	5841	5	5	53	12
서울특별시	강남구	일원본동	일원본동제1투	3238	2714	524	12	2702	1715	975	0	0	8	4
서울특별시	강남구	일원본동	일원본동제2투	4170	3503	667	10	3493	1935	1537	0	2	17	2
서울특별시	강남구	일원본동	일원본동제3투	5010	4102	908	11	4091	2562	1510	3	2	13	1
서울특별시	강남구	일원본동	일원본동제4투	4650	3639	1011	36	3603	1761	1819	2	1	15	5
서울특별시	강남구	일원1동	소계	15170	11486	3684	86	11400	5796	5557	10	2	24	11
서울특별시	강남구	일원1동	일원1동제1투	3523	2604	919	26	2578	1241	1324	2	0	8	3
서울특별시	강남구	일원1동	일원1동제2투	3013	2361	652	12	2349	1179	1162	1	2	3	2
서울특별시	강남구	일원1동	일원1동제3투	2855	2156	699	10	2146	1055	1083	3	0	4	1
서울특별시	강남구	일원1동	일원1동제4투	2906	2230	676	18	2212	1207	997	2	0	4	2
서울특별시	강남구	일원1동	일원1동제5투	2873	2135	738	20	2115	1114	991	2	0	5	3
서울특별시	강남구	일원2동	소계	15010	11911	3099	62	11849	6306	5487	10	2	35	9
서울특별시	강남구	일원2동	일원2동제1투	3139	2288	851	21	2267	1114	1137	6	2	5	3
서울특별시	강남구	일원2동	일원2동제2투	3305	2640	665	11	2629	1220	1400	2	0	6	1
서울특별시	강남구	일원2동	일원2동제3투	2805	2267	538	7	2260	1255	999	1	0	5	0
서울특별시	강남구	일원2동	일원2동제4투	2829	2257	572	8	2249	1287	954	0	0	6	2
서울특별시	강남구	일원2동	일원2동제5투	2932	2459	473	15	2444	1430	997	1	0	13	3
서울특별시	강남구	수서동	소계	14581	10913	3668	72	10841	5668	5118	8	5	19	23
서울특별시	강남구	수서동	수서동제1투	3485	2682	803	7	2675	1621	1048	0	1	3	2
서울특별시	강남구	수서동	수서동제2투	2320	1704	616	21	1683	798	876	0	0	5	4
서울특별시	강남구	수서동	수서동제3투	2751	1932	819	19	1913	961	936	3	1	2	10
서울특별시	강남구	수서동	수서동제4투	2572	1877	695	14	1863	939	912	2	3	2	5
서울특별시	강남구	수서동	수서동제5투	3453	2718	735	11	2707	1349	1346	3	0	7	2
서울특별시	강남구	세곡동	소계	10438	8058	2380	42	8016	4269	3715	5	5	13	9
서울특별시	강남구	세곡동	세곡동제1투	3255	2333	922	18	2315	1494	816	2	0	1	2
서울특별시	강남구	세곡동	세곡동제2투	4978	3964	1014	18	3946	1922	2008	2	3	6	5
서울특별시	강남구	세곡동	세곡동제3투	2205	1761	444	6	1755	853	891	1	2	6	2
서울특별시	강남구	잘못 투입·구분된 투표지	잘못 투입·구분된 투표지	0	18	-18	1	17	10	7	0	0	0	0
서울특별시	송파구	계	계	545369	419631	125738	1819	417812	217650	198590	194	177	897	304
서울특별시	송파구	재외투표	재외투표	6140	4518	1622	21	4497	2130	2352	1	6	4	4
서울특별시	송파구	국내부재자투표	국내부재자투표	11772	10993	779	191	10802	5841	4885	11	14	29	22
서울특별시	송파구	풍납1동	소계	15614	11631	3983	59	11572	5532	6001	3	7	19	10
서울특별시	송파구	풍납1동	풍납1동제1투	4133	2869	1264	19	2850	1372	1466	2	3	4	3
서울특별시	송파구	풍납1동	풍납1동제2투	3933	3014	919	11	3003	1398	1597	0	1	4	3
서울특별시	송파구	풍납1동	풍납1동제3투	3915	2910	1005	16	2894	1363	1517	1	3	7	3
서울특별시	송파구	풍납1동	풍납1동제4투	3633	2838	795	13	2825	1399	1421	0	0	4	1
서울특별시	송파구	풍납2동	소계	22509	17610	4899	73	17537	8353	9105	13	9	45	12
서울특별시	송파구	풍납2동	풍납2동제1투	3706	2874	832	11	2863	1347	1504	2	0	10	0
서울특별시	송파구	풍납2동	풍납2동제2투	4266	3334	932	15	3319	1508	1800	2	2	4	3
서울특별시	송파구	풍납2동	풍납2동제3투	3643	2884	759	13	2871	1411	1442	2	1	14	1
서울특별시	송파구	풍납2동	풍납2동제4투	4075	3134	941	12	3122	1370	1743	1	1	5	2
서울특별시	송파구	풍납2동	풍납2동제5투	3482	2684	798	11	2673	1390	1269	5	2	5	2
서울특별시	송파구	풍납2동	풍납2동제6투	3337	2700	637	11	2689	1327	1347	1	3	7	4
서울특별시	송파구	거여1동	소계	12247	9322	2925	48	9274	4773	4462	4	5	19	11
서울특별시	송파구	거여1동	거여1동제1투	3894	2877	1017	15	2862	1355	1496	0	1	7	3
서울특별시	송파구	거여1동	거여1동제2투	3888	2893	995	18	2875	1384	1477	2	2	5	5
서울특별시	송파구	거여1동	거여1동제3투	4465	3552	913	15	3537	2034	1489	2	2	7	3
서울특별시	송파구	거여2동	소계	21824	16257	5567	115	16142	7899	8168	12	9	34	20
서울특별시	송파구	거여2동	거여2동제1투	3268	2269	999	11	2258	1121	1130	0	0	4	3
서울특별시	송파구	거여2동	거여2동제2투	3295	2273	1022	13	2260	1158	1090	2	0	6	4
서울특별시	송파구	거여2동	거여2동제3투	3552	2657	895	8	2649	1428	1218	1	0	0	2
서울특별시	송파구	거여2동	거여2동제4투	3401	2520	881	62	2458	1239	1191	7	4	10	7
서울특별시	송파구	거여2동	거여2동제5투	3749	2897	852	8	2889	1216	1657	0	5	8	3
서울특별시	송파구	거여2동	거여2동제6투	4559	3641	918	13	3628	1737	1882	2	0	6	1
서울특별시	송파구	마천1동	소계	19036	13774	5262	64	13710	6526	7124	7	9	29	15
서울특별시	송파구	마천1동	마천1동제1투	3673	2527	1146	12	2515	1201	1302	3	2	4	3
서울특별시	송파구	마천1동	마천1동제2투	3751	2712	1039	16	2696	1291	1396	1	1	6	1
서울특별시	송파구	마천1동	마천1동제3투	3996	2837	1159	11	2826	1399	1414	0	2	4	7
서울특별시	송파구	마천1동	마천1동제4투	3463	2396	1067	17	2379	1141	1230	0	1	4	3
서울특별시	송파구	마천1동	마천1동제5투	4153	3302	851	8	3294	1494	1782	3	3	11	1
서울특별시	송파구	마천2동	소계	17844	12758	5086	71	12687	6101	6536	9	5	23	13
서울특별시	송파구	마천2동	마천2동제1투	4556	3048	1508	31	3017	1497	1512	2	0	5	1
서울특별시	송파구	마천2동	마천2동제2투	4523	3287	1236	18	3269	1589	1663	2	2	11	2
서울특별시	송파구	마천2동	마천2동제3투	4529	3321	1208	11	3310	1478	1821	1	1	2	7
서울특별시	송파구	마천2동	마천2동제4투	4236	3102	1134	11	3091	1537	1540	4	2	5	3
서울특별시	송파구	방이1동	소계	13092	10295	2797	43	10252	5412	4811	7	3	19	0
서울특별시	송파구	방이1동	방이1동제1투	4295	3363	932	15	3348	1858	1477	2	1	10	0
서울특별시	송파구	방이1동	방이1동제2투	4544	3419	1125	21	3398	1538	1851	3	2	4	0
서울특별시	송파구	방이1동	방이1동제3투	4253	3513	740	7	3506	2016	1483	2	0	5	0
서울특별시	송파구	방이2동	소계	21304	15514	5790	63	15451	7022	8366	9	8	32	14
서울특별시	송파구	방이2동	방이2동제1투	4647	3251	1396	12	3239	1501	1720	2	1	11	4
서울특별시	송파구	방이2동	방이2동제2투	4219	3110	1109	13	3097	1365	1717	1	2	8	4
서울특별시	송파구	방이2동	방이2동제3투	4203	2906	1297	11	2895	1276	1606	2	1	6	4
서울특별시	송파구	방이2동	방이2동제4투	4149	3190	959	17	3173	1503	1662	1	2	5	0
서울특별시	송파구	방이2동	방이2동제5투	4086	3057	1029	10	3047	1377	1661	3	2	2	2
서울특별시	송파구	오륜동	소계	14880	12333	2547	54	12279	8183	4042	4	6	39	5
서울특별시	송파구	오륜동	오륜동제1투	3037	2563	474	12	2551	1733	803	2	1	11	1
서울특별시	송파구	오륜동	오륜동제2투	4011	3353	658	12	3341	2241	1085	0	3	10	2
서울특별시	송파구	오륜동	오륜동제3투	3737	3113	624	16	3097	2007	1079	2	0	8	1
서울특별시	송파구	오륜동	오륜동제4투	4095	3304	791	14	3290	2202	1075	0	2	10	1
서울특별시	송파구	오금동	소계	30405	23233	7172	84	23149	12274	10782	18	8	57	10
서울특별시	송파구	오금동	오금동제1투	4927	3737	1190	9	3728	2491	1227	1	1	7	1
서울특별시	송파구	오금동	오금동제2투	4635	3632	1003	17	3615	2031	1570	1	2	11	0
서울특별시	송파구	오금동	오금동제3투	4500	3325	1175	12	3313	1671	1621	6	3	11	1
서울특별시	송파구	오금동	오금동제4투	3920	2905	1015	11	2894	1410	1467	7	1	7	2
서울특별시	송파구	오금동	오금동제5투	4599	3498	1101	16	3482	1667	1807	1	0	5	2
서울특별시	송파구	오금동	오금동제6투	3598	2942	656	4	2938	1548	1374	1	0	14	1
서울특별시	송파구	오금동	오금동제7투	4226	3194	1032	15	3179	1456	1716	1	1	2	3
서울특별시	송파구	송파1동	소계	22138	16646	5492	59	16587	7584	8952	11	5	25	10
서울특별시	송파구	송파1동	송파1동제1투	4275	3002	1273	15	2987	1309	1669	2	1	4	2
서울특별시	송파구	송파1동	송파1동제2투	3202	2481	721	7	2474	1224	1243	1	1	4	1
서울특별시	송파구	송파1동	송파1동제3투	3049	2265	784	7	2258	956	1295	0	1	3	3
서울특별시	송파구	송파1동	송파1동제4투	3390	2573	817	7	2566	1088	1468	3	0	6	1
서울특별시	송파구	송파1동	송파1동제5투	3762	2906	856	14	2892	1234	1649	3	1	2	3
서울특별시	송파구	송파1동	송파1동제6투	4460	3419	1041	9	3410	1773	1628	2	1	6	0
서울특별시	송파구	송파2동	소계	17473	14095	3378	44	14051	7733	6256	5	9	36	12
서울특별시	송파구	송파2동	송파2동제1투	4432	3510	922	12	3498	1928	1554	2	1	10	3
서울특별시	송파구	송파2동	송파2동제2투	4140	3230	910	14	3216	1507	1694	2	2	8	3
서울특별시	송파구	송파2동	송파2동제3투	4483	3682	801	12	3670	2073	1583	1	3	9	1
서울특별시	송파구	송파2동	송파2동제4투	4418	3673	745	6	3667	2225	1425	0	3	9	5
서울특별시	송파구	석촌동	소계	28673	20481	8192	82	20399	8841	11506	5	8	24	15
서울특별시	송파구	석촌동	석촌동제1투	3783	2707	1076	16	2691	1132	1555	0	0	1	3
서울특별시	송파구	석촌동	석촌동제2투	3376	2576	800	12	2564	1105	1455	0	1	3	0
서울특별시	송파구	석촌동	석촌동제3투	3233	2377	856	5	2372	957	1408	1	0	5	1
서울특별시	송파구	석촌동	석촌동제4투	4558	3225	1333	10	3215	1388	1817	0	2	4	4
서울특별시	송파구	석촌동	석촌동제5투	4182	2994	1188	11	2983	1339	1635	3	1	3	2
서울특별시	송파구	석촌동	석촌동제6투	5257	3583	1674	18	3565	1632	1926	0	1	5	1
서울특별시	송파구	석촌동	석촌동제7투	4284	3019	1265	10	3009	1288	1710	1	3	3	4
서울특별시	송파구	삼전동	소계	28307	20390	7917	62	20328	8862	11409	6	7	31	13
서울특별시	송파구	삼전동	삼전동제1투	3704	2419	1285	4	2415	1053	1355	1	1	3	2
서울특별시	송파구	삼전동	삼전동제2투	3448	2457	991	12	2445	1079	1355	3	0	6	2
서울특별시	송파구	삼전동	삼전동제3투	3467	2571	896	5	2566	1123	1433	0	1	6	3
서울특별시	송파구	삼전동	삼전동제4투	3498	2537	961	5	2532	1123	1403	1	2	3	0
서울특별시	송파구	삼전동	삼전동제5투	3658	2705	953	10	2695	1149	1540	0	2	2	2
서울특별시	송파구	삼전동	삼전동제6투	3503	2505	998	10	2495	1098	1391	1	0	4	1
서울특별시	송파구	삼전동	삼전동제7투	3696	2693	1003	7	2686	1193	1487	0	1	2	3
서울특별시	송파구	삼전동	삼전동제8투	3333	2503	830	9	2494	1044	1445	0	0	5	0
서울특별시	송파구	가락본동	소계	23313	17730	5583	69	17661	8962	8643	6	6	37	7
서울특별시	송파구	가락본동	가락본동제1투	3623	2389	1234	6	2383	1271	1108	1	0	3	0
서울특별시	송파구	가락본동	가락본동제2투	4355	3433	922	11	3422	1677	1729	0	2	10	4
서울특별시	송파구	가락본동	가락본동제3투	4762	3516	1246	9	3507	1742	1751	0	3	9	2
서울특별시	송파구	가락본동	가락본동제4투	4174	3410	764	18	3392	1732	1651	2	0	7	0
서울특별시	송파구	가락본동	가락본동제5투	3742	2846	896	15	2831	1338	1489	1	1	2	0
서울특별시	송파구	가락본동	가락본동제6투	2657	2136	521	10	2126	1202	915	2	0	6	1
서울특별시	송파구	가락1동	소계	7483	5252	2231	20	5232	2600	2609	5	2	12	4
서울특별시	송파구	가락1동	가락1동제1투	1963	1273	690	1	1272	629	637	0	1	3	2
서울특별시	송파구	가락1동	가락1동제2투	1611	1104	507	3	1101	567	529	2	0	2	1
서울특별시	송파구	가락1동	가락1동제3투	2120	1574	546	8	1566	766	792	1	1	5	1
서울특별시	송파구	가락1동	가락1동제4투	1789	1301	488	8	1293	638	651	2	0	2	0
서울특별시	송파구	가락2동	소계	27014	21600	5414	95	21505	11132	10295	6	6	53	13
서울특별시	송파구	가락2동	가락2동제1투	4164	3092	1072	16	3076	1394	1677	0	0	3	2
서울특별시	송파구	가락2동	가락2동제2투	3815	2999	816	13	2986	1367	1600	1	2	12	4
서울특별시	송파구	가락2동	가락2동제3투	4154	3523	631	12	3511	1736	1767	1	0	7	0
서울특별시	송파구	가락2동	가락2동제4투	3957	3213	744	10	3203	1738	1454	3	0	4	4
서울특별시	송파구	가락2동	가락2동제5투	3978	3199	779	19	3180	1866	1296	0	2	14	2
서울특별시	송파구	가락2동	가락2동제6투	3382	2731	651	12	2719	1518	1191	1	1	7	1
서울특별시	송파구	가락2동	가락2동제7투	3564	2843	721	13	2830	1513	1310	0	1	6	0
서울특별시	송파구	문정1동	소계	17859	13851	4008	50	13801	7357	6395	6	5	27	11
서울특별시	송파구	문정1동	문정1동제1투	4788	3401	1387	19	3382	1565	1808	2	2	3	2
서울특별시	송파구	문정1동	문정1동제2투	3807	3075	732	14	3061	1560	1484	2	0	8	7
서울특별시	송파구	문정1동	문정1동제3투	4355	3305	1050	8	3297	1537	1747	2	1	8	2
서울특별시	송파구	문정1동	문정1동제4투	4909	4070	839	9	4061	2695	1356	0	2	8	0
서울특별시	송파구	문정2동	소계	12861	10491	2370	50	10441	7099	3297	3	4	28	10
서울특별시	송파구	문정2동	문정2동제1투	2821	2257	564	8	2249	1436	805	1	0	4	3
서울특별시	송파구	문정2동	문정2동제2투	3305	2759	546	16	2743	1784	944	1	1	10	3
서울특별시	송파구	문정2동	문정2동제3투	3427	2796	631	14	2782	1905	866	1	2	6	2
서울특별시	송파구	문정2동	문정2동제4투	3308	2679	629	12	2667	1974	682	0	1	8	2
서울특별시	송파구	장지동	소계	28335	21913	6422	97	21816	10014	11717	13	6	50	16
서울특별시	송파구	장지동	장지동제1투	4528	3369	1159	12	3357	1581	1760	3	4	6	3
서울특별시	송파구	장지동	장지동제2투	3296	2564	732	13	2551	1298	1247	0	0	4	2
서울특별시	송파구	장지동	장지동제3투	3874	2972	902	16	2956	1380	1568	1	0	2	5
서울특별시	송파구	장지동	장지동제4투	3940	2960	980	13	2947	1277	1654	2	2	11	1
서울특별시	송파구	장지동	장지동제5투	4695	3657	1038	18	3639	1592	2039	2	0	6	0
서울특별시	송파구	장지동	장지동제6투	4175	3317	858	11	3306	1501	1790	2	0	10	3
서울특별시	송파구	장지동	장지동제7투	3827	3074	753	14	3060	1385	1659	3	0	11	2
서울특별시	송파구	잠실본동	소계	25017	17791	7226	46	17745	8165	9527	9	2	29	13
서울특별시	송파구	잠실본동	잠실본동제1투	4097	2983	1114	10	2973	1299	1669	1	0	2	2
서울특별시	송파구	잠실본동	잠실본동제2투	3576	2461	1115	8	2453	1180	1264	1	0	6	2
서울특별시	송파구	잠실본동	잠실본동제3투	3813	2714	1099	6	2708	1229	1470	1	2	4	2
서울특별시	송파구	잠실본동	잠실본동제4투	4958	3251	1707	5	3246	1504	1732	2	0	6	2
서울특별시	송파구	잠실본동	잠실본동제5투	4140	3169	971	7	3162	1506	1645	0	0	8	3
서울특별시	송파구	잠실본동	잠실본동제6투	4433	3213	1220	10	3203	1447	1747	4	0	3	2
서울특별시	송파구	잠실2동	소계	25896	20700	5196	46	20654	11678	8907	2	5	53	9
서울특별시	송파구	잠실2동	잠실2동제1투	3406	2395	1011	11	2384	1349	1027	0	0	7	1
서울특별시	송파구	잠실2동	잠실2동제2투	4123	3392	731	7	3385	1896	1481	1	0	6	1
서울특별시	송파구	잠실2동	잠실2동제3투	3803	3091	712	6	3085	1670	1398	0	5	10	2
서울특별시	송파구	잠실2동	잠실2동제4투	3726	3002	724	5	2997	1857	1134	0	0	5	1
서울특별시	송파구	잠실2동	잠실2동제5투	3870	3129	741	5	3124	1792	1323	0	0	7	2
서울특별시	송파구	잠실2동	잠실2동제6투	3185	2633	552	6	2627	1504	1109	1	0	13	0
서울특별시	송파구	잠실2동	잠실2동제7투	3783	3058	725	6	3052	1610	1435	0	0	5	2
서울특별시	송파구	잠실3동	소계	28621	23243	5378	69	23174	14676	8412	10	7	53	16
서울특별시	송파구	잠실3동	잠실3동제1투	3204	2702	502	16	2686	1736	940	1	1	5	3
서울특별시	송파구	잠실3동	잠실3동제2투	4378	3316	1062	9	3307	2106	1188	0	1	7	5
서울특별시	송파구	잠실3동	잠실3동제3투	3165	2656	509	7	2649	1616	1023	1	0	9	0
서울특별시	송파구	잠실3동	잠실3동제4투	2159	1709	450	2	1707	1290	414	0	0	2	1
서울특별시	송파구	잠실3동	잠실3동제5투	3855	3165	690	7	3158	1986	1159	1	2	9	1
서울특별시	송파구	잠실3동	잠실3동제6투	2895	2397	498	9	2388	1559	815	2	0	9	3
서울특별시	송파구	잠실3동	잠실3동제7투	4367	3529	838	8	3521	2151	1360	3	1	5	1
서울특별시	송파구	잠실3동	잠실3동제8투	4598	3769	829	11	3758	2232	1513	2	2	7	2
서울특별시	송파구	잠실4동	소계	23876	19600	4276	72	19528	11434	8028	4	6	46	10
서울특별시	송파구	잠실4동	잠실4동제1투	3602	2770	832	9	2761	1601	1149	1	0	8	2
서울특별시	송파구	잠실4동	잠실4동제2투	4443	3678	765	14	3664	2106	1549	1	1	5	2
서울특별시	송파구	잠실4동	잠실4동제3투	4492	3757	735	13	3744	2192	1542	2	1	7	0
서울특별시	송파구	잠실4동	잠실4동제4투	4491	3700	791	14	3686	2049	1625	0	1	11	0
서울특별시	송파구	잠실4동	잠실4동제5투	2978	2450	528	7	2443	1368	1061	0	1	9	4
서울특별시	송파구	잠실4동	잠실4동제6투	3870	3245	625	15	3230	2118	1102	0	2	6	2
서울특별시	송파구	잠실6동	소계	13484	10736	2748	51	10685	6637	4009	2	5	28	4
서울특별시	송파구	잠실6동	잠실6동제1투	4351	3344	1007	16	3328	2017	1299	1	0	9	2
서울특별시	송파구	잠실6동	잠실6동제2투	4685	3772	913	21	3751	2380	1358	1	1	10	1
서울특별시	송파구	잠실6동	잠실6동제3투	4448	3620	828	14	3606	2240	1352	0	4	9	1
서울특별시	송파구	잠실7동	소계	8352	6835	1517	21	6814	4809	1976	3	5	16	5
서울특별시	송파구	잠실7동	잠실7동제1투	4391	3536	855	11	3525	2685	825	1	2	8	4
서울특별시	송파구	잠실7동	잠실7동제2투	3961	3299	662	10	3289	2124	1151	2	3	8	1
서울특별시	송파구	잘못 투입·구분된 투표지	잘못 투입·구분된 투표지	0	39	-39	0	39	21	18	0	0	0	0
서울특별시	강동구	계	계	397018	300362	96656	1358	299004	150764	147131	165	141	577	226
서울특별시	강동구	재외투표	재외투표	3228	2388	840	5	2383	1032	1338	2	2	7	2
서울특별시	강동구	국내부재자투표	국내부재자투표	8784	8228	556	156	8072	4093	3909	13	9	25	23
서울특별시	강동구	강일동	소계	24607	19449	5158	72	19377	8898	10423	14	6	28	8
서울특별시	강동구	강일동	강일동제1투	4065	3079	986	11	3068	1443	1616	3	0	5	1
서울특별시	강동구	강일동	강일동제2투	3907	3071	836	4	3067	1431	1629	1	2	3	1
서울특별시	강동구	강일동	강일동제3투	3663	2934	729	8	2926	1399	1518	3	1	5	0
서울특별시	강동구	강일동	강일동제4투	4061	3250	811	12	3238	1458	1772	2	0	5	1
서울특별시	강동구	강일동	강일동제5투	3180	2544	636	19	2525	1096	1422	1	2	1	3
서울특별시	강동구	강일동	강일동제6투	5731	4571	1160	18	4553	2071	2466	4	1	9	2
서울특별시	강동구	상일동	소계	21575	16836	4739	53	16783	8900	7819	5	8	34	17
서울특별시	강동구	상일동	상일동제1투	3602	2725	877	8	2717	1404	1301	2	3	5	2
서울특별시	강동구	상일동	상일동제2투	3894	3108	786	8	3100	1482	1607	1	0	7	3
서울특별시	강동구	상일동	상일동제3투	3637	2857	780	6	2851	1427	1413	1	1	6	3
서울특별시	강동구	상일동	상일동제4투	3543	2923	620	9	2914	1604	1299	1	1	8	1
서울특별시	강동구	상일동	상일동제5투	3221	2369	852	11	2358	1312	1036	0	2	4	4
서울특별시	강동구	상일동	상일동제6투	3678	2854	824	11	2843	1671	1163	0	1	4	4
서울특별시	강동구	명일제1동	소계	21667	17145	4522	69	17076	9162	7850	7	6	40	11
서울특별시	강동구	명일제1동	명일제1동제1투	4434	3265	1169	23	3242	1807	1421	3	1	8	2
서울특별시	강동구	명일제1동	명일제1동제2투	4552	3707	845	11	3696	2056	1629	2	1	6	2
서울특별시	강동구	명일제1동	명일제1동제3투	4090	3375	715	8	3367	1873	1478	0	2	11	3
서울특별시	강동구	명일제1동	명일제1동제4투	4717	3788	929	12	3776	1963	1803	1	1	5	3
서울특별시	강동구	명일제1동	명일제1동제5투	3874	3010	864	15	2995	1463	1519	1	1	10	1
서울특별시	강동구	명일제2동	소계	14464	11842	2622	36	11806	6994	4762	8	7	26	9
서울특별시	강동구	명일제2동	명일제2동제1투	3531	3043	488	8	3035	1757	1267	2	1	8	0
서울특별시	강동구	명일제2동	명일제2동제2투	3744	2844	900	7	2837	1649	1178	0	2	4	4
서울특별시	강동구	명일제2동	명일제2동제3투	3499	2883	616	10	2873	1635	1222	4	2	8	2
서울특별시	강동구	명일제2동	명일제2동제4투	3690	3072	618	11	3061	1953	1095	2	2	6	3
서울특별시	강동구	고덕제1동	소계	12942	10011	2931	48	9963	5134	4797	2	1	25	4
서울특별시	강동구	고덕제1동	고덕제1동제1투	3338	2265	1073	14	2251	1259	986	1	0	2	3
서울특별시	강동구	고덕제1동	고덕제1동제2투	3360	2809	551	14	2795	1446	1336	1	0	12	0
서울특별시	강동구	고덕제1동	고덕제1동제3투	3081	2506	575	4	2502	1103	1392	0	0	6	1
서울특별시	강동구	고덕제1동	고덕제1동제4투	3163	2431	732	16	2415	1326	1083	0	1	5	0
서울특별시	강동구	고덕제2동	소계	14470	10664	3806	52	10612	5484	5074	4	5	32	13
서울특별시	강동구	고덕제2동	고덕제2동제1투	4205	2911	1294	22	2889	1571	1303	3	2	6	4
서울특별시	강동구	고덕제2동	고덕제2동제2투	3501	2690	811	7	2683	1365	1300	1	3	11	3
서울특별시	강동구	고덕제2동	고덕제2동제3투	3411	2567	844	6	2561	1298	1253	0	0	10	0
서울특별시	강동구	고덕제2동	고덕제2동제4투	3353	2496	857	17	2479	1250	1218	0	0	5	6
서울특별시	강동구	암사제1동	소계	31218	22490	8728	104	22386	10958	11354	16	11	29	18
서울특별시	강동구	암사제1동	암사제1동제1투	4570	2794	1776	10	2784	1332	1441	3	0	4	4
서울특별시	강동구	암사제1동	암사제1동제2투	3947	2783	1164	9	2774	1313	1451	3	0	4	3
서울특별시	강동구	암사제1동	암사제1동제3투	4030	2943	1087	18	2925	1311	1606	1	1	3	3
서울특별시	강동구	암사제1동	암사제1동제4투	3730	2657	1073	8	2649	1353	1288	2	1	3	2
서울특별시	강동구	암사제1동	암사제1동제5투	3312	2354	958	14	2340	1085	1246	2	2	5	0
서울특별시	강동구	암사제1동	암사제1동제6투	3908	2797	1111	18	2779	1341	1427	3	2	4	2
서울특별시	강동구	암사제1동	암사제1동제7투	3641	2711	930	17	2694	1379	1304	1	2	4	4
서울특별시	강동구	암사제1동	암사제1동제8투	4080	3451	629	10	3441	1844	1591	1	3	2	0
서울특별시	강동구	암사제2동	소계	12596	9849	2747	41	9808	4678	5099	5	3	17	6
서울특별시	강동구	암사제2동	암사제2동제1투	3658	2751	907	14	2737	1339	1390	1	0	5	2
서울특별시	강동구	암사제2동	암사제2동제2투	4305	3257	1048	17	3240	1573	1657	0	0	7	3
서울특별시	강동구	암사제2동	암사제2동제3투	4633	3841	792	10	3831	1766	2052	4	3	5	1
서울특별시	강동구	암사제3동	소계	14206	11588	2618	38	11550	6204	5313	2	6	16	9
서울특별시	강동구	암사제3동	암사제3동제1투	4458	3570	888	11	3559	1864	1684	1	1	8	1
서울특별시	강동구	암사제3동	암사제3동제2투	3739	3134	605	9	3125	1809	1303	0	3	6	4
서울특별시	강동구	암사제3동	암사제3동제3투	3157	2557	600	6	2551	1331	1217	0	1	0	2
서울특별시	강동구	암사제3동	암사제3동제4투	2852	2327	525	12	2315	1200	1109	1	1	2	2
서울특별시	강동구	천호제1동	소계	25562	18340	7222	98	18242	9134	9038	16	14	23	17
서울특별시	강동구	천호제1동	천호제1동제1투	4923	3145	1778	23	3122	1484	1627	1	3	3	4
서울특별시	강동구	천호제1동	천호제1동제2투	4080	2967	1113	19	2948	1561	1369	3	4	7	4
서울특별시	강동구	천호제1동	천호제1동제3투	3884	2730	1154	15	2715	1342	1362	4	2	2	3
서울특별시	강동구	천호제1동	천호제1동제4투	4214	3180	1034	11	3169	1571	1588	2	1	6	1
서울특별시	강동구	천호제1동	천호제1동제5투	4851	3608	1243	19	3589	1817	1763	4	2	1	2
서울특별시	강동구	천호제1동	천호제1동제6투	3610	2710	900	11	2699	1359	1329	2	2	4	3
서울특별시	강동구	천호제2동	소계	31296	21858	9438	106	21752	10627	11048	16	8	39	14
서울특별시	강동구	천호제2동	천호제2동제1투	3452	2436	1016	17	2419	1206	1203	3	1	2	4
서울특별시	강동구	천호제2동	천호제2동제2투	3681	2754	927	9	2745	1233	1505	1	1	4	1
서울특별시	강동구	천호제2동	천호제2동제3투	3067	2213	854	7	2206	1075	1120	2	2	5	2
서울특별시	강동구	천호제2동	천호제2동제4투	2925	2076	849	9	2067	1024	1039	1	0	3	0
서울특별시	강동구	천호제2동	천호제2동제5투	4515	3117	1398	18	3099	1503	1579	1	2	13	1
서울특별시	강동구	천호제2동	천호제2동제6투	4634	3285	1349	17	3268	1611	1650	2	1	3	1
서울특별시	강동구	천호제2동	천호제2동제7투	5105	3342	1763	12	3330	1616	1703	4	1	4	2
서울특별시	강동구	천호제2동	천호제2동제8투	3917	2635	1282	17	2618	1359	1249	2	0	5	3
서울특별시	강동구	천호제3동	소계	22591	15731	6860	68	15663	7750	7848	13	7	35	10
서울특별시	강동구	천호제3동	천호제3동제1투	4467	2988	1479	7	2981	1532	1442	0	1	5	1
서울특별시	강동구	천호제3동	천호제3동제2투	4351	3148	1203	24	3124	1498	1607	3	3	11	2
서울특별시	강동구	천호제3동	천호제3동제3투	3677	2465	1212	15	2450	1254	1182	5	0	6	3
서울특별시	강동구	천호제3동	천호제3동제4투	3321	2289	1032	12	2277	1190	1079	2	1	3	2
서울특별시	강동구	천호제3동	천호제3동제5투	3602	2481	1121	6	2475	1187	1279	1	1	5	2
서울특별시	강동구	천호제3동	천호제3동제6투	3173	2360	813	4	2356	1089	1259	2	1	5	0
서울특별시	강동구	성내제1동	소계	15508	12073	3435	56	12017	5907	6063	4	7	28	8
서울특별시	강동구	성내제1동	성내제1동제1투	3986	2930	1056	12	2918	1465	1443	0	2	7	1
서울특별시	강동구	성내제1동	성내제1동제2투	3315	2625	690	12	2613	1293	1312	1	2	5	0
서울특별시	강동구	성내제1동	성내제1동제3투	3508	2633	875	20	2613	1206	1397	1	3	3	3
서울특별시	강동구	성내제1동	성내제1동제4투	4699	3885	814	12	3873	1943	1911	2	0	13	4
서울특별시	강동구	성내제2동	소계	22333	15877	6456	63	15814	7558	8195	13	10	30	8
서울특별시	강동구	성내제2동	성내제2동제1투	4620	2984	1636	17	2967	1432	1524	3	3	5	0
서울특별시	강동구	성내제2동	성내제2동제2투	4742	3558	1184	11	3547	1698	1833	3	0	12	1
서울특별시	강동구	성내제2동	성내제2동제3투	4802	3482	1320	11	3471	1724	1729	6	2	7	3
서울특별시	강동구	성내제2동	성내제2동제4투	4141	3045	1096	18	3027	1383	1633	0	4	6	1
서울특별시	강동구	성내제2동	성내제2동제5투	4028	2808	1220	6	2802	1321	1476	1	1	0	3
서울특별시	강동구	성내제3동	소계	20534	15239	5295	67	15172	7209	7901	8	13	30	11
서울특별시	강동구	성내제3동	성내제3동제1투	4691	3347	1344	10	3337	1579	1747	2	1	7	1
서울특별시	강동구	성내제3동	성내제3동제2투	5109	3876	1233	19	3857	1846	1988	3	3	12	5
서울특별시	강동구	성내제3동	성내제3동제3투	5065	3874	1191	25	3849	1846	1991	2	3	4	3
서울특별시	강동구	성내제3동	성내제3동제4투	5669	4142	1527	13	4129	1938	2175	1	6	7	2
서울특별시	강동구	길동	소계	41205	30732	10473	116	30616	15151	15374	6	9	54	22
서울특별시	강동구	길동	길동제1투	4656	3386	1270	14	3372	1586	1778	0	2	5	1
서울특별시	강동구	길동	길동제2투	3878	3004	874	11	2993	1469	1516	1	1	5	1
서울특별시	강동구	길동	길동제3투	4509	3415	1094	18	3397	1573	1813	0	2	4	5
서울특별시	강동구	길동	길동제4투	3862	2771	1091	11	2760	1313	1435	1	1	8	2
서울특별시	강동구	길동	길동제5투	2897	2124	773	6	2118	990	1121	1	0	3	3
서울특별시	강동구	길동	길동제6투	4569	2895	1674	10	2885	1441	1436	0	0	6	2
서울특별시	강동구	길동	길동제7투	4759	3644	1115	10	3634	1978	1649	0	1	4	2
서울특별시	강동구	길동	길동제8투	4283	3455	828	14	3441	1732	1700	2	0	6	1
서울특별시	강동구	길동	길동제9투	3875	2968	907	8	2960	1521	1426	1	1	7	4
서울특별시	강동구	길동	길동제10투	3917	3070	847	14	3056	1548	1500	0	1	6	1
서울특별시	강동구	둔촌제1동	소계	15177	12323	2854	40	12283	6794	5445	3	5	28	8
서울특별시	강동구	둔촌제1동	둔촌제1동제1투	4027	3259	768	15	3244	1748	1489	0	1	5	1
서울특별시	강동구	둔촌제1동	둔촌제1동제2투	3533	2739	794	5	2734	1475	1244	3	0	9	3
서울특별시	강동구	둔촌제1동	둔촌제1동제3투	3938	3289	649	11	3278	1848	1420	0	0	7	3
서울특별시	강동구	둔촌제1동	둔촌제1동제4투	3679	3036	643	9	3027	1723	1292	0	4	7	1
서울특별시	강동구	둔촌제2동	소계	23055	17676	5379	70	17606	9087	8468	8	4	31	8
서울특별시	강동구	둔촌제2동	둔촌제2동제1투	4709	3338	1371	18	3320	1644	1665	2	0	8	1
서울특별시	강동구	둔촌제2동	둔촌제2동제2투	4461	3322	1139	12	3310	1638	1668	0	1	2	1
서울특별시	강동구	둔촌제2동	둔촌제2동제3투	4678	3797	881	11	3786	1896	1876	2	3	7	2
서울특별시	강동구	둔촌제2동	둔촌제2동제4투	4662	3629	1033	16	3613	1955	1647	3	0	7	1
서울특별시	강동구	둔촌제2동	둔촌제2동제5투	4545	3590	955	13	3577	1954	1612	1	0	7	3
서울특별시	강동구	잘못 투입·구분된 투표지	잘못 투입·구분된 투표지	0	23	-23	0	23	10	13	0	0	0	0
부산광역시	중구	계	계	42123	29939	12184	86	29853	19208	10567	5	10	34	29
부산광역시	중구	재외투표	재외투표	321	221	100	0	221	121	99	1	0	0	0
부산광역시	중구	국내부재자투표	국내부재자투표	814	767	47	15	752	372	374	0	0	0	6
부산광역시	중구	중앙동	소계	1751	1184	567	3	1181	769	411	0	0	1	0
부산광역시	중구	중앙동	중앙동제1투	688	429	259	1	428	297	131	0	0	0	0
부산광역시	중구	중앙동	중앙동제2투	1063	755	308	2	753	472	280	0	0	1	0
부산광역시	중구	동광동	소계	3312	2158	1154	8	2150	1406	736	0	0	5	3
부산광역시	중구	동광동	동광동제1투	1739	1078	661	3	1075	705	366	0	0	2	2
부산광역시	중구	동광동	동광동제2투	1573	1080	493	5	1075	701	370	0	0	3	1
부산광역시	중구	대청동	소계	6327	4563	1764	7	4556	2852	1690	2	2	5	5
부산광역시	중구	대청동	대청동제1투	1662	1138	524	1	1137	715	418	2	0	0	2
부산광역시	중구	대청동	대청동제2투	2809	2058	751	2	2056	1320	729	0	2	3	2
부산광역시	중구	대청동	대청동제3투	1856	1367	489	4	1363	817	543	0	0	2	1
부산광역시	중구	보수동	소계	9886	7085	2801	13	7072	4543	2513	1	3	4	8
부산광역시	중구	보수동	보수동제1투	2521	1865	656	2	1863	1174	685	0	1	1	2
부산광역시	중구	보수동	보수동제2투	2832	1957	875	5	1952	1249	697	0	1	1	4
부산광역시	중구	보수동	보수동제3투	1961	1345	616	2	1343	880	461	1	0	0	1
부산광역시	중구	보수동	보수동제4투	2572	1918	654	4	1914	1240	670	0	1	2	1
부산광역시	중구	부평동	소계	4780	3323	1457	4	3319	2296	1019	1	0	2	1
부산광역시	중구	부평동	부평동제1투	2730	1844	886	2	1842	1268	571	1	0	1	1
부산광역시	중구	부평동	부평동제2투	2050	1479	571	2	1477	1028	448	0	0	1	0
부산광역시	중구	광복동	소계	1327	881	446	4	877	616	260	0	1	0	0
부산광역시	중구	광복동	광복동투표소	1327	881	446	4	877	616	260	0	1	0	0
부산광역시	중구	남포동	소계	1266	825	441	0	825	596	225	0	0	3	1
부산광역시	중구	남포동	남포동투표소	1266	825	441	0	825	596	225	0	0	3	1
부산광역시	중구	영주제1동	소계	4428	3111	1317	10	3101	1911	1182	0	2	5	1
부산광역시	중구	영주제1동	영주제1동제1투	1379	979	400	4	975	590	382	0	1	2	0
부산광역시	중구	영주제1동	영주제1동제2투	1281	966	315	3	963	585	377	0	0	1	0
부산광역시	중구	영주제1동	영주제1동제3투	1768	1166	602	3	1163	736	423	0	1	2	1
부산광역시	중구	영주제2동	소계	7911	5821	2090	22	5799	3726	2058	0	2	9	4
부산광역시	중구	영주제2동	영주제2동제1투	2096	1417	679	2	1415	946	465	0	0	3	1
부산광역시	중구	영주제2동	영주제2동제2투	1876	1352	524	6	1346	928	415	0	0	1	2
부산광역시	중구	영주제2동	영주제2동제3투	2452	1909	543	9	1900	1117	778	0	1	3	1
부산광역시	중구	영주제2동	영주제2동제4투	1487	1143	344	5	1138	735	400	0	1	2	0
부산광역시	서구	계	계	103696	75140	28556	271	74869	48129	26426	22	38	104	150
부산광역시	서구	재외투표	재외투표	628	455	173	1	454	223	229	0	2	0	0
부산광역시	서구	국내부재자투표	국내부재자투표	2366	2204	162	60	2144	1074	1025	5	7	10	23
부산광역시	서구	동대신제1동	소계	4823	3608	1215	13	3595	2348	1237	2	1	1	6
부산광역시	서구	동대신제1동	동대신제1동제1투	2393	1827	566	7	1820	1225	593	0	0	0	2
부산광역시	서구	동대신제1동	동대신제1동제2투	2430	1781	649	6	1775	1123	644	2	1	1	4
부산광역시	서구	동대신제2동	소계	7983	6009	1974	20	5989	3924	2036	2	5	13	9
부산광역시	서구	동대신제2동	동대신제2동제1투	2226	1794	432	5	1789	1205	575	0	3	5	1
부산광역시	서구	동대신제2동	동대신제2동제2투	3196	2290	906	10	2280	1481	790	0	1	5	3
부산광역시	서구	동대신제2동	동대신제2동제3투	2561	1925	636	5	1920	1238	671	2	1	3	5
부산광역시	서구	동대신제3동	소계	6876	5087	1789	11	5076	3132	1926	1	5	6	6
부산광역시	서구	동대신제3동	동대신제3동제1투	3508	2544	964	4	2540	1576	953	1	4	3	3
부산광역시	서구	동대신제3동	동대신제3동제2투	3368	2543	825	7	2536	1556	973	0	1	3	3
부산광역시	서구	서대신제1동	소계	11213	8412	2801	21	8391	5343	3023	1	4	12	8
부산광역시	서구	서대신제1동	서대신제1동제1투	2944	2278	666	7	2271	1396	870	0	0	1	4
부산광역시	서구	서대신제1동	서대신제1동제2투	1509	1082	427	4	1078	734	342	1	1	0	0
부산광역시	서구	서대신제1동	서대신제1동제3투	2545	1851	694	1	1850	1193	652	0	2	3	0
부산광역시	서구	서대신제1동	서대신제1동제4투	2353	1839	514	5	1834	1176	652	0	0	4	2
부산광역시	서구	서대신제1동	서대신제1동제5투	1862	1362	500	4	1358	844	507	0	1	4	2
부산광역시	서구	서대신제3동	소계	5597	4282	1315	12	4270	2752	1505	1	0	6	6
부산광역시	서구	서대신제3동	서대신제3동제1투	2784	2159	625	6	2153	1400	743	0	0	5	5
부산광역시	서구	서대신제3동	서대신제3동제2투	2813	2123	690	6	2117	1352	762	1	0	1	1
부산광역시	서구	서대신제4동	소계	5820	4552	1268	9	4543	2864	1656	0	3	13	7
부산광역시	서구	서대신제4동	서대신제4동제1투	2123	1596	527	2	1594	1028	558	0	2	5	1
부산광역시	서구	서대신제4동	서대신제4동제2투	2806	2319	487	4	2315	1411	897	0	1	3	3
부산광역시	서구	서대신제4동	서대신제4동제3투	891	637	254	3	634	425	201	0	0	5	3
부산광역시	서구	부민동	소계	6504	4837	1667	18	4819	2921	1888	1	1	5	3
부산광역시	서구	부민동	부민동제1투	3702	2727	975	9	2718	1593	1119	1	0	4	1
부산광역시	서구	부민동	부민동제2투	2802	2110	692	9	2101	1328	769	0	1	1	2
부산광역시	서구	아미동	소계	8875	6004	2871	18	5986	3967	1984	1	2	7	25
부산광역시	서구	아미동	아미동제1투	2909	1952	957	9	1943	1264	674	0	0	0	5
부산광역시	서구	아미동	아미동제2투	2168	1504	664	5	1499	1007	481	0	1	6	4
부산광역시	서구	아미동	아미동제3투	2075	1314	761	2	1312	873	431	0	0	0	8
부산광역시	서구	아미동	아미동제4투	1723	1234	489	2	1232	823	398	1	1	1	8
부산광역시	서구	초장동	소계	5518	3685	1833	10	3675	2516	1145	1	1	3	9
부산광역시	서구	초장동	초장동제1투	3075	2010	1065	6	2004	1376	620	1	0	3	4
부산광역시	서구	초장동	초장동제2투	2443	1675	768	4	1671	1140	525	0	1	0	5
부산광역시	서구	충무동	소계	7013	4886	2127	15	4871	3332	1522	1	0	10	6
부산광역시	서구	충무동	충무동제1투	3535	2420	1115	6	2414	1577	829	1	0	4	3
부산광역시	서구	충무동	충무동제2투	3478	2466	1012	9	2457	1755	693	0	0	6	3
부산광역시	서구	남부민제1동	소계	5516	3785	1731	6	3779	2511	1258	1	1	2	6
부산광역시	서구	남부민제1동	남부민제1동제1투	3025	2059	966	4	2055	1341	710	0	1	1	2
부산광역시	서구	남부민제1동	남부민제1동제2투	2491	1726	765	2	1724	1170	548	1	0	1	4
부산광역시	서구	남부민제2동	소계	9593	6654	2939	19	6635	4404	2205	3	2	4	17
부산광역시	서구	남부민제2동	남부민제2동제1투	2418	1692	726	3	1689	1109	573	0	0	2	5
부산광역시	서구	남부민제2동	남부민제2동제2투	2272	1598	674	5	1593	1066	516	3	1	1	6
부산광역시	서구	남부민제2동	남부민제2동제3투	2476	1607	869	5	1602	1094	504	0	0	0	4
부산광역시	서구	남부민제2동	남부민제2동제4투	2427	1757	670	6	1751	1135	612	0	1	1	2
부산광역시	서구	암남동	소계	15371	10680	4691	38	10642	6818	3787	2	4	12	19
부산광역시	서구	암남동	암남동제1투	3341	2014	1327	2	2012	1339	668	1	1	1	2
부산광역시	서구	암남동	암남동제2투	2029	1515	514	18	1497	880	606	0	1	3	7
부산광역시	서구	암남동	암남동제3투	2154	1514	640	4	1510	954	549	0	1	4	2
부산광역시	서구	암남동	암남동제4투	4073	2914	1159	10	2904	1890	1009	0	0	3	2
부산광역시	서구	암남동	암남동제5투	3774	2723	1051	4	2719	1755	955	1	1	1	6
부산광역시	동구	계	계	85145	62994	22151	179	62815	40262	22338	14	29	81	91
부산광역시	동구	재외투표	재외투표	448	309	139	5	304	147	157	0	0	0	0
부산광역시	동구	국내부재자투표	국내부재자투표	1789	1659	130	24	1635	821	795	2	4	7	6
부산광역시	동구	초량제1동	소계	4645	3365	1280	7	3358	2178	1166	3	1	5	5
부산광역시	동구	초량제1동	초량제1동제1투	2748	1926	822	3	1923	1261	655	1	0	2	4
부산광역시	동구	초량제1동	초량제1동제2투	1897	1439	458	4	1435	917	511	2	1	3	1
부산광역시	동구	초량제2동	소계	6063	4291	1772	13	4278	2869	1391	1	4	10	3
부산광역시	동구	초량제2동	초량제2동제1투	3335	2267	1068	7	2260	1530	720	0	2	7	1
부산광역시	동구	초량제2동	초량제2동제2투	2728	2024	704	6	2018	1339	671	1	2	3	2
부산광역시	동구	초량제3동	소계	5607	4096	1511	9	4087	2500	1573	0	1	6	7
부산광역시	동구	초량제3동	초량제3동제1투	3127	2270	857	5	2265	1464	793	0	1	4	3
부산광역시	동구	초량제3동	초량제3동제2투	2480	1826	654	4	1822	1036	780	0	0	2	4
부산광역시	동구	초량제6동	소계	6973	5154	1819	17	5137	3358	1757	0	1	7	14
부산광역시	동구	초량제6동	초량제6동제1투	3479	2538	941	8	2530	1656	864	0	1	4	5
부산광역시	동구	초량제6동	초량제6동제2투	3494	2616	878	9	2607	1702	893	0	0	3	9
부산광역시	동구	수정제1동	소계	4706	3552	1154	5	3547	2219	1315	0	1	8	4
부산광역시	동구	수정제1동	수정제1동제1투	2267	1640	627	1	1639	1019	612	0	0	5	3
부산광역시	동구	수정제1동	수정제1동제2투	2439	1912	527	4	1908	1200	703	0	1	3	1
부산광역시	동구	수정제2동	소계	8800	6432	2368	14	6418	4193	2202	1	2	9	11
부산광역시	동구	수정제2동	수정제2동제1투	2601	1910	691	2	1908	1299	602	0	2	3	2
부산광역시	동구	수정제2동	수정제2동제2투	2974	2097	877	5	2092	1321	767	0	0	3	1
부산광역시	동구	수정제2동	수정제2동제3투	3225	2425	800	7	2418	1573	833	1	0	3	8
부산광역시	동구	수정제4동	소계	4710	3414	1296	4	3410	2289	1109	0	4	3	5
부산광역시	동구	수정제4동	수정제4동제1투	2328	1620	708	1	1619	1085	527	0	4	2	1
부산광역시	동구	수정제4동	수정제4동제2투	2382	1794	588	3	1791	1204	582	0	0	1	4
부산광역시	동구	수정제5동	소계	5963	4453	1510	14	4439	2942	1486	0	3	3	5
부산광역시	동구	수정제5동	수정제5동제1투	2664	2028	636	3	2025	1324	695	0	3	1	2
부산광역시	동구	수정제5동	수정제5동제2투	3299	2425	874	11	2414	1618	791	0	0	2	3
부산광역시	동구	좌천제1동	소계	7020	5280	1740	11	5269	3359	1902	1	0	3	4
부산광역시	동구	좌천제1동	좌천제1동제1투	3332	2494	838	6	2488	1623	860	0	0	3	2
부산광역시	동구	좌천제1동	좌천제1동제2투	3688	2786	902	5	2781	1736	1042	1	0	0	2
부산광역시	동구	좌천제4동	소계	3778	2834	944	5	2829	1786	1031	1	0	5	6
부산광역시	동구	좌천제4동	좌천제4동투표소	3778	2834	944	5	2829	1786	1031	1	0	5	6
부산광역시	동구	범일제1동	소계	4190	3183	1007	6	3177	1966	1205	1	2	1	2
부산광역시	동구	범일제1동	범일제1동제1투	3025	2325	700	3	2322	1423	895	1	1	1	1
부산광역시	동구	범일제1동	범일제1동제2투	1165	858	307	3	855	543	310	0	1	0	1
부산광역시	동구	범일제2동	소계	7424	5552	1872	15	5537	3468	2059	2	0	4	4
부산광역시	동구	범일제2동	범일제2동제1투	2706	1873	833	6	1867	1257	605	2	0	1	2
부산광역시	동구	범일제2동	범일제2동제2투	4718	3679	1039	9	3670	2211	1454	0	0	3	2
부산광역시	동구	범일제4동	소계	8615	6223	2392	19	6204	4101	2077	1	4	10	11
부산광역시	동구	범일제4동	범일제4동제1투	2534	1893	641	3	1890	1247	636	0	0	4	3
부산광역시	동구	범일제4동	범일제4동제2투	2923	2183	740	5	2178	1407	761	0	3	3	4
부산광역시	동구	범일제4동	범일제4동제3투	3158	2147	1011	11	2136	1447	680	1	1	3	4
부산광역시	동구	범일제5동	소계	4414	3197	1217	11	3186	2066	1113	1	2	0	4
부산광역시	동구	범일제5동	범일제5동제1투	2126	1559	567	4	1555	1049	501	1	2	0	2
부산광역시	동구	범일제5동	범일제5동제2투	2288	1638	650	7	1631	1017	612	0	0	0	2
부산광역시	영도구	계	계	119481	86765	32716	297	86468	50903	35314	16	38	91	106
부산광역시	영도구	재외투표	재외투표	620	433	187	4	429	187	242	0	0	0	0
부산광역시	영도구	국내부재자투표	국내부재자투표	2870	2682	188	46	2636	1346	1271	4	6	1	8
부산광역시	영도구	남항동	소계	9890	7058	2832	22	7036	4496	2524	2	1	8	5
부산광역시	영도구	남항동	남항동제1투	3422	2385	1037	10	2375	1523	849	0	0	2	1
부산광역시	영도구	남항동	남항동제2투	3203	2355	848	7	2348	1471	868	1	0	4	4
부산광역시	영도구	남항동	남항동제3투	3265	2318	947	5	2313	1502	807	1	1	2	0
부산광역시	영도구	영선제1동	소계	3929	2908	1021	7	2901	1674	1222	0	0	4	1
부산광역시	영도구	영선제1동	영선제1동제1투	1735	1230	505	3	1227	726	498	0	0	3	0
부산광역시	영도구	영선제1동	영선제1동제2투	2194	1678	516	4	1674	948	724	0	0	1	1
부산광역시	영도구	영선제2동	소계	9102	6696	2406	14	6682	3971	2694	1	4	5	7
부산광역시	영도구	영선제2동	영선제2동제1투	3554	2650	904	5	2645	1511	1126	0	3	3	2
부산광역시	영도구	영선제2동	영선제2동제2투	3367	2511	856	6	2505	1522	976	1	1	2	3
부산광역시	영도구	영선제2동	영선제2동제3투	2181	1535	646	3	1532	938	592	0	0	0	2
부산광역시	영도구	신선동	소계	11803	8044	3759	28	8016	4955	3042	2	1	7	9
부산광역시	영도구	신선동	신선동제1투	3114	1966	1148	7	1959	1218	737	0	0	2	2
부산광역시	영도구	신선동	신선동제2투	3141	2240	901	10	2230	1368	859	0	1	1	1
부산광역시	영도구	신선동	신선동제3투	2611	1856	755	8	1848	1122	721	2	0	1	2
부산광역시	영도구	신선동	신선동제4투	2937	1982	955	3	1979	1247	725	0	0	3	4
부산광역시	영도구	봉래제1동	소계	6537	4775	1762	13	4762	2909	1838	0	4	6	5
부산광역시	영도구	봉래제1동	봉래제1동제1투	3607	2667	940	6	2661	1613	1039	0	2	4	3
부산광역시	영도구	봉래제1동	봉래제1동제2투	2930	2108	822	7	2101	1296	799	0	2	2	2
부산광역시	영도구	봉래제2동	소계	8028	5614	2414	15	5599	3490	2094	1	2	5	7
부산광역시	영도구	봉래제2동	봉래제2동제1투	2902	1923	979	5	1918	1196	714	1	0	3	4
부산광역시	영도구	봉래제2동	봉래제2동제2투	2762	1947	815	5	1942	1237	703	0	0	0	2
부산광역시	영도구	봉래제2동	봉래제2동제3투	2364	1744	620	5	1739	1057	677	0	2	2	1
부산광역시	영도구	청학제1동	소계	7304	5059	2245	17	5042	2988	2039	2	6	2	5
부산광역시	영도구	청학제1동	청학제1동제1투	4290	2927	1363	12	2915	1706	1200	1	5	2	1
부산광역시	영도구	청학제1동	청학제1동제2투	3014	2132	882	5	2127	1282	839	1	1	0	4
부산광역시	영도구	청학제2동	소계	17983	13063	4920	39	13024	7438	5550	2	3	12	19
부산광역시	영도구	청학제2동	청학제2동제1투	3443	2534	909	3	2531	1424	1101	1	1	1	3
부산광역시	영도구	청학제2동	청학제2동제2투	2861	1921	940	6	1915	1176	735	1	0	3	0
부산광역시	영도구	청학제2동	청학제2동제3투	3783	2859	924	12	2847	1514	1326	0	1	3	3
부산광역시	영도구	청학제2동	청학제2동제4투	4002	2939	1063	5	2934	1600	1326	0	1	2	5
부산광역시	영도구	청학제2동	청학제2동제5투	3894	2810	1084	13	2797	1724	1062	0	0	3	8
부산광역시	영도구	동삼제1동	소계	26664	19675	6989	57	19618	11067	8497	2	6	28	18
부산광역시	영도구	동삼제1동	동삼제1동제1투	2653	1867	786	5	1862	1127	731	0	0	4	0
부산광역시	영도구	동삼제1동	동삼제1동제2투	3548	2590	958	6	2584	1400	1175	1	3	2	3
부산광역시	영도구	동삼제1동	동삼제1동제3투	4071	3032	1039	11	3021	1717	1297	0	1	4	2
부산광역시	영도구	동삼제1동	동삼제1동제4투	3374	2588	786	8	2580	1428	1139	1	2	6	4
부산광역시	영도구	동삼제1동	동삼제1동제5투	4218	3100	1118	6	3094	1747	1344	0	0	3	0
부산광역시	영도구	동삼제1동	동삼제1동제6투	3298	2513	785	8	2505	1390	1107	0	0	6	2
부산광역시	영도구	동삼제1동	동삼제1동제7투	2889	2007	882	9	1998	1170	821	0	0	2	5
부산광역시	영도구	동삼제1동	동삼제1동제8투	2613	1978	635	4	1974	1088	883	0	0	1	2
부산광역시	영도구	동삼제2동	소계	3523	2590	933	10	2580	1590	981	0	1	5	3
부산광역시	영도구	동삼제2동	동삼제2동투표소	3523	2590	933	10	2580	1590	981	0	1	5	3
부산광역시	영도구	동삼제3동	소계	11228	8168	3060	25	8143	4792	3320	0	4	8	19
부산광역시	영도구	동삼제3동	동삼제3동제1투	2376	1742	634	3	1739	1034	694	0	2	4	5
부산광역시	영도구	동삼제3동	동삼제3동제2투	2875	2138	737	6	2132	1213	912	0	2	1	4
부산광역시	영도구	동삼제3동	동삼제3동제3투	3247	2210	1037	11	2199	1433	757	0	0	1	8
부산광역시	영도구	동삼제3동	동삼제3동제4투	2730	2078	652	5	2073	1112	957	0	0	2	2
부산광역시	부산진구	계	계	328421	248245	80176	635	247610	146883	99987	68	118	289	265
부산광역시	부산진구	재외투표	재외투표	1395	955	440	8	947	363	581	1	0	1	1
부산광역시	부산진구	국내부재자투표	국내부재자투표	7665	7121	544	102	7019	3310	3649	9	9	17	25
부산광역시	부산진구	부전제1동	소계	6009	3909	2100	10	3899	2490	1399	1	2	4	3
부산광역시	부산진구	부전제1동	부전제1동제1투	3041	1977	1064	5	1972	1387	580	1	1	1	2
부산광역시	부산진구	부전제1동	부전제1동제2투	2968	1932	1036	5	1927	1103	819	0	1	3	1
부산광역시	부산진구	부전제2동	소계	8258	5449	2809	14	5435	3236	2176	2	4	12	5
부산광역시	부산진구	부전제2동	부전제2동제1투	3754	2634	1120	11	2623	1520	1086	2	4	6	5
부산광역시	부산진구	부전제2동	부전제2동제2투	4504	2815	1689	3	2812	1716	1090	0	0	6	0
부산광역시	부산진구	범전동	소계	6450	4598	1852	12	4586	3026	1547	1	2	5	5
부산광역시	부산진구	범전동	범전동제1투	2074	1587	487	3	1584	988	591	1	1	2	1
부산광역시	부산진구	범전동	범전동제2투	1853	1341	512	6	1335	951	382	0	0	0	2
부산광역시	부산진구	범전동	범전동제3투	2523	1670	853	3	1667	1087	574	0	1	3	2
부산광역시	부산진구	연지동	소계	19714	15486	4228	25	15461	9232	6193	1	6	17	12
부산광역시	부산진구	연지동	연지동제1투	3888	3304	584	5	3299	1665	1628	1	2	1	2
부산광역시	부산진구	연지동	연지동제2투	4722	3487	1235	3	3484	2251	1229	0	1	3	0
부산광역시	부산진구	연지동	연지동제3투	4072	3147	925	7	3140	2056	1072	0	1	6	5
부산광역시	부산진구	연지동	연지동제4투	3668	2834	834	6	2828	1691	1127	0	2	4	4
부산광역시	부산진구	연지동	연지동제5투	3364	2714	650	4	2710	1569	1137	0	0	3	1
부산광역시	부산진구	초읍동	소계	20653	15892	4761	31	15861	10401	5421	5	14	11	9
부산광역시	부산진구	초읍동	초읍동제1투	3286	2543	743	9	2534	1769	763	0	1	1	0
부산광역시	부산진구	초읍동	초읍동제2투	3513	2778	735	4	2774	1874	895	1	3	1	0
부산광역시	부산진구	초읍동	초읍동제3투	3935	2810	1125	7	2803	1901	889	2	4	3	4
부산광역시	부산진구	초읍동	초읍동제4투	3141	2504	637	5	2499	1545	948	1	2	2	1
부산광역시	부산진구	초읍동	초읍동제5투	3613	2777	836	6	2771	1665	1097	1	2	4	2
부산광역시	부산진구	초읍동	초읍동제6투	3165	2480	685	0	2480	1647	829	0	2	0	2
부산광역시	부산진구	양정제1동	소계	18670	14668	4002	35	14633	8739	5850	3	2	20	19
부산광역시	부산진구	양정제1동	양정제1동제1투	4375	3159	1216	5	3154	1976	1170	0	2	1	5
부산광역시	부산진구	양정제1동	양정제1동제2투	3689	3095	594	5	3090	1763	1320	1	0	4	2
부산광역시	부산진구	양정제1동	양정제1동제3투	4433	3734	699	4	3730	2116	1608	1	0	3	2
부산광역시	부산진구	양정제1동	양정제1동제4투	3321	2600	721	5	2595	1539	1041	1	0	8	6
부산광역시	부산진구	양정제1동	양정제1동제5투	2852	2080	772	16	2064	1345	711	0	0	4	4
부산광역시	부산진구	양정제2동	소계	12891	9388	3503	23	9365	5729	3617	0	3	8	8
부산광역시	부산진구	양정제2동	양정제2동제1투	3796	2662	1134	8	2654	1537	1115	0	1	1	0
부산광역시	부산진구	양정제2동	양정제2동제2투	3517	2715	802	6	2709	1659	1045	0	1	2	2
부산광역시	부산진구	양정제2동	양정제2동제3투	3202	2262	940	7	2255	1434	814	0	1	2	4
부산광역시	부산진구	양정제2동	양정제2동제4투	2376	1749	627	2	1747	1099	643	0	0	3	2
부산광역시	부산진구	전포제1동	소계	8019	5660	2359	16	5644	3654	1977	1	1	6	5
부산광역시	부산진구	전포제1동	전포제1동제1투	3629	2509	1120	11	2498	1611	884	0	0	1	2
부산광역시	부산진구	전포제1동	전포제1동제2투	4390	3151	1239	5	3146	2043	1093	1	1	5	3
부산광역시	부산진구	전포제2동	소계	17957	13297	4660	35	13262	8066	5156	4	10	17	9
부산광역시	부산진구	전포제2동	전포제2동제1투	3317	2374	943	4	2370	1384	972	1	4	6	3
부산광역시	부산진구	전포제2동	전포제2동제2투	3333	2469	864	3	2466	1538	919	1	3	3	2
부산광역시	부산진구	전포제2동	전포제2동제3투	3751	2921	830	12	2909	1745	1160	0	1	2	1
부산광역시	부산진구	전포제2동	전포제2동제4투	3388	2491	897	7	2484	1614	862	1	2	2	3
부산광역시	부산진구	전포제2동	전포제2동제5투	4168	3042	1126	9	3033	1785	1243	1	0	4	0
부산광역시	부산진구	전포제3동	소계	8719	6079	2640	14	6065	3652	2396	3	2	5	7
부산광역시	부산진구	전포제3동	전포제3동제1투	4503	3085	1418	9	3076	1606	1462	2	0	2	4
부산광역시	부산진구	전포제3동	전포제3동제2투	4216	2994	1222	5	2989	2046	934	1	2	3	3
부산광역시	부산진구	부암제1동	소계	17467	12915	4552	29	12886	7619	5240	4	2	9	12
부산광역시	부산진구	부암제1동	부암제1동제1투	2818	1653	1165	2	1651	1063	582	2	0	1	3
부산광역시	부산진구	부암제1동	부암제1동제2투	4056	3055	1001	7	3048	1843	1200	0	0	1	4
부산광역시	부산진구	부암제1동	부암제1동제3투	5190	4053	1137	12	4041	2318	1715	0	2	5	1
부산광역시	부산진구	부암제1동	부암제1동제4투	5403	4154	1249	8	4146	2395	1743	2	0	2	4
부산광역시	부산진구	부암제3동	소계	19225	14886	4339	32	14854	8100	6699	4	6	22	23
부산광역시	부산진구	부암제3동	부암제3동제1투	4086	2816	1270	9	2807	1598	1192	1	0	5	11
부산광역시	부산진구	부암제3동	부암제3동제2투	4421	3637	784	9	3628	1983	1633	3	0	6	3
부산광역시	부산진구	부암제3동	부암제3동제3투	4130	3162	968	5	3157	1886	1260	0	1	6	4
부산광역시	부산진구	부암제3동	부암제3동제4투	2877	2169	708	6	2163	1222	933	0	3	3	2
부산광역시	부산진구	부암제3동	부암제3동제5투	3711	3102	609	3	3099	1411	1681	0	2	2	3
부산광역시	부산진구	당감제1동	소계	4048	2907	1141	6	2901	1887	1000	1	1	6	6
부산광역시	부산진구	당감제1동	당감제1동제1투	1851	1353	498	1	1352	859	487	0	0	5	1
부산광역시	부산진구	당감제1동	당감제1동제2투	2197	1554	643	5	1549	1028	513	1	1	1	5
부산광역시	부산진구	당감제2동	소계	8939	6984	1955	17	6967	4108	2843	1	4	7	4
부산광역시	부산진구	당감제2동	당감제2동제1투	2850	2026	824	7	2019	1321	694	1	2	0	1
부산광역시	부산진구	당감제2동	당감제2동제2투	3081	2441	640	5	2436	1389	1039	0	2	4	2
부산광역시	부산진구	당감제2동	당감제2동제3투	3008	2517	491	5	2512	1398	1110	0	0	3	1
부산광역시	부산진구	당감제3동	소계	19035	14878	4157	26	14852	8181	6632	4	8	20	7
부산광역시	부산진구	당감제3동	당감제3동제1투	4098	3283	815	9	3274	1879	1384	0	5	4	2
부산광역시	부산진구	당감제3동	당감제3동제2투	3710	2662	1048	5	2657	1602	1049	2	1	3	0
부산광역시	부산진구	당감제3동	당감제3동제3투	5012	3752	1260	1	3751	2054	1688	0	1	5	3
부산광역시	부산진구	당감제3동	당감제3동제4투	2858	2378	480	6	2372	1244	1121	1	1	4	1
부산광역시	부산진구	당감제3동	당감제3동제5투	3357	2803	554	5	2798	1402	1390	1	0	4	1
부산광역시	부산진구	당감제4동	소계	11209	8449	2760	23	8426	4618	3789	1	2	7	9
부산광역시	부산진구	당감제4동	당감제4동제1투	3489	2413	1076	11	2402	1491	903	0	0	2	6
부산광역시	부산진구	당감제4동	당감제4동제2투	2963	2272	691	6	2266	1314	946	0	0	3	3
부산광역시	부산진구	당감제4동	당감제4동제3투	4757	3764	993	6	3758	1813	1940	1	2	2	0
부산광역시	부산진구	가야제1동	소계	11627	8371	3256	23	8348	4941	3373	3	5	13	13
부산광역시	부산진구	가야제1동	가야제1동제1투	3437	2426	1011	4	2422	1504	908	2	1	3	4
부산광역시	부산진구	가야제1동	가야제1동제2투	3907	2606	1301	9	2597	1488	1097	1	1	5	5
부산광역시	부산진구	가야제1동	가야제1동제3투	4283	3339	944	10	3329	1949	1368	0	3	5	4
부산광역시	부산진구	가야제2동	소계	14865	11603	3262	17	11586	7060	4483	2	10	15	16
부산광역시	부산진구	가야제2동	가야제2동제1투	3661	2696	965	5	2691	1716	971	1	0	0	3
부산광역시	부산진구	가야제2동	가야제2동제2투	4186	3281	905	5	3276	1926	1334	1	5	6	4
부산광역시	부산진구	가야제2동	가야제2동제3투	3333	2616	717	4	2612	1596	1003	0	1	5	7
부산광역시	부산진구	가야제2동	가야제2동제4투	3685	3010	675	3	3007	1822	1175	0	4	4	2
부산광역시	부산진구	가야제3동	소계	9374	6863	2511	25	6838	4008	2813	1	4	4	8
부산광역시	부산진구	가야제3동	가야제3동제1투	3507	2611	896	12	2599	1480	1111	0	2	3	3
부산광역시	부산진구	가야제3동	가야제3동제2투	3007	2141	866	6	2135	1289	841	1	1	0	3
부산광역시	부산진구	가야제3동	가야제3동제3투	2860	2111	749	7	2104	1239	861	0	1	1	2
부산광역시	부산진구	개금제1동	소계	11578	8550	3028	21	8529	5053	3459	1	3	8	5
부산광역시	부산진구	개금제1동	개금제1동제1투	4317	3160	1157	7	3153	1768	1380	0	0	4	1
부산광역시	부산진구	개금제1동	개금제1동제2투	3817	2839	978	7	2832	1719	1108	1	2	2	0
부산광역시	부산진구	개금제1동	개금제1동제3투	3444	2551	893	7	2544	1566	971	0	1	2	4
부산광역시	부산진구	개금제2동	소계	11272	8628	2644	14	8614	5263	3325	4	2	9	11
부산광역시	부산진구	개금제2동	개금제2동제1투	3933	2862	1071	9	2853	1735	1109	3	0	3	3
부산광역시	부산진구	개금제2동	개금제2동제2투	3701	2786	915	1	2785	1854	922	0	2	2	5
부산광역시	부산진구	개금제2동	개금제2동제3투	3638	2980	658	4	2976	1674	1294	1	0	4	3
부산광역시	부산진구	개금제3동	소계	27113	21700	5413	38	21662	12290	9325	4	8	20	15
부산광역시	부산진구	개금제3동	개금제3동제1투	3259	2353	906	5	2348	1453	887	0	1	2	5
부산광역시	부산진구	개금제3동	개금제3동제2투	3430	2667	763	4	2663	1474	1184	1	1	2	1
부산광역시	부산진구	개금제3동	개금제3동제3투	3578	2873	705	4	2869	1533	1331	0	0	5	0
부산광역시	부산진구	개금제3동	개금제3동제4투	3709	3100	609	7	3093	1701	1387	0	0	5	0
부산광역시	부산진구	개금제3동	개금제3동제5투	3020	2316	704	5	2311	1367	934	2	4	1	3
부산광역시	부산진구	개금제3동	개금제3동제6투	3704	2980	724	5	2975	1698	1270	0	1	2	4
부산광역시	부산진구	개금제3동	개금제3동제7투	3296	2802	494	5	2797	1640	1152	1	1	2	1
부산광역시	부산진구	개금제3동	개금제3동제8투	3117	2609	508	3	2606	1424	1180	0	0	1	1
부산광역시	부산진구	범천제1동	소계	8166	5740	2426	12	5728	3595	2116	0	3	10	4
부산광역시	부산진구	범천제1동	범천제1동제1투	4658	3279	1379	9	3270	2058	1200	0	2	7	3
부산광역시	부산진구	범천제1동	범천제1동제2투	3508	2461	1047	3	2458	1537	916	0	1	3	1
부산광역시	부산진구	범천제2동	소계	9717	7111	2606	18	7093	4464	2598	5	4	9	13
부산광역시	부산진구	범천제2동	범천제2동제1투	3748	2833	915	5	2828	1734	1083	0	2	4	5
부산광역시	부산진구	범천제2동	범천제2동제2투	3282	2431	851	4	2427	1525	892	2	2	2	4
부산광역시	부산진구	범천제2동	범천제2동제3투	2687	1847	840	9	1838	1205	623	3	0	3	4
부산광역시	부산진구	범천제4동	소계	8386	6158	2228	9	6149	3798	2330	2	1	7	11
부산광역시	부산진구	범천제4동	범천제4동제1투	2737	2054	683	2	2052	1140	908	0	1	2	1
부산광역시	부산진구	범천제4동	범천제4동제2투	3016	2126	890	4	2122	1358	754	1	0	3	6
부산광역시	부산진구	범천제4동	범천제4동제3투	2633	1978	655	3	1975	1300	668	1	0	2	4
부산광역시	동래구	계	계	228712	178174	50538	460	177714	108913	68281	44	68	232	176
부산광역시	동래구	재외투표	재외투표	1260	918	342	4	914	402	506	2	0	2	2
부산광역시	동래구	국내부재자투표	국내부재자투표	6087	5716	371	83	5633	2782	2808	4	7	11	21
부산광역시	동래구	수민동	소계	26290	21002	5288	45	20957	12364	8542	4	4	26	17
부산광역시	동래구	수민동	수민동제1투	3481	2607	874	3	2604	1613	984	1	0	5	1
부산광역시	동래구	수민동	수민동제2투	4486	3657	829	8	3649	2055	1582	1	0	9	2
부산광역시	동래구	수민동	수민동제3투	3816	2954	862	8	2946	1864	1080	0	0	1	1
부산광역시	동래구	수민동	수민동제4투	4780	3657	1123	10	3647	2076	1562	1	0	2	6
부산광역시	동래구	수민동	수민동제5투	2868	2333	535	3	2330	1499	825	1	1	2	2
부산광역시	동래구	수민동	수민동제6투	3221	2712	509	7	2705	1480	1219	0	2	3	1
부산광역시	동래구	수민동	수민동제7투	3638	3082	556	6	3076	1777	1290	0	1	4	4
부산광역시	동래구	복산동	소계	10932	8128	2804	22	8106	5469	2601	3	4	14	15
부산광역시	동래구	복산동	복산동제1투	3788	3057	731	9	3048	2045	992	2	1	7	1
부산광역시	동래구	복산동	복산동제2투	3734	2723	1011	5	2718	1872	835	0	1	2	8
부산광역시	동래구	복산동	복산동제3투	3410	2348	1062	8	2340	1552	774	1	2	5	6
부산광역시	동래구	명륜동	소계	12231	9496	2735	15	9481	5895	3568	1	0	12	5
부산광역시	동래구	명륜동	명륜동제1투	3214	2482	732	4	2478	1619	855	0	0	3	1
부산광역시	동래구	명륜동	명륜동제2투	3301	2537	764	2	2535	1483	1047	0	0	4	1
부산광역시	동래구	명륜동	명륜동제3투	3051	2362	689	6	2356	1475	876	0	0	4	1
부산광역시	동래구	명륜동	명륜동제4투	2665	2115	550	3	2112	1318	790	1	0	1	2
부산광역시	동래구	온천제1동	소계	16670	11881	4789	18	11863	7549	4279	0	5	14	16
부산광역시	동래구	온천제1동	온천제1동제1투	4353	2915	1438	5	2910	2009	891	0	2	2	6
부산광역시	동래구	온천제1동	온천제1동제2투	4652	3326	1326	3	3323	2187	1123	0	2	7	4
부산광역시	동래구	온천제1동	온천제1동제3투	4148	3049	1099	5	3044	1908	1130	0	1	1	4
부산광역시	동래구	온천제1동	온천제1동제4투	3517	2591	926	5	2586	1445	1135	0	0	4	2
부산광역시	동래구	온천제2동	소계	18166	14078	4088	37	14041	9312	4681	3	8	21	16
부산광역시	동래구	온천제2동	온천제2동제1투	3037	2339	698	8	2331	1525	796	0	0	3	7
부산광역시	동래구	온천제2동	온천제2동제2투	3479	2764	715	3	2761	1762	996	0	0	3	0
부산광역시	동래구	온천제2동	온천제2동제3투	3698	2940	758	4	2936	2122	802	0	2	8	2
부산광역시	동래구	온천제2동	온천제2동제4투	3149	2388	761	6	2382	1568	806	1	0	5	2
부산광역시	동래구	온천제2동	온천제2동제5투	2427	1831	596	2	1829	1186	638	1	2	1	1
부산광역시	동래구	온천제2동	온천제2동제6투	2376	1816	560	14	1802	1149	643	1	4	1	4
부산광역시	동래구	온천제3동	소계	28322	21751	6571	66	21685	13032	8607	8	8	18	12
부산광역시	동래구	온천제3동	온천제3동제1투	4685	3803	882	11	3792	2085	1702	2	0	1	2
부산광역시	동래구	온천제3동	온천제3동제2투	4403	3347	1056	10	3337	2074	1252	2	2	6	1
부산광역시	동래구	온천제3동	온천제3동제3투	4415	3143	1272	13	3130	1978	1148	0	0	2	2
부산광역시	동래구	온천제3동	온천제3동제4투	3814	2820	994	6	2814	1764	1046	1	2	0	1
부산광역시	동래구	온천제3동	온천제3동제5투	2985	2264	721	4	2260	1377	880	1	0	1	1
부산광역시	동래구	온천제3동	온천제3동제6투	3925	3078	847	9	3069	1815	1244	0	2	5	3
부산광역시	동래구	온천제3동	온천제3동제7투	4095	3296	799	13	3283	1939	1335	2	2	3	2
부산광역시	동래구	사직제1동	소계	7794	6038	1756	14	6024	3843	2168	0	0	10	3
부산광역시	동래구	사직제1동	사직제1동제1투	3662	2889	773	7	2882	1859	1018	0	0	3	2
부산광역시	동래구	사직제1동	사직제1동제2투	4132	3149	983	7	3142	1984	1150	0	0	7	1
부산광역시	동래구	사직제2동	소계	20640	16883	3757	26	16857	9515	7284	5	7	33	13
부산광역시	동래구	사직제2동	사직제2동제1투	2088	1541	547	2	1539	845	684	1	0	6	3
부산광역시	동래구	사직제2동	사직제2동제2투	4073	3250	823	4	3246	1912	1328	1	1	3	1
부산광역시	동래구	사직제2동	사직제2동제3투	4327	3689	638	4	3685	2032	1643	0	3	4	3
부산광역시	동래구	사직제2동	사직제2동제4투	3485	2896	589	7	2889	1619	1255	3	2	9	1
부산광역시	동래구	사직제2동	사직제2동제5투	3113	2536	577	3	2533	1537	989	0	0	4	3
부산광역시	동래구	사직제2동	사직제2동제6투	3554	2971	583	6	2965	1570	1385	0	1	7	2
부산광역시	동래구	사직제3동	소계	13748	10519	3229	26	10493	6568	3888	1	4	18	14
부산광역시	동래구	사직제3동	사직제3동제1투	3287	2398	889	9	2389	1481	898	0	2	5	3
부산광역시	동래구	사직제3동	사직제3동제2투	3464	2676	788	4	2672	1659	1003	0	0	6	4
부산광역시	동래구	사직제3동	사직제3동제3투	3377	2649	728	6	2643	1708	928	0	1	3	3
부산광역시	동래구	사직제3동	사직제3동제4투	3620	2796	824	7	2789	1720	1059	1	1	4	4
부산광역시	동래구	안락제1동	소계	14211	10939	3272	21	10918	6895	3994	2	1	13	13
부산광역시	동래구	안락제1동	안락제1동제1투	3678	2901	777	4	2897	1954	933	2	0	0	8
부산광역시	동래구	안락제1동	안락제1동제2투	3508	2887	621	4	2883	1581	1294	0	1	6	1
부산광역시	동래구	안락제1동	안락제1동제3투	3597	2585	1012	4	2581	1667	909	0	0	3	2
부산광역시	동래구	안락제1동	안락제1동제4투	3428	2566	862	9	2557	1693	858	0	0	4	2
부산광역시	동래구	안락제2동	소계	24975	19779	5196	32	19747	11830	7864	5	10	24	14
부산광역시	동래구	안락제2동	안락제2동제1투	2861	2150	711	2	2148	1455	690	0	0	3	0
부산광역시	동래구	안락제2동	안락제2동제2투	4192	3180	1012	3	3177	1950	1221	1	2	2	1
부산광역시	동래구	안락제2동	안락제2동제3투	3170	2390	780	3	2387	1551	829	2	1	1	3
부산광역시	동래구	안락제2동	안락제2동제4투	2667	2010	657	3	2007	1221	779	0	4	3	0
부산광역시	동래구	안락제2동	안락제2동제5투	4663	3861	802	7	3854	2312	1529	1	1	7	4
부산광역시	동래구	안락제2동	안락제2동제6투	3294	2726	568	7	2719	1567	1145	0	2	4	1
부산광역시	동래구	안락제2동	안락제2동제7투	4128	3462	666	7	3455	1774	1671	1	0	4	5
부산광역시	동래구	명장제1동	소계	13872	10500	3372	29	10471	6874	3569	6	8	8	6
부산광역시	동래구	명장제1동	명장제1동제1투	3592	2622	970	10	2612	1734	873	1	3	0	1
부산광역시	동래구	명장제1동	명장제1동제2투	3447	2727	720	8	2719	1849	859	2	2	4	3
부산광역시	동래구	명장제1동	명장제1동제3투	3845	2928	917	6	2922	1825	1088	2	3	2	2
부산광역시	동래구	명장제1동	명장제1동제4투	2988	2223	765	5	2218	1466	749	1	0	2	0
부산광역시	동래구	명장제2동	소계	13514	10546	2968	22	10524	6583	3922	0	2	8	9
부산광역시	동래구	명장제2동	명장제2동제1투	4135	3292	843	5	3287	1992	1292	0	0	3	0
부산광역시	동래구	명장제2동	명장제2동제2투	3496	2719	777	7	2712	1657	1051	0	1	1	2
부산광역시	동래구	명장제2동	명장제2동제3투	3228	2460	768	4	2456	1586	863	0	1	2	4
부산광역시	동래구	명장제2동	명장제2동제4투	2655	2075	580	6	2069	1348	716	0	0	2	3
부산광역시	남구	계	계	240343	184999	55344	470	184529	111763	72244	44	72	226	180
부산광역시	남구	재외투표	재외투표	1209	810	399	3	807	352	452	1	0	2	0
부산광역시	남구	국내부재자투표	국내부재자투표	6061	5672	389	79	5593	2854	2687	7	12	11	22
부산광역시	남구	대연제1동	소계	12310	9300	3010	23	9277	5214	4037	2	4	10	10
부산광역시	남구	대연제1동	대연제1동제1투	4019	2940	1079	8	2932	1674	1253	1	1	2	1
부산광역시	남구	대연제1동	대연제1동제2투	4675	3578	1097	11	3567	1895	1664	1	1	3	3
부산광역시	남구	대연제1동	대연제1동제3투	3616	2782	834	4	2778	1645	1120	0	2	5	6
부산광역시	남구	대연제2동	소계	6080	4407	1673	13	4394	2841	1545	1	1	4	2
부산광역시	남구	대연제2동	대연제2동제1투	2721	1975	746	7	1968	1255	710	0	0	2	1
부산광역시	남구	대연제2동	대연제2동제2투	3359	2432	927	6	2426	1586	835	1	1	2	1
부산광역시	남구	대연제3동	소계	21931	16719	5212	41	16678	9508	7125	5	5	17	18
부산광역시	남구	대연제3동	대연제3동제1투	3861	2912	949	12	2900	1601	1287	1	1	5	5
부산광역시	남구	대연제3동	대연제3동제2투	4019	3192	827	6	3186	1852	1325	0	1	3	5
부산광역시	남구	대연제3동	대연제3동제3투	3194	2057	1137	5	2052	1122	926	0	0	1	3
부산광역시	남구	대연제3동	대연제3동제4투	3885	3007	878	8	2999	1760	1235	2	1	0	1
부산광역시	남구	대연제3동	대연제3동제5투	3322	2568	754	8	2560	1491	1058	1	1	7	2
부산광역시	남구	대연제3동	대연제3동제6투	3650	2983	667	2	2981	1682	1294	1	1	1	2
부산광역시	남구	대연제4동	소계	11648	8889	2759	26	8863	5441	3403	1	1	13	4
부산광역시	남구	대연제4동	대연제4동제1투	3131	2412	719	4	2408	1421	980	0	0	6	1
부산광역시	남구	대연제4동	대연제4동제2투	3528	2620	908	7	2613	1612	993	1	1	4	2
부산광역시	남구	대연제4동	대연제4동제3투	2059	1545	514	10	1535	966	567	0	0	2	0
부산광역시	남구	대연제4동	대연제4동제4투	2930	2312	618	5	2307	1442	863	0	0	1	1
부산광역시	남구	대연제5동	소계	12587	9624	2963	14	9610	5763	3819	3	4	17	4
부산광역시	남구	대연제5동	대연제5동제1투	4073	3103	970	7	3096	1894	1189	2	2	7	2
부산광역시	남구	대연제5동	대연제5동제2투	4302	3265	1037	2	3263	1991	1265	1	0	5	1
부산광역시	남구	대연제5동	대연제5동제3투	4212	3256	956	5	3251	1878	1365	0	2	5	1
부산광역시	남구	대연제6동	소계	9425	7260	2165	14	7246	4449	2781	1	2	7	6
부산광역시	남구	대연제6동	대연제6동제1투	2903	2077	826	6	2071	1307	754	0	1	5	4
부산광역시	남구	대연제6동	대연제6동제2투	3067	2499	568	1	2498	1534	962	1	0	0	1
부산광역시	남구	대연제6동	대연제6동제3투	3455	2684	771	7	2677	1608	1065	0	1	2	1
부산광역시	남구	용호제1동	소계	34322	27040	7282	58	26982	16701	10220	5	5	33	18
부산광역시	남구	용호제1동	용호제1동제1투	2977	2180	797	4	2176	1402	770	0	0	1	3
부산광역시	남구	용호제1동	용호제1동제2투	2858	1986	872	7	1979	1258	716	0	1	1	3
부산광역시	남구	용호제1동	용호제1동제3투	3062	2293	769	7	2286	1442	839	1	0	1	3
부산광역시	남구	용호제1동	용호제1동제4투	2387	1772	615	5	1767	1094	669	1	0	1	2
부산광역시	남구	용호제1동	용호제1동제5투	4274	3451	823	6	3445	1885	1546	1	1	7	5
부산광역시	남구	용호제1동	용호제1동제6투	4527	3690	837	9	3681	2223	1450	0	0	8	0
부산광역시	남구	용호제1동	용호제1동제7투	4185	3372	813	8	3364	2185	1174	0	2	3	0
부산광역시	남구	용호제1동	용호제1동제8투	4526	3708	818	3	3705	2408	1292	0	1	4	0
부산광역시	남구	용호제1동	용호제1동제9투	3007	2444	563	6	2438	1369	1063	2	0	3	1
부산광역시	남구	용호제1동	용호제1동제10투	2519	2144	375	3	2141	1435	701	0	0	4	1
부산광역시	남구	용호제2동	소계	16053	12372	3681	20	12352	7626	4690	3	3	19	11
부산광역시	남구	용호제2동	용호제2동제1투	3079	2299	780	8	2291	1465	816	1	0	4	5
부산광역시	남구	용호제2동	용호제2동제2투	2947	2179	768	2	2177	1455	714	1	2	3	2
부산광역시	남구	용호제2동	용호제2동제3투	4134	3182	952	8	3174	1955	1214	0	0	3	2
부산광역시	남구	용호제2동	용호제2동제4투	2600	2069	531	2	2067	1180	881	0	0	5	1
부산광역시	남구	용호제2동	용호제2동제5투	3293	2643	650	0	2643	1571	1065	1	1	4	1
부산광역시	남구	용호제3동	소계	12505	9678	2827	31	9647	6029	3598	1	6	7	6
부산광역시	남구	용호제3동	용호제3동제1투	3435	2711	724	10	2701	1640	1055	0	4	2	0
부산광역시	남구	용호제3동	용호제3동제2투	2825	2096	729	6	2090	1344	739	1	1	2	3
부산광역시	남구	용호제3동	용호제3동제3투	2963	2262	701	7	2255	1493	757	0	1	1	3
부산광역시	남구	용호제3동	용호제3동제4투	3282	2609	673	8	2601	1552	1047	0	0	2	0
부산광역시	남구	용호제4동	소계	6694	4986	1708	8	4978	2993	1970	1	1	5	8
부산광역시	남구	용호제4동	용호제4동제1투	3358	2464	894	3	2461	1473	980	0	0	3	5
부산광역시	남구	용호제4동	용호제4동제2투	3336	2522	814	5	2517	1520	990	1	1	2	3
부산광역시	남구	용당동	소계	7582	5996	1586	8	5988	3510	2460	1	2	10	5
부산광역시	남구	용당동	용당동제1투	1948	1408	540	1	1407	912	491	0	1	2	1
부산광역시	남구	용당동	용당동제2투	2266	1790	476	4	1786	1020	763	0	1	2	0
부산광역시	남구	용당동	용당동제3투	3368	2798	570	3	2795	1578	1206	1	0	6	4
부산광역시	남구	감만제1동	소계	14311	10800	3511	13	10787	6463	4299	4	4	6	11
부산광역시	남구	감만제1동	감만제1동제1투	2170	1505	665	2	1503	1009	493	0	0	0	1
부산광역시	남구	감만제1동	감만제1동제2투	3185	2423	762	3	2420	1425	989	0	1	2	3
부산광역시	남구	감만제1동	감만제1동제3투	2562	1869	693	2	1867	1252	613	0	0	0	2
부산광역시	남구	감만제1동	감만제1동제4투	2942	2206	736	4	2202	1298	894	3	0	2	5
부산광역시	남구	감만제1동	감만제1동제5투	3452	2797	655	2	2795	1479	1310	1	3	2	0
부산광역시	남구	감만제2동	소계	6770	5134	1636	18	5116	3238	1867	0	2	7	2
부산광역시	남구	감만제2동	감만제2동제1투	3065	2258	807	13	2245	1469	772	0	2	1	1
부산광역시	남구	감만제2동	감만제2동제2투	3705	2876	829	5	2871	1769	1095	0	0	6	1
부산광역시	남구	우암제1동	소계	11895	9504	2391	26	9478	5776	3673	1	6	13	9
부산광역시	남구	우암제1동	우암제1동제1투	3084	2448	636	5	2443	1480	954	0	1	3	5
부산광역시	남구	우암제1동	우암제1동제2투	3494	2956	538	6	2950	1738	1203	0	4	2	3
부산광역시	남구	우암제1동	우암제1동제3투	2059	1458	601	3	1455	994	457	1	0	3	0
부산광역시	남구	우암제1동	우암제1동제4투	3258	2642	616	12	2630	1564	1059	0	1	5	1
부산광역시	남구	우암제2동	소계	5050	3700	1350	8	3692	2446	1234	2	2	4	4
부산광역시	남구	우암제2동	우암제2동제1투	2504	1872	632	3	1869	1249	614	1	1	2	2
부산광역시	남구	우암제2동	우암제2동제2투	2546	1828	718	5	1823	1197	620	1	1	2	2
부산광역시	남구	문현제1동	소계	13608	10282	3326	20	10262	6301	3935	1	5	12	8
부산광역시	남구	문현제1동	문현제1동제1투	4054	3036	1018	5	3031	1919	1099	0	2	6	5
부산광역시	남구	문현제1동	문현제1동제2투	3268	2560	708	7	2553	1541	1007	0	0	3	2
부산광역시	남구	문현제1동	문현제1동제3투	3699	2835	864	6	2829	1682	1140	1	3	2	1
부산광역시	남구	문현제1동	문현제1동제4투	2587	1851	736	2	1849	1159	689	0	0	1	0
부산광역시	남구	문현제2동	소계	7916	5630	2286	10	5620	3720	1883	3	0	6	8
부산광역시	남구	문현제2동	문현제2동제1투	2748	1904	844	2	1902	1268	627	1	0	3	3
부산광역시	남구	문현제2동	문현제2동제2투	2113	1501	612	6	1495	1039	453	1	0	1	1
부산광역시	남구	문현제2동	문현제2동제3투	3055	2225	830	2	2223	1413	803	1	0	2	4
부산광역시	남구	문현제3동	소계	12042	9384	2658	17	9367	5674	3662	1	4	13	13
부산광역시	남구	문현제3동	문현제3동제1투	3658	2771	887	4	2767	1730	1025	0	2	4	6
부산광역시	남구	문현제3동	문현제3동제2투	3506	2664	842	3	2661	1649	1003	0	1	4	4
부산광역시	남구	문현제3동	문현제3동제3투	4878	3949	929	10	3939	2295	1634	1	1	5	3
부산광역시	남구	문현제4동	소계	10344	7812	2532	20	7792	4864	2904	0	3	10	11
부산광역시	남구	문현제4동	문현제4동제1투	3374	2605	769	10	2595	1617	971	0	0	2	5
부산광역시	남구	문현제4동	문현제4동제2투	4092	3112	980	4	3108	1880	1219	0	2	4	3
부산광역시	남구	문현제4동	문현제4동제3투	2878	2095	783	6	2089	1367	714	0	1	4	3
부산광역시	북구	계	계	250964	196487	54477	566	195921	111611	83710	45	99	251	205
부산광역시	북구	재외투표	재외투표	922	639	283	7	632	235	397	0	0	0	0
부산광역시	북구	국내부재자투표	국내부재자투표	6914	6503	411	99	6404	3074	3270	6	12	22	20
부산광역시	북구	구포제1동	소계	11520	8331	3189	25	8306	5259	3018	3	3	7	16
부산광역시	북구	구포제1동	구포제1동제1투	3019	2101	918	7	2094	1448	636	0	1	4	5
부산광역시	북구	구포제1동	구포제1동제2투	2645	1917	728	6	1911	1215	693	1	0	0	2
부산광역시	북구	구포제1동	구포제1동제3투	2841	2084	757	5	2079	1301	772	0	1	1	4
부산광역시	북구	구포제1동	구포제1동제4투	3015	2229	786	7	2222	1295	917	2	1	2	5
부산광역시	북구	구포제2동	소계	24479	18493	5986	49	18444	10709	7686	4	7	12	26
부산광역시	북구	구포제2동	구포제2동제1투	3402	2497	905	8	2489	1550	935	0	1	0	3
부산광역시	북구	구포제2동	구포제2동제2투	4092	2738	1354	11	2727	1727	992	0	0	2	6
부산광역시	북구	구포제2동	구포제2동제3투	3935	3062	873	8	3054	1748	1301	1	1	0	3
부산광역시	북구	구포제2동	구포제2동제4투	4123	3125	998	9	3116	1805	1300	2	3	3	3
부산광역시	북구	구포제2동	구포제2동제5투	4300	3542	758	6	3536	1962	1565	0	0	5	4
부산광역시	북구	구포제2동	구포제2동제6투	1949	1319	630	5	1314	800	509	0	0	1	4
부산광역시	북구	구포제2동	구포제2동제7투	2678	2210	468	2	2208	1117	1084	1	2	1	3
부산광역시	북구	구포제3동	소계	20882	15143	5739	36	15107	8833	6240	3	3	13	15
부산광역시	북구	구포제3동	구포제3동제1투	3316	2337	979	4	2333	1390	935	0	1	3	4
부산광역시	북구	구포제3동	구포제3동제2투	3296	2310	986	5	2305	1348	953	0	1	0	3
부산광역시	북구	구포제3동	구포제3동제3투	3555	2554	1001	7	2547	1479	1064	0	0	1	3
부산광역시	북구	구포제3동	구포제3동제4투	3615	2812	803	10	2802	1596	1198	3	0	3	2
부산광역시	북구	구포제3동	구포제3동제5투	3159	2319	840	3	2316	1402	911	0	1	2	0
부산광역시	북구	구포제3동	구포제3동제6투	3941	2811	1130	7	2804	1618	1179	0	0	4	3
부산광역시	북구	덕천제1동	소계	14681	11082	3599	27	11055	6675	4337	1	14	15	13
부산광역시	북구	덕천제1동	덕천제1동제1투	4170	3307	863	6	3301	1953	1336	0	4	6	2
부산광역시	북구	덕천제1동	덕천제1동제2투	3738	2745	993	8	2737	1687	1037	1	6	2	4
부산광역시	북구	덕천제1동	덕천제1동제3투	2686	1996	690	4	1992	1203	781	0	3	2	3
부산광역시	북구	덕천제1동	덕천제1동제4투	4087	3034	1053	9	3025	1832	1183	0	1	5	4
부산광역시	북구	덕천제2동	소계	12719	9512	3207	18	9494	5720	3754	1	3	8	8
부산광역시	북구	덕천제2동	덕천제2동제1투	3160	2330	830	5	2325	1408	915	0	1	0	1
부산광역시	북구	덕천제2동	덕천제2동제2투	3229	2381	848	4	2377	1411	964	0	0	1	1
부산광역시	북구	덕천제2동	덕천제2동제3투	3351	2560	791	4	2556	1451	1099	0	0	4	2
부산광역시	북구	덕천제2동	덕천제2동제4투	2979	2241	738	5	2236	1450	776	1	2	3	4
부산광역시	북구	덕천제3동	소계	11346	8426	2920	23	8403	5136	3240	1	3	11	12
부산광역시	북구	덕천제3동	덕천제3동제1투	3552	2740	812	5	2735	1529	1198	0	2	5	1
부산광역시	북구	덕천제3동	덕천제3동제2투	2279	1715	564	5	1710	1033	674	0	1	2	0
부산광역시	북구	덕천제3동	덕천제3동제3투	2886	2148	738	7	2141	1323	810	0	0	2	6
부산광역시	북구	덕천제3동	덕천제3동제4투	2629	1823	806	6	1817	1251	558	1	0	2	5
부산광역시	북구	만덕제1동	소계	10643	8251	2392	37	8214	4704	3487	4	4	7	8
부산광역시	북구	만덕제1동	만덕제1동제1투	2214	1681	533	10	1671	1014	648	2	2	3	2
부산광역시	북구	만덕제1동	만덕제1동제2투	2162	1520	642	11	1509	850	656	0	0	1	2
부산광역시	북구	만덕제1동	만덕제1동제3투	3136	2488	648	10	2478	1413	1058	2	0	2	3
부산광역시	북구	만덕제1동	만덕제1동제4투	3131	2562	569	6	2556	1427	1125	0	2	1	1
부산광역시	북구	만덕제2동	소계	18327	14053	4274	26	14027	8137	5842	5	4	21	18
부산광역시	북구	만덕제2동	만덕제2동제1투	2844	2132	712	4	2128	1323	796	0	0	4	5
부산광역시	북구	만덕제2동	만덕제2동제2투	2569	1888	681	4	1884	1147	724	3	1	4	5
부산광역시	북구	만덕제2동	만덕제2동제3투	3682	2799	883	9	2790	1616	1167	1	1	2	3
부산광역시	북구	만덕제2동	만덕제2동제4투	4251	3270	981	3	3267	1966	1291	1	1	5	3
부산광역시	북구	만덕제2동	만덕제2동제5투	4981	3964	1017	6	3958	2085	1864	0	1	6	2
부산광역시	북구	만덕제3동	소계	18089	14607	3482	32	14575	8239	6292	4	9	19	12
부산광역시	북구	만덕제3동	만덕제3동제1투	3269	2670	599	10	2660	1503	1144	1	4	6	2
부산광역시	북구	만덕제3동	만덕제3동제2투	3766	3087	679	3	3084	1786	1291	0	0	5	2
부산광역시	북구	만덕제3동	만덕제3동제3투	2934	2217	717	7	2210	1241	966	1	0	2	0
부산광역시	북구	만덕제3동	만덕제3동제4투	3894	3187	707	8	3179	1725	1445	2	3	0	4
부산광역시	북구	만덕제3동	만덕제3동제5투	4226	3446	780	4	3442	1984	1446	0	2	6	4
부산광역시	북구	금곡동	소계	32967	26023	6944	88	25935	14896	10967	3	13	33	23
부산광역시	북구	금곡동	금곡동제1투	1697	1249	448	3	1246	700	545	0	0	1	0
부산광역시	북구	금곡동	금곡동제2투	3037	2231	806	17	2214	1511	687	1	2	4	9
부산광역시	북구	금곡동	금곡동제3투	2152	1624	528	10	1614	1115	494	1	3	1	0
부산광역시	북구	금곡동	금곡동제4투	3337	2704	633	5	2699	1635	1056	0	2	3	3
부산광역시	북구	금곡동	금곡동제5투	3477	2837	640	12	2825	1625	1191	0	0	6	3
부산광역시	북구	금곡동	금곡동제6투	2900	2261	639	3	2258	1276	978	0	0	1	3
부산광역시	북구	금곡동	금곡동제7투	1971	1484	487	5	1479	1008	468	0	1	2	0
부산광역시	북구	금곡동	금곡동제8투	2304	1807	497	10	1797	951	839	0	2	5	0
부산광역시	북구	금곡동	금곡동제9투	3946	3017	929	9	3008	1745	1258	0	0	2	3
부산광역시	북구	금곡동	금곡동제10투	4037	3391	646	6	3385	1679	1697	0	3	6	0
부산광역시	북구	금곡동	금곡동제11투	4109	3418	691	8	3410	1651	1754	1	0	2	2
부산광역시	북구	화명제1동	소계	28389	23501	4888	40	23461	12625	10777	5	9	36	9
부산광역시	북구	화명제1동	화명제1동제1투	3792	3118	674	3	3115	1603	1501	2	2	5	2
부산광역시	북구	화명제1동	화명제1동제2투	4393	3657	736	7	3650	1943	1698	0	1	7	1
부산광역시	북구	화명제1동	화명제1동제3투	3569	2781	788	9	2772	1519	1242	1	1	7	2
부산광역시	북구	화명제1동	화명제1동제4투	2677	2165	512	2	2163	1141	1016	0	1	4	1
부산광역시	북구	화명제1동	화명제1동제5투	5074	4190	884	4	4186	2337	1843	0	1	3	2
부산광역시	북구	화명제1동	화명제1동제6투	2704	2336	368	3	2333	1286	1043	0	1	3	0
부산광역시	북구	화명제1동	화명제1동제7투	3247	2810	437	10	2800	1513	1279	1	1	5	1
부산광역시	북구	화명제1동	화명제1동제8투	2933	2444	489	2	2442	1283	1155	1	1	2	0
부산광역시	북구	화명제2동	소계	15515	12170	3345	25	12145	6700	5400	3	7	24	11
부산광역시	북구	화명제2동	화명제2동제1투	2947	2181	766	4	2177	1298	869	1	2	5	2
부산광역시	북구	화명제2동	화명제2동제2투	3193	2481	712	5	2476	1371	1094	0	1	8	2
부산광역시	북구	화명제2동	화명제2동제3투	3549	2869	680	4	2865	1532	1323	1	1	7	1
부산광역시	북구	화명제2동	화명제2동제4투	3022	2299	723	6	2293	1265	1021	1	1	2	3
부산광역시	북구	화명제2동	화명제2동제5투	2804	2340	464	6	2334	1234	1093	0	2	2	3
부산광역시	북구	화명제3동	소계	23571	19753	3818	34	19719	10669	9003	2	8	23	14
부산광역시	북구	화명제3동	화명제3동제1투	4426	3681	745	5	3676	2013	1652	0	1	7	3
부산광역시	북구	화명제3동	화명제3동제2투	2322	1964	358	3	1961	1033	926	1	0	1	0
부산광역시	북구	화명제3동	화명제3동제3투	3613	2961	652	6	2955	1628	1317	1	1	6	2
부산광역시	북구	화명제3동	화명제3동제4투	3282	2735	547	5	2730	1482	1243	0	1	3	1
부산광역시	북구	화명제3동	화명제3동제5투	1756	1479	277	4	1475	849	621	0	2	1	2
부산광역시	북구	화명제3동	화명제3동제6투	3978	3359	619	7	3352	1728	1615	0	2	2	5
부산광역시	북구	화명제3동	화명제3동제7투	4194	3574	620	4	3570	1936	1629	0	1	3	1
부산광역시	해운대구	계	계	340520	260066	80454	686	259380	155263	103287	53	93	443	241
부산광역시	해운대구	재외투표	재외투표	2010	1348	662	5	1343	573	764	0	2	3	1
부산광역시	해운대구	국내부재자투표	국내부재자투표	9122	8488	634	132	8356	4054	4219	5	17	26	35
부산광역시	해운대구	우제1동	소계	37613	28502	9111	53	28449	18701	9671	2	6	43	26
부산광역시	해운대구	우제1동	우제1동제1투	3326	2382	944	9	2373	1562	800	1	1	4	5
부산광역시	해운대구	우제1동	우제1동제2투	4263	3318	945	4	3314	1952	1349	0	0	8	5
부산광역시	해운대구	우제1동	우제1동제3투	3373	2434	939	6	2428	1622	799	0	0	3	4
부산광역시	해운대구	우제1동	우제1동제4투	3564	2237	1327	6	2231	1489	738	0	0	2	2
부산광역시	해운대구	우제1동	우제1동제5투	3773	3048	725	1	3047	1914	1122	0	3	5	3
부산광역시	해운대구	우제1동	우제1동제6투	3159	2598	561	7	2591	1658	929	0	0	2	2
부산광역시	해운대구	우제1동	우제1동제7투	4360	3541	819	9	3532	2245	1279	0	0	7	1
부산광역시	해운대구	우제1동	우제1동제8투	3041	2344	697	2	2342	1793	545	0	0	3	1
부산광역시	해운대구	우제1동	우제1동제9투	3942	2873	1069	4	2869	1978	886	0	0	3	2
부산광역시	해운대구	우제1동	우제1동제10투	4812	3727	1085	5	3722	2488	1224	1	2	6	1
부산광역시	해운대구	우제2동	소계	21286	16538	4748	26	16512	10324	6145	1	2	31	9
부산광역시	해운대구	우제2동	우제2동제1투	5216	4257	959	6	4251	2632	1605	0	0	11	3
부산광역시	해운대구	우제2동	우제2동제2투	3799	2822	977	8	2814	1726	1083	0	0	3	2
부산광역시	해운대구	우제2동	우제2동제3투	3134	2374	760	5	2369	1473	890	0	1	5	0
부산광역시	해운대구	우제2동	우제2동제4투	4754	3702	1052	5	3697	2163	1523	0	0	9	2
부산광역시	해운대구	우제2동	우제2동제5투	4383	3383	1000	2	3381	2330	1044	1	1	3	2
부산광역시	해운대구	중제1동	소계	17686	12993	4693	29	12964	8077	4852	0	2	25	8
부산광역시	해운대구	중제1동	중제1동제1투	4415	3031	1384	11	3020	2039	970	0	1	7	3
부산광역시	해운대구	중제1동	중제1동제2투	4273	3298	975	9	3289	2041	1243	0	0	4	1
부산광역시	해운대구	중제1동	중제1동제3투	4543	3341	1202	5	3336	2049	1280	0	0	6	1
부산광역시	해운대구	중제1동	중제1동제4투	4455	3323	1132	4	3319	1948	1359	0	1	8	3
부산광역시	해운대구	중제2동	소계	9449	6448	3001	19	6429	4004	2407	0	3	12	3
부산광역시	해운대구	중제2동	중제2동제1투	3247	2179	1068	5	2174	1342	826	0	1	4	1
부산광역시	해운대구	중제2동	중제2동제2투	3318	2194	1124	8	2186	1293	888	0	1	3	1
부산광역시	해운대구	중제2동	중제2동제3투	2884	2075	809	6	2069	1369	693	0	1	5	1
부산광역시	해운대구	좌제1동	소계	14140	11197	2943	27	11170	6374	4770	1	2	21	2
부산광역시	해운대구	좌제1동	좌제1동제1투	2755	1918	837	3	1915	1068	842	0	1	4	0
부산광역시	해운대구	좌제1동	좌제1동제2투	3306	2653	653	8	2645	1561	1078	0	1	5	0
부산광역시	해운대구	좌제1동	좌제1동제3투	3715	3017	698	7	3010	1633	1367	1	0	9	0
부산광역시	해운대구	좌제1동	좌제1동제4투	4364	3609	755	9	3600	2112	1483	0	0	3	2
부산광역시	해운대구	좌제2동	소계	25726	20075	5651	40	20035	11389	8574	3	4	43	22
부산광역시	해운대구	좌제2동	좌제2동제1투	5072	3440	1632	1	3439	1876	1549	0	0	10	4
부산광역시	해운대구	좌제2동	좌제2동제2투	2210	1832	378	2	1830	1111	712	0	1	6	0
부산광역시	해운대구	좌제2동	좌제2동제3투	4162	3329	833	12	3317	1831	1470	1	0	10	5
부산광역시	해운대구	좌제2동	좌제2동제4투	3480	2694	786	3	2691	1490	1196	0	1	1	3
부산광역시	해운대구	좌제2동	좌제2동제5투	3878	3138	740	8	3130	1821	1299	0	1	7	2
부산광역시	해운대구	좌제2동	좌제2동제6투	3533	2878	655	6	2872	1667	1196	2	0	3	4
부산광역시	해운대구	좌제2동	좌제2동제7투	3391	2764	627	8	2756	1593	1152	0	1	6	4
부산광역시	해운대구	좌제3동	소계	14209	11494	2715	20	11474	6769	4661	3	7	23	11
부산광역시	해운대구	좌제3동	좌제3동제1투	4084	3333	751	5	3328	2039	1270	0	4	9	6
부산광역시	해운대구	좌제3동	좌제3동제2투	2998	2366	632	4	2362	1380	976	1	0	3	2
부산광역시	해운대구	좌제3동	좌제3동제3투	3470	2774	696	5	2769	1538	1222	1	1	6	1
부산광역시	해운대구	좌제3동	좌제3동제4투	3657	3021	636	6	3015	1812	1193	1	2	5	2
부산광역시	해운대구	좌제4동	소계	18994	15460	3534	29	15431	8843	6527	6	3	40	12
부산광역시	해운대구	좌제4동	좌제4동제1투	3319	2629	690	4	2625	1453	1166	0	0	5	1
부산광역시	해운대구	좌제4동	좌제4동제2투	1708	1364	344	2	1362	729	631	0	0	1	1
부산광역시	해운대구	좌제4동	좌제4동제3투	3378	2736	642	3	2733	1498	1218	3	1	9	4
부산광역시	해운대구	좌제4동	좌제4동제4투	3884	3173	711	3	3170	1860	1297	0	0	11	2
부산광역시	해운대구	좌제4동	좌제4동제5투	3381	2799	582	10	2789	1683	1090	3	2	8	3
부산광역시	해운대구	좌제4동	좌제4동제6투	3324	2759	565	7	2752	1620	1125	0	0	6	1
부산광역시	해운대구	송정동	소계	8139	5886	2253	19	5867	3789	2060	1	2	11	4
부산광역시	해운대구	송정동	송정동제1투	4882	3518	1364	7	3511	2273	1228	1	1	6	2
부산광역시	해운대구	송정동	송정동제2투	3257	2368	889	12	2356	1516	832	0	1	5	2
부산광역시	해운대구	반여제1동	소계	32695	26127	6568	52	26075	14728	11273	5	9	44	16
부산광역시	해운대구	반여제1동	반여제1동제1투	3011	2215	796	7	2208	1380	821	0	3	2	2
부산광역시	해운대구	반여제1동	반여제1동제2투	3211	2384	827	6	2378	1487	885	2	1	1	2
부산광역시	해운대구	반여제1동	반여제1동제3투	4342	3354	988	3	3351	1929	1411	0	1	9	1
부산광역시	해운대구	반여제1동	반여제1동제4투	4340	3331	1009	5	3326	1997	1321	2	1	4	1
부산광역시	해운대구	반여제1동	반여제1동제5투	2311	1903	408	5	1898	1060	833	0	0	4	1
부산광역시	해운대구	반여제1동	반여제1동제6투	3267	2741	526	6	2735	1504	1221	1	2	3	4
부산광역시	해운대구	반여제1동	반여제1동제7투	2648	2219	429	3	2216	1162	1046	0	0	6	2
부산광역시	해운대구	반여제1동	반여제1동제8투	2629	2189	440	4	2185	1169	1009	0	0	7	0
부산광역시	해운대구	반여제1동	반여제1동제9투	3336	2787	549	7	2780	1514	1260	0	1	3	2
부산광역시	해운대구	반여제1동	반여제1동제10투	3600	3004	596	6	2998	1526	1466	0	0	5	1
부산광역시	해운대구	반여제2동	소계	14148	9762	4386	25	9737	6081	3624	4	4	14	10
부산광역시	해운대구	반여제2동	반여제2동제1투	2937	2072	865	2	2070	1377	686	1	0	2	4
부산광역시	해운대구	반여제2동	반여제2동제2투	3071	2176	895	4	2172	1311	857	0	2	2	0
부산광역시	해운대구	반여제2동	반여제2동제3투	2919	1849	1070	6	1843	1177	660	0	0	4	2
부산광역시	해운대구	반여제2동	반여제2동제4투	2961	2109	852	4	2105	1262	833	2	1	4	3
부산광역시	해운대구	반여제2동	반여제2동제5투	2260	1556	704	9	1547	954	588	1	1	2	1
부산광역시	해운대구	반여제3동	소계	10252	7204	3048	12	7192	4454	2716	2	4	9	7
부산광역시	해운대구	반여제3동	반여제3동제1투	3502	2470	1032	6	2464	1552	906	1	2	1	2
부산광역시	해운대구	반여제3동	반여제3동제2투	3096	2185	911	4	2181	1385	790	0	1	2	3
부산광역시	해운대구	반여제3동	반여제3동제3투	3654	2549	1105	2	2547	1517	1020	1	1	6	2
부산광역시	해운대구	반여제4동	소계	13114	10519	2595	21	10498	5946	4525	2	5	14	6
부산광역시	해운대구	반여제4동	반여제4동제1투	2654	2022	632	8	2014	1209	798	0	2	4	1
부산광역시	해운대구	반여제4동	반여제4동제2투	3545	2746	799	3	2743	1650	1088	1	0	1	3
부산광역시	해운대구	반여제4동	반여제4동제3투	3236	2740	496	5	2735	1513	1212	1	2	5	2
부산광역시	해운대구	반여제4동	반여제4동제4투	3679	3011	668	5	3006	1574	1427	0	1	4	0
부산광역시	해운대구	반송제1동	소계	9143	6326	2817	20	6306	4005	2277	2	2	8	12
부산광역시	해운대구	반송제1동	반송제1동제1투	2435	1683	752	5	1678	1053	617	0	2	2	4
부산광역시	해운대구	반송제1동	반송제1동제2투	1999	1381	618	7	1374	879	490	0	0	2	3
부산광역시	해운대구	반송제1동	반송제1동제3투	1915	1278	637	4	1274	793	477	0	0	2	2
부산광역시	해운대구	반송제1동	반송제1동제4투	2324	1639	685	3	1636	1032	599	1	0	2	2
부산광역시	해운대구	반송제1동	반송제1동제5투	470	345	125	1	344	248	94	1	0	0	1
부산광역시	해운대구	반송제2동	소계	25475	18788	6687	62	18726	11659	7015	4	9	16	23
부산광역시	해운대구	반송제2동	반송제2동제1투	3131	2344	787	6	2338	1553	781	0	0	4	0
부산광역시	해운대구	반송제2동	반송제2동제2투	4498	3300	1198	7	3293	1929	1357	1	1	1	4
부산광역시	해운대구	반송제2동	반송제2동제3투	2466	1658	808	10	1648	1054	587	0	2	0	5
부산광역시	해운대구	반송제2동	반송제2동제4투	1862	1335	527	6	1329	850	478	0	0	0	1
부산광역시	해운대구	반송제2동	반송제2동제5투	3988	3078	910	7	3071	1902	1161	0	1	5	2
부산광역시	해운대구	반송제2동	반송제2동제6투	3024	2109	915	9	2100	1354	740	1	0	3	2
부산광역시	해운대구	반송제2동	반송제2동제7투	2585	1894	691	9	1885	1312	568	0	1	0	4
부산광역시	해운대구	반송제2동	반송제2동제8투	3921	3070	851	8	3062	1705	1343	2	4	3	5
부산광역시	해운대구	반송제3동	소계	7721	5420	2301	32	5388	3467	1907	4	1	4	5
부산광역시	해운대구	반송제3동	반송제3동제1투	2052	1462	590	9	1453	922	527	3	0	1	0
부산광역시	해운대구	반송제3동	반송제3동제2투	2862	1972	890	11	1961	1301	655	0	0	2	3
부산광역시	해운대구	반송제3동	반송제3동제3투	2807	1986	821	12	1974	1244	725	1	1	1	2
부산광역시	해운대구	재송제1동	소계	24055	18683	5372	17	18666	10985	7624	3	6	32	16
부산광역시	해운대구	재송제1동	재송제1동제1투	3744	2814	930	3	2811	1679	1125	0	1	3	3
부산광역시	해운대구	재송제1동	재송제1동제2투	3565	2628	937	2	2626	1639	982	1	1	0	3
부산광역시	해운대구	재송제1동	재송제1동제3투	3863	2892	971	4	2888	1757	1119	1	0	7	4
부산광역시	해운대구	재송제1동	재송제1동제4투	3215	2532	683	3	2529	1303	1218	0	2	2	4
부산광역시	해운대구	재송제1동	재송제1동제5투	5191	4186	1005	0	4186	2379	1790	0	1	15	1
부산광역시	해운대구	재송제1동	재송제1동제6투	4477	3631	846	5	3626	2228	1390	1	1	5	1
부산광역시	해운대구	재송제2동	소계	25543	18808	6735	46	18762	11041	7676	5	3	24	13
부산광역시	해운대구	재송제2동	재송제2동제1투	3166	2270	896	8	2262	1376	881	2	0	2	1
부산광역시	해운대구	재송제2동	재송제2동제2투	3032	2201	831	10	2191	1280	909	0	1	1	0
부산광역시	해운대구	재송제2동	재송제2동제3투	3581	2513	1068	5	2508	1433	1064	1	1	5	4
부산광역시	해운대구	재송제2동	재송제2동제4투	3321	2472	849	3	2469	1500	961	0	0	6	2
부산광역시	해운대구	재송제2동	재송제2동제5투	2824	2080	744	7	2073	1184	884	0	0	1	4
부산광역시	해운대구	재송제2동	재송제2동제6투	2705	1942	763	3	1939	1165	772	1	0	1	0
부산광역시	해운대구	재송제2동	재송제2동제7투	3612	2772	840	10	2762	1612	1143	0	1	5	1
부산광역시	해운대구	재송제2동	재송제2동제8투	3302	2558	744	0	2558	1491	1062	1	0	3	1
부산광역시	기장군	계	계	89141	67694	21447	245	67449	41164	26084	17	24	77	83
부산광역시	기장군	재외투표	재외투표	377	253	124	3	250	127	122	0	0	1	0
부산광역시	기장군	국내부재자투표	국내부재자투표	2190	2032	158	40	1992	1058	919	6	2	1	6
부산광역시	기장군	기장읍	소계	41760	31358	10402	97	31261	19773	11406	2	12	43	25
부산광역시	기장군	기장읍	기장읍제1투	5733	3858	1875	8	3850	2517	1327	0	0	2	4
부산광역시	기장군	기장읍	기장읍제2투	4704	3476	1228	4	3472	2110	1355	0	1	3	3
부산광역시	기장군	기장읍	기장읍제3투	3719	2996	723	10	2986	1626	1347	0	2	8	3
부산광역시	기장군	기장읍	기장읍제4투	4611	3388	1223	6	3382	2085	1282	2	2	7	4
부산광역시	기장군	기장읍	기장읍제5투	5203	4083	1120	11	4072	2437	1626	0	1	5	3
부산광역시	기장군	기장읍	기장읍제6투	4537	3324	1213	11	3313	1994	1311	0	2	5	1
부산광역시	기장군	기장읍	기장읍제7투	3960	3023	937	7	3016	1981	1023	0	2	8	2
부산광역시	기장군	기장읍	기장읍제8투	2331	1678	653	14	1664	1113	547	0	1	2	1
부산광역시	기장군	기장읍	기장읍제9투	1941	1406	535	8	1398	987	407	0	1	1	2
부산광역시	기장군	기장읍	기장읍제10투	3226	2563	663	7	2556	1540	1012	0	0	2	2
부산광역시	기장군	기장읍	기장읍제11투	794	603	191	11	592	435	157	0	0	0	0
부산광역시	기장군	기장읍	기장읍제12투	1001	960	41	0	960	948	12	0	0	0	0
부산광역시	기장군	장안읍	소계	8234	6120	2114	29	6091	4173	1891	4	1	4	18
부산광역시	기장군	장안읍	장안읍제1투	2060	1459	601	5	1454	1021	425	1	1	2	4
부산광역시	기장군	장안읍	장안읍제2투	981	739	242	8	731	560	168	1	0	1	1
부산광역시	기장군	장안읍	장안읍제3투	735	560	175	2	558	404	150	0	0	0	4
부산광역시	기장군	장안읍	장안읍제4투	1495	1038	457	4	1034	712	318	2	0	0	2
부산광역시	기장군	장안읍	장안읍제5투	1946	1478	468	8	1470	1064	399	0	0	1	6
부산광역시	기장군	장안읍	장안읍제6투	1017	846	171	2	844	412	431	0	0	0	1
부산광역시	기장군	일광면	소계	8012	5934	2078	25	5909	4126	1763	1	4	2	13
부산광역시	기장군	일광면	일광면제1투	1947	1376	571	4	1372	960	410	0	0	0	2
부산광역시	기장군	일광면	일광면제2투	1996	1483	513	4	1479	1079	394	1	0	0	5
부산광역시	기장군	일광면	일광면제3투	589	422	167	7	415	317	95	0	2	1	0
부산광역시	기장군	일광면	일광면제4투	776	611	165	2	609	423	184	0	0	0	2
부산광역시	기장군	일광면	일광면제5투	2704	2042	662	8	2034	1347	680	0	2	1	4
부산광역시	기장군	정관면	소계	22646	17455	5191	37	17418	8962	8417	3	3	22	11
부산광역시	기장군	정관면	정관면제1투	5638	4052	1586	12	4040	2151	1881	0	2	3	3
부산광역시	기장군	정관면	정관면제2투	3431	2608	823	5	2603	1343	1254	0	0	4	2
부산광역시	기장군	정관면	정관면제3투	781	626	155	0	626	433	186	2	0	1	4
부산광역시	기장군	정관면	정관면제4투	3146	2609	537	5	2604	1236	1365	0	1	2	0
부산광역시	기장군	정관면	정관면제5투	2606	2159	447	0	2159	1039	1111	0	0	7	2
부산광역시	기장군	정관면	정관면제6투	3093	2396	697	6	2390	1284	1102	1	0	3	0
부산광역시	기장군	정관면	정관면제7투	3951	3005	946	9	2996	1476	1518	0	0	2	0
부산광역시	기장군	철마면	소계	5922	4542	1380	14	4528	2945	1566	1	2	4	10
부산광역시	기장군	철마면	철마면제1투	1802	1380	422	3	1377	971	396	1	1	0	8
부산광역시	기장군	철마면	철마면제2투	1527	1214	313	6	1208	704	501	0	0	3	0
부산광역시	기장군	철마면	철마면제3투	2593	1948	645	5	1943	1270	669	0	1	1	2
부산광역시	사하구	계	계	286161	215739	70422	700	215039	125432	89012	64	83	245	203
부산광역시	사하구	재외투표	재외투표	1263	877	386	6	871	356	511	0	0	3	1
부산광역시	사하구	국내부재자투표	국내부재자투표	6858	6392	466	97	6295	3059	3181	9	5	16	25
부산광역시	사하구	괴정제1동	소계	17259	13236	4023	46	13190	8047	5121	4	4	6	8
부산광역시	사하구	괴정제1동	괴정제1동제1투	3618	2808	810	10	2798	1675	1119	0	1	1	2
부산광역시	사하구	괴정제1동	괴정제1동제2투	3762	2827	935	5	2822	1771	1049	0	1	0	1
부산광역시	사하구	괴정제1동	괴정제1동제3투	2864	2142	722	12	2130	1333	792	0	1	3	1
부산광역시	사하구	괴정제1동	괴정제1동제4투	3376	2565	811	13	2552	1589	954	4	1	1	3
부산광역시	사하구	괴정제1동	괴정제1동제5투	3639	2894	745	6	2888	1679	1207	0	0	1	1
부산광역시	사하구	괴정제2동	소계	14034	10399	3635	41	10358	6226	4109	3	5	8	7
부산광역시	사하구	괴정제2동	괴정제2동제1투	3745	2664	1081	11	2653	1610	1039	0	2	0	2
부산광역시	사하구	괴정제2동	괴정제2동제2투	4022	3088	934	13	3075	1828	1241	1	1	1	3
부산광역시	사하구	괴정제2동	괴정제2동제3투	3030	2201	829	9	2192	1335	852	0	0	5	0
부산광역시	사하구	괴정제2동	괴정제2동제4투	3237	2446	791	8	2438	1453	977	2	2	2	2
부산광역시	사하구	괴정제3동	소계	12395	9002	3393	62	8940	5503	3407	7	4	11	8
부산광역시	사하구	괴정제3동	괴정제3동제1투	3664	2684	980	29	2655	1587	1057	5	2	2	2
부산광역시	사하구	괴정제3동	괴정제3동제2투	4153	2974	1179	18	2956	1884	1060	2	2	5	3
부산광역시	사하구	괴정제3동	괴정제3동제3투	4578	3344	1234	15	3329	2032	1290	0	0	4	3
부산광역시	사하구	괴정제4동	소계	13368	10042	3326	44	9998	6148	3820	7	7	15	1
부산광역시	사하구	괴정제4동	괴정제4동제1투	3607	2738	869	10	2728	1609	1113	4	1	1	0
부산광역시	사하구	괴정제4동	괴정제4동제2투	3713	2784	929	14	2770	1723	1036	2	3	6	0
부산광역시	사하구	괴정제4동	괴정제4동제3투	2932	2234	698	8	2226	1423	795	1	2	4	1
부산광역시	사하구	괴정제4동	괴정제4동제4투	3116	2286	830	12	2274	1393	876	0	1	4	0
부산광역시	사하구	당리동	소계	24185	18694	5491	35	18659	10674	7943	1	6	23	12
부산광역시	사하구	당리동	당리동제1투	4692	3770	922	4	3766	1980	1776	1	1	7	1
부산광역시	사하구	당리동	당리동제2투	4615	3455	1160	5	3450	1934	1510	0	1	3	2
부산광역시	사하구	당리동	당리동제3투	4856	3742	1114	5	3737	2223	1505	0	0	7	2
부산광역시	사하구	당리동	당리동제4투	3621	2752	869	9	2743	1558	1178	0	1	4	2
부산광역시	사하구	당리동	당리동제5투	3109	2343	766	5	2338	1432	899	0	3	0	4
부산광역시	사하구	당리동	당리동제6투	3292	2632	660	7	2625	1547	1075	0	0	2	1
부산광역시	사하구	하단제1동	소계	18979	14560	4419	29	14531	8353	6132	2	7	19	18
부산광역시	사하구	하단제1동	하단제1동제1투	3512	2694	818	6	2688	1561	1124	0	0	0	3
부산광역시	사하구	하단제1동	하단제1동제2투	3281	2270	1011	8	2262	1309	945	0	3	1	4
부산광역시	사하구	하단제1동	하단제1동제3투	4458	3212	1246	4	3208	1783	1413	2	2	3	5
부산광역시	사하구	하단제1동	하단제1동제4투	4227	3463	764	4	3459	2038	1412	0	1	5	3
부산광역시	사하구	하단제1동	하단제1동제5투	3501	2921	580	7	2914	1662	1238	0	1	10	3
부산광역시	사하구	하단제2동	소계	21917	16662	5255	33	16629	9336	7250	4	5	18	16
부산광역시	사하구	하단제2동	하단제2동제1투	5034	3834	1200	3	3831	2172	1645	1	1	7	5
부산광역시	사하구	하단제2동	하단제2동제2투	4435	3364	1071	10	3354	1881	1463	3	1	4	2
부산광역시	사하구	하단제2동	하단제2동제3투	3451	2396	1055	5	2391	1395	992	0	0	1	3
부산광역시	사하구	하단제2동	하단제2동제4투	4529	3429	1100	8	3421	1980	1430	0	2	5	4
부산광역시	사하구	하단제2동	하단제2동제5투	4468	3639	829	7	3632	1908	1720	0	1	1	2
부산광역시	사하구	신평제1동	소계	16125	11459	4666	39	11420	6814	4563	0	7	21	15
부산광역시	사하구	신평제1동	신평제1동제1투	3704	2815	889	8	2807	1655	1147	0	1	2	2
부산광역시	사하구	신평제1동	신평제1동제2투	4164	2902	1262	10	2892	1715	1165	0	2	4	6
부산광역시	사하구	신평제1동	신평제1동제3투	4354	2841	1513	10	2831	1696	1123	0	0	7	5
부산광역시	사하구	신평제1동	신평제1동제4투	3903	2901	1002	11	2890	1748	1128	0	4	8	2
부산광역시	사하구	신평제2동	소계	12991	10022	2969	23	9999	5608	4372	2	4	7	6
부산광역시	사하구	신평제2동	신평제2동제1투	3820	2637	1183	10	2627	1464	1160	1	1	0	1
부산광역시	사하구	신평제2동	신평제2동제2투	4265	3422	843	7	3415	1913	1496	0	1	4	1
부산광역시	사하구	신평제2동	신평제2동제3투	2338	1903	435	5	1898	1105	789	0	1	1	2
부산광역시	사하구	신평제2동	신평제2동제4투	2568	2060	508	1	2059	1126	927	1	1	2	2
부산광역시	사하구	장림제1동	소계	11634	8318	3316	19	8299	4793	3485	1	3	7	10
부산광역시	사하구	장림제1동	장림제1동제1투	3930	2571	1359	3	2568	1593	964	0	1	5	5
부산광역시	사하구	장림제1동	장림제1동제2투	3657	2560	1097	11	2549	1592	949	1	1	1	5
부산광역시	사하구	장림제1동	장림제1동제3투	4047	3187	860	5	3182	1608	1572	0	1	1	0
부산광역시	사하구	장림제2동	소계	23961	17798	6163	46	17752	9939	7769	2	8	22	12
부산광역시	사하구	장림제2동	장림제2동제1투	3457	2288	1169	8	2280	1443	827	1	2	5	2
부산광역시	사하구	장림제2동	장림제2동제2투	4429	3358	1071	9	3349	1761	1585	0	1	0	2
부산광역시	사하구	장림제2동	장림제2동제3투	3629	2776	853	2	2774	1547	1220	0	1	4	2
부산광역시	사하구	장림제2동	장림제2동제4투	4159	3228	931	8	3220	1871	1344	0	1	2	2
부산광역시	사하구	장림제2동	장림제2동제5투	4197	3105	1092	14	3091	1769	1312	1	3	4	2
부산광역시	사하구	장림제2동	장림제2동제6투	4090	3043	1047	5	3038	1548	1481	0	0	7	2
부산광역시	사하구	다대제1동	소계	34426	26048	8378	64	25984	14859	11077	6	6	20	16
부산광역시	사하구	다대제1동	다대제1동제1투	4066	2881	1185	8	2873	1658	1210	2	0	2	1
부산광역시	사하구	다대제1동	다대제1동제2투	3647	2634	1013	6	2628	1527	1097	0	0	2	2
부산광역시	사하구	다대제1동	다대제1동제3투	2341	1657	684	6	1651	1040	609	1	0	0	1
부산광역시	사하구	다대제1동	다대제1동제4투	3014	2403	611	10	2393	1404	986	0	0	1	2
부산광역시	사하구	다대제1동	다대제1동제5투	3488	2550	938	7	2543	1445	1097	0	1	0	0
부산광역시	사하구	다대제1동	다대제1동제6투	2757	2024	733	6	2018	1037	976	1	1	2	1
부산광역시	사하구	다대제1동	다대제1동제7투	3346	2699	647	6	2693	1681	1008	0	1	2	1
부산광역시	사하구	다대제1동	다대제1동제8투	2328	1661	667	5	1656	1104	543	1	1	3	4
부산광역시	사하구	다대제1동	다대제1동제9투	2053	1533	520	2	1531	826	700	0	0	3	2
부산광역시	사하구	다대제1동	다대제1동제10투	4219	3420	799	3	3417	1736	1675	1	0	3	2
부산광역시	사하구	다대제1동	다대제1동제11투	3167	2586	581	5	2581	1401	1176	0	2	2	0
부산광역시	사하구	다대제2동	소계	22844	17380	5464	55	17325	10232	7039	7	6	24	17
부산광역시	사하구	다대제2동	다대제2동제1투	2754	2262	492	1	2261	1304	953	0	0	3	1
부산광역시	사하구	다대제2동	다대제2동제2투	2861	2300	561	7	2293	1364	925	0	0	3	1
부산광역시	사하구	다대제2동	다대제2동제3투	3583	2637	946	13	2624	1633	980	1	2	5	3
부산광역시	사하구	다대제2동	다대제2동제4투	3513	2578	935	5	2573	1358	1208	1	2	2	2
부산광역시	사하구	다대제2동	다대제2동제5투	2441	1839	602	3	1836	1106	727	0	0	3	0
부산광역시	사하구	다대제2동	다대제2동제6투	4172	3299	873	6	3293	1877	1404	2	1	6	3
부산광역시	사하구	다대제2동	다대제2동제7투	3520	2465	1055	20	2445	1590	842	3	1	2	7
부산광역시	사하구	구평동	소계	5376	4117	1259	9	4108	2602	1495	3	0	5	3
부산광역시	사하구	구평동	구평동제1투	2597	1998	599	4	1994	1178	811	1	0	1	3
부산광역시	사하구	구평동	구평동제2투	2191	1696	495	4	1692	1116	570	2	0	4	0
부산광역시	사하구	구평동	구평동제3투	588	423	165	1	422	308	114	0	0	0	0
부산광역시	사하구	감천제1동	소계	20217	15034	5183	34	15000	9066	5899	5	3	13	14
부산광역시	사하구	감천제1동	감천제1동제1투	4494	3211	1283	8	3203	2009	1186	0	2	1	5
부산광역시	사하구	감천제1동	감천제1동제2투	3836	2504	1332	9	2495	1605	885	1	0	2	2
부산광역시	사하구	감천제1동	감천제1동제3투	2624	1971	653	8	1963	1210	747	1	0	2	3
부산광역시	사하구	감천제1동	감천제1동제4투	2593	2091	502	5	2086	1213	864	2	1	4	2
부산광역시	사하구	감천제1동	감천제1동제5투	3173	2500	673	1	2499	1427	1068	1	0	2	1
부산광역시	사하구	감천제1동	감천제1동제6투	3497	2757	740	3	2754	1602	1149	0	0	2	1
부산광역시	사하구	감천제2동	소계	8329	5699	2630	18	5681	3817	1839	1	3	7	14
부산광역시	사하구	감천제2동	감천제2동제1투	3047	2134	913	7	2127	1410	711	0	2	0	4
부산광역시	사하구	감천제2동	감천제2동제2투	2918	1880	1038	7	1873	1271	592	0	0	5	5
부산광역시	사하구	감천제2동	감천제2동제3투	2364	1685	679	4	1681	1136	536	1	1	2	5
부산광역시	사하구	잘못 투입·구분된 투표지	잘못 투입·구분된 투표지	0	0	0	0	0	0	0	0	0	0	0
부산광역시	금정구	계	계	212193	164536	47657	473	164063	100400	63126	50	75	235	177
부산광역시	금정구	재외투표	재외투표	1093	787	306	7	780	298	480	0	0	1	1
부산광역시	금정구	국내부재자투표	국내부재자투표	5864	5423	441	62	5361	2547	2769	7	9	11	18
부산광역시	금정구	서제1동	소계	8064	5578	2486	18	5560	3688	1846	1	2	8	15
부산광역시	금정구	서제1동	서제1동제1투	2862	1934	928	5	1929	1309	608	1	0	5	6
부산광역시	금정구	서제1동	서제1동제2투	2457	1767	690	10	1757	1178	570	0	1	3	5
부산광역시	금정구	서제1동	서제1동제3투	2745	1877	868	3	1874	1201	668	0	1	0	4
부산광역시	금정구	서제2동	소계	11388	8158	3230	23	8135	5234	2873	1	3	9	15
부산광역시	금정구	서제2동	서제2동제1투	4194	3040	1154	6	3034	1929	1100	1	0	0	4
부산광역시	금정구	서제2동	서제2동제2투	3862	2651	1211	7	2644	1720	909	0	2	7	6
부산광역시	금정구	서제2동	서제2동제3투	3332	2467	865	10	2457	1585	864	0	1	2	5
부산광역시	금정구	서제3동	소계	11759	8746	3013	15	8731	5589	3112	4	7	5	14
부산광역시	금정구	서제3동	서제3동제1투	2776	2147	629	4	2143	1388	749	0	1	2	3
부산광역시	금정구	서제3동	서제3동제2투	3235	2458	777	4	2454	1521	929	0	1	0	3
부산광역시	금정구	서제3동	서제3동제3투	3135	2130	1005	3	2127	1407	711	1	3	1	4
부산광역시	금정구	서제3동	서제3동제4투	2613	2011	602	4	2007	1273	723	3	2	2	4
부산광역시	금정구	금사동	소계	8617	6346	2271	10	6336	4175	2136	4	6	6	9
부산광역시	금정구	금사동	금사동제1투	3097	2321	776	3	2318	1529	783	2	2	0	2
부산광역시	금정구	금사동	금사동제2투	3091	2217	874	4	2213	1447	757	0	2	3	4
부산광역시	금정구	금사동	금사동제3투	2429	1808	621	3	1805	1199	596	2	2	3	3
부산광역시	금정구	부곡제1동	소계	9375	6990	2385	23	6967	4489	2452	4	2	12	8
부산광역시	금정구	부곡제1동	부곡제1동제1투	2607	1952	655	7	1945	1227	714	0	0	3	1
부산광역시	금정구	부곡제1동	부곡제1동제2투	4408	3264	1144	6	3258	2135	1107	2	2	7	5
부산광역시	금정구	부곡제1동	부곡제1동제3투	2360	1774	586	10	1764	1127	631	2	0	2	2
부산광역시	금정구	부곡제2동	소계	14672	11703	2969	21	11682	7065	4584	2	6	20	5
부산광역시	금정구	부곡제2동	부곡제2동제1투	2433	1873	560	6	1867	1145	719	0	1	1	1
부산광역시	금정구	부곡제2동	부곡제2동제2투	3180	2407	773	5	2402	1544	850	0	4	2	2
부산광역시	금정구	부곡제2동	부곡제2동제3투	4888	3887	1001	5	3882	2288	1585	2	0	6	1
부산광역시	금정구	부곡제2동	부곡제2동제4투	4171	3536	635	5	3531	2088	1430	0	1	11	1
부산광역시	금정구	부곡제3동	소계	14311	11394	2917	29	11365	6877	4455	5	7	16	5
부산광역시	금정구	부곡제3동	부곡제3동제1투	3011	2196	815	7	2189	1356	827	2	2	2	0
부산광역시	금정구	부곡제3동	부곡제3동제2투	2860	2190	670	10	2180	1355	816	0	1	7	1
부산광역시	금정구	부곡제3동	부곡제3동제3투	4268	3585	683	8	3577	2108	1460	0	1	6	2
부산광역시	금정구	부곡제3동	부곡제3동제4투	4172	3423	749	4	3419	2058	1352	3	3	1	2
부산광역시	금정구	부곡제4동	소계	13197	10021	3176	22	9999	6120	3843	5	4	18	9
부산광역시	금정구	부곡제4동	부곡제4동제1투	3904	3007	897	5	3002	1728	1262	1	0	8	3
부산광역시	금정구	부곡제4동	부곡제4동제2투	3211	2523	688	10	2513	1551	950	2	1	6	3
부산광역시	금정구	부곡제4동	부곡제4동제3투	2974	2093	881	4	2089	1364	717	2	1	2	3
부산광역시	금정구	부곡제4동	부곡제4동제4투	3108	2398	710	3	2395	1477	914	0	2	2	0
부산광역시	금정구	장전제1동	소계	12768	9780	2988	27	9753	5395	4320	1	7	15	15
부산광역시	금정구	장전제1동	장전제1동제1투	3418	2547	871	8	2539	1369	1159	0	3	3	5
부산광역시	금정구	장전제1동	장전제1동제2투	3476	2728	748	2	2726	1435	1278	1	2	5	5
부산광역시	금정구	장전제1동	장전제1동제3투	3153	2374	779	5	2369	1385	977	0	1	4	2
부산광역시	금정구	장전제1동	장전제1동제4투	2721	2131	590	12	2119	1206	906	0	1	3	3
부산광역시	금정구	장전제2동	소계	11033	8506	2527	23	8483	4888	3572	1	0	16	6
부산광역시	금정구	장전제2동	장전제2동제1투	3389	2410	979	13	2397	1464	925	0	0	5	3
부산광역시	금정구	장전제2동	장전제2동제2투	4119	3209	910	7	3202	1920	1275	1	0	4	2
부산광역시	금정구	장전제2동	장전제2동제3투	3525	2887	638	3	2884	1504	1372	0	0	7	1
부산광역시	금정구	장전제3동	소계	7321	5387	1934	16	5371	3438	1919	2	1	4	7
부산광역시	금정구	장전제3동	장전제3동제1투	3351	2395	956	9	2386	1504	878	1	0	0	3
부산광역시	금정구	장전제3동	장전제3동제2투	3970	2992	978	7	2985	1934	1041	1	1	4	4
부산광역시	금정구	선두구동	소계	2425	1851	574	10	1841	1363	471	0	0	1	6
부산광역시	금정구	선두구동	선두구동투표소	2425	1851	574	10	1841	1363	471	0	0	1	6
부산광역시	금정구	청룡노포동	소계	8175	6365	1810	8	6357	4241	2092	2	4	11	7
부산광역시	금정구	청룡노포동	청룡노포동제1투	3078	2340	738	5	2335	1527	798	1	1	8	0
부산광역시	금정구	청룡노포동	청룡노포동제2투	4143	3315	828	3	3312	2218	1082	1	2	2	7
부산광역시	금정구	청룡노포동	청룡노포동제3투	954	710	244	0	710	496	212	0	1	1	0
부산광역시	금정구	남산동	소계	27811	21584	6227	65	21519	13299	8157	5	8	34	16
부산광역시	금정구	남산동	남산동제1투	3534	2739	795	12	2727	1741	975	0	1	7	3
부산광역시	금정구	남산동	남산동제2투	3743	2866	877	12	2854	1723	1126	1	1	2	1
부산광역시	금정구	남산동	남산동제3투	3969	3153	816	9	3144	1882	1251	1	1	7	2
부산광역시	금정구	남산동	남산동제4투	4185	3272	913	7	3265	2033	1225	1	1	2	3
부산광역시	금정구	남산동	남산동제5투	3929	3053	876	10	3043	1941	1091	1	2	5	3
부산광역시	금정구	남산동	남산동제6투	5147	3898	1249	13	3885	2433	1441	0	1	7	3
부산광역시	금정구	남산동	남산동제7투	3304	2603	701	2	2601	1546	1048	1	1	4	1
부산광역시	금정구	구서제1동	소계	15526	12394	3132	29	12365	7261	5073	2	4	15	10
부산광역시	금정구	구서제1동	구서제1동제1투	4059	3273	786	8	3265	1948	1308	0	2	3	4
부산광역시	금정구	구서제1동	구서제1동제2투	4457	3466	991	12	3454	2109	1335	1	1	6	2
부산광역시	금정구	구서제1동	구서제1동제3투	3431	2846	585	3	2843	1654	1185	1	0	3	0
부산광역시	금정구	구서제1동	구서제1동제4투	3579	2809	770	6	2803	1550	1245	0	1	3	4
부산광역시	금정구	구서제2동	소계	27780	22685	5095	60	22625	13873	8700	4	4	33	11
부산광역시	금정구	구서제2동	구서제2동제1투	3855	2853	1002	9	2844	1758	1078	1	0	4	3
부산광역시	금정구	구서제2동	구서제2동제2투	3762	3096	666	7	3089	1967	1116	1	0	4	1
부산광역시	금정구	구서제2동	구서제2동제3투	3747	2923	824	9	2914	1781	1123	2	1	4	3
부산광역시	금정구	구서제2동	구서제2동제4투	3752	3074	678	5	3069	1893	1170	0	1	5	0
부산광역시	금정구	구서제2동	구서제2동제5투	4275	3535	740	18	3517	1977	1533	0	1	5	1
부산광역시	금정구	구서제2동	구서제2동제6투	3960	3410	550	6	3404	1947	1447	0	1	8	1
부산광역시	금정구	구서제2동	구서제2동제7투	4429	3794	635	6	3788	2550	1233	0	0	3	2
부산광역시	금정구	금성동	소계	1014	838	176	5	833	560	272	0	1	0	0
부산광역시	금정구	금성동	금성동투표소	1014	838	176	5	833	560	272	0	1	0	0
부산광역시	금정구	잘못 투입·구분된 투표지	잘못 투입·구분된 투표지	0	0	0	0	0	0	0	0	0	0	0
부산광역시	강서구	계	계	54683	41319	13364	144	41175	24560	16494	9	13	32	67
부산광역시	강서구	재외투표	재외투표	335	238	97	0	238	121	116	0	0	0	1
부산광역시	강서구	국내부재자투표	국내부재자투표	1183	1099	84	20	1079	543	531	1	1	0	3
부산광역시	강서구	대저1동	소계	8492	6110	2382	26	6084	3928	2139	2	0	4	11
부산광역시	강서구	대저1동	대저1동제1투	1944	1287	657	6	1281	802	475	1	0	1	2
부산광역시	강서구	대저1동	대저1동제2투	1927	1461	466	5	1456	976	479	0	0	0	1
부산광역시	강서구	대저1동	대저1동제3투	1940	1400	540	8	1392	912	474	1	0	2	3
부산광역시	강서구	대저1동	대저1동제4투	1457	1081	376	2	1079	719	357	0	0	0	3
부산광역시	강서구	대저1동	대저1동제5투	1224	881	343	5	876	519	354	0	0	1	2
부산광역시	강서구	대저2동	소계	7425	5653	1772	15	5638	3344	2272	1	4	6	11
부산광역시	강서구	대저2동	대저2동제1투	2280	1718	562	3	1715	968	742	0	1	2	2
부산광역시	강서구	대저2동	대저2동제2투	1753	1324	429	4	1320	790	526	0	0	1	3
부산광역시	강서구	대저2동	대저2동제3투	1773	1351	422	4	1347	791	549	1	1	2	3
부산광역시	강서구	대저2동	대저2동제4투	1619	1260	359	4	1256	795	455	0	2	1	3
부산광역시	강서구	강동동	소계	6329	4622	1707	12	4610	2862	1732	0	2	3	11
부산광역시	강서구	강동동	강동동제1투	1408	1029	379	1	1028	623	397	0	1	2	5
부산광역시	강서구	강동동	강동동제2투	1350	979	371	3	976	579	393	0	1	0	3
부산광역시	강서구	강동동	강동동제3투	1800	1366	434	4	1362	897	462	0	0	0	3
부산광역시	강서구	강동동	강동동제4투	1771	1248	523	4	1244	763	480	0	0	1	0
부산광역시	강서구	명지동	소계	16894	13404	3490	26	13378	7410	5936	2	3	14	13
부산광역시	강서구	명지동	명지동제1투	1577	1165	412	2	1163	764	396	0	0	1	2
부산광역시	강서구	명지동	명지동제2투	1943	1431	512	9	1422	984	435	1	0	0	2
부산광역시	강서구	명지동	명지동제3투	1582	1035	547	2	1033	731	300	0	0	1	1
부산광역시	강서구	명지동	명지동제4투	3745	3120	625	3	3117	1505	1608	0	0	2	2
부산광역시	강서구	명지동	명지동제5투	2536	2136	400	3	2133	1088	1036	1	0	5	3
부산광역시	강서구	명지동	명지동제6투	2528	2099	429	2	2097	1150	943	0	2	1	1
부산광역시	강서구	명지동	명지동제7투	2983	2418	565	5	2413	1188	1218	0	1	4	2
부산광역시	강서구	가락동	소계	2561	1924	637	11	1913	1173	734	1	0	3	2
부산광역시	강서구	가락동	가락동제1투	1539	1154	385	7	1147	693	452	0	0	1	1
부산광역시	강서구	가락동	가락동제2투	1022	770	252	4	766	480	282	1	0	2	1
부산광역시	강서구	녹산동	소계	8875	6464	2411	22	6442	3962	2466	1	3	2	8
부산광역시	강서구	녹산동	녹산동제1투	1049	715	334	5	710	483	226	0	0	0	1
부산광역시	강서구	녹산동	녹산동제2투	1663	1213	450	5	1208	798	405	1	1	0	3
부산광역시	강서구	녹산동	녹산동제3투	1543	1079	464	3	1076	727	345	0	0	2	2
부산광역시	강서구	녹산동	녹산동제4투	1832	1406	426	4	1402	817	583	0	1	0	1
부산광역시	강서구	녹산동	녹산동제5투	2788	2051	737	5	2046	1137	907	0	1	0	1
부산광역시	강서구	천가동	소계	2589	1805	784	12	1793	1217	568	1	0	0	7
부산광역시	강서구	천가동	천가동제1투	1014	701	313	9	692	452	239	0	0	0	1
부산광역시	강서구	천가동	천가동제2투	912	663	249	2	661	484	173	1	0	0	3
부산광역시	강서구	천가동	천가동제3투	663	441	222	1	440	281	156	0	0	0	3
부산광역시	연제구	계	계	174375	135450	38925	350	135100	81370	53294	27	57	210	142
부산광역시	연제구	재외투표	재외투표	851	604	247	3	601	256	345	0	0	0	0
부산광역시	연제구	국내부재자투표	국내부재자투표	4362	4068	294	58	4010	1949	2022	2	7	14	16
부산광역시	연제구	거제제1동	소계	22708	18737	3971	32	18705	10651	8006	0	2	40	6
부산광역시	연제구	거제제1동	거제제1동제1투	2275	1793	482	3	1790	976	808	0	1	4	1
부산광역시	연제구	거제제1동	거제제1동제2투	3955	3353	602	6	3347	1882	1457	0	1	7	0
부산광역시	연제구	거제제1동	거제제1동제3투	3314	2650	664	5	2645	1588	1050	0	0	6	1
부산광역시	연제구	거제제1동	거제제1동제4투	2118	1717	401	4	1713	940	770	0	0	2	1
부산광역시	연제구	거제제1동	거제제1동제5투	4754	4092	662	8	4084	2181	1889	0	0	14	0
부산광역시	연제구	거제제1동	거제제1동제6투	2171	1644	527	2	1642	1005	634	0	0	2	1
부산광역시	연제구	거제제1동	거제제1동제7투	4121	3488	633	4	3484	2079	1398	0	0	5	2
부산광역시	연제구	거제제2동	소계	13889	10983	2906	21	10962	6650	4279	4	4	18	7
부산광역시	연제구	거제제2동	거제제2동제1투	3812	3064	748	2	3062	1734	1317	1	1	6	3
부산광역시	연제구	거제제2동	거제제2동제2투	3696	2998	698	8	2990	1827	1157	1	2	3	0
부산광역시	연제구	거제제2동	거제제2동제3투	3114	2368	746	6	2362	1569	785	1	1	5	1
부산광역시	연제구	거제제2동	거제제2동제4투	3267	2553	714	5	2548	1520	1020	1	0	4	3
부산광역시	연제구	거제제3동	소계	9650	7671	1979	17	7654	4882	2744	0	5	14	9
부산광역시	연제구	거제제3동	거제제3동제1투	3145	2539	606	5	2534	1563	964	0	0	6	1
부산광역시	연제구	거제제3동	거제제3동제2투	3125	2362	763	3	2359	1604	743	0	3	4	5
부산광역시	연제구	거제제3동	거제제3동제3투	3380	2770	610	9	2761	1715	1037	0	2	4	3
부산광역시	연제구	거제제4동	소계	9034	7105	1929	13	7092	4333	2737	4	1	8	9
부산광역시	연제구	거제제4동	거제제4동제1투	4205	3384	821	5	3379	2078	1291	1	1	3	5
부산광역시	연제구	거제제4동	거제제4동제2투	2369	1807	562	6	1801	1041	757	1	0	1	1
부산광역시	연제구	거제제4동	거제제4동제3투	2460	1914	546	2	1912	1214	689	2	0	4	3
부산광역시	연제구	연산제1동	소계	13257	10396	2861	16	10380	6171	4186	1	2	12	8
부산광역시	연제구	연산제1동	연산제1동제1투	3584	2858	726	4	2854	1779	1067	0	0	5	3
부산광역시	연제구	연산제1동	연산제1동제2투	3331	2449	882	5	2444	1516	920	0	1	3	4
부산광역시	연제구	연산제1동	연산제1동제3투	3185	2421	764	4	2417	1468	946	1	0	1	1
부산광역시	연제구	연산제1동	연산제1동제4투	3157	2668	489	3	2665	1408	1253	0	1	3	0
부산광역시	연제구	연산제2동	소계	12548	9368	3180	21	9347	6012	3306	1	5	17	6
부산광역시	연제구	연산제2동	연산제2동제1투	2868	2265	603	2	2263	1433	824	0	2	4	0
부산광역시	연제구	연산제2동	연산제2동제2투	3292	2334	958	9	2325	1525	794	0	1	4	1
부산광역시	연제구	연산제2동	연산제2동제3투	3066	2334	732	4	2330	1524	801	0	0	5	0
부산광역시	연제구	연산제2동	연산제2동제4투	3322	2435	887	6	2429	1530	887	1	2	4	5
부산광역시	연제구	연산제3동	소계	9770	7239	2531	23	7216	4503	2686	0	5	14	8
부산광역시	연제구	연산제3동	연산제3동제1투	3073	2278	795	5	2273	1430	834	0	0	5	4
부산광역시	연제구	연산제3동	연산제3동제2투	3868	2830	1038	10	2820	1767	1044	0	4	5	0
부산광역시	연제구	연산제3동	연산제3동제3투	2829	2131	698	8	2123	1306	808	0	1	4	4
부산광역시	연제구	연산제4동	소계	14816	11219	3597	29	11190	7000	4159	1	5	15	10
부산광역시	연제구	연산제4동	연산제4동제1투	3805	2971	834	7	2964	1806	1151	1	2	2	2
부산광역시	연제구	연산제4동	연산제4동제2투	3455	2502	953	10	2492	1629	857	0	2	4	0
부산광역시	연제구	연산제4동	연산제4동제3투	4093	3016	1077	8	3008	1922	1079	0	0	3	4
부산광역시	연제구	연산제4동	연산제4동제4투	3463	2730	733	4	2726	1643	1072	0	1	6	4
부산광역시	연제구	연산제5동	소계	9624	6951	2673	16	6935	4154	2765	1	3	5	7
부산광역시	연제구	연산제5동	연산제5동제1투	3208	2276	932	4	2272	1398	867	1	0	2	4
부산광역시	연제구	연산제5동	연산제5동제2투	4056	2996	1060	7	2989	1757	1225	0	2	2	3
부산광역시	연제구	연산제5동	연산제5동제3투	2360	1679	681	5	1674	999	673	0	1	1	0
부산광역시	연제구	연산제6동	소계	14446	10695	3751	32	10663	6653	3977	2	7	11	13
부산광역시	연제구	연산제6동	연산제6동제1투	2425	1667	758	6	1661	1057	600	0	0	2	2
부산광역시	연제구	연산제6동	연산제6동제2투	3122	2377	745	8	2369	1565	799	1	1	2	1
부산광역시	연제구	연산제6동	연산제6동제3투	2672	1950	722	2	1948	1242	701	0	0	1	4
부산광역시	연제구	연산제6동	연산제6동제4투	2402	1802	600	8	1794	1094	691	0	2	4	3
부산광역시	연제구	연산제6동	연산제6동제5투	3825	2899	926	8	2891	1695	1186	1	4	2	3
부산광역시	연제구	연산제8동	소계	9108	6760	2348	19	6741	4241	2478	1	2	6	13
부산광역시	연제구	연산제8동	연산제8동제1투	3147	2261	886	10	2251	1453	792	1	0	1	4
부산광역시	연제구	연산제8동	연산제8동제2투	3374	2587	787	7	2580	1560	1010	0	2	3	5
부산광역시	연제구	연산제8동	연산제8동제3투	2587	1912	675	2	1910	1228	676	0	0	2	4
부산광역시	연제구	연산제9동	소계	30312	23654	6658	50	23604	13915	9604	10	9	36	30
부산광역시	연제구	연산제9동	연산제9동제1투	3269	2282	987	6	2276	1384	885	1	1	1	4
부산광역시	연제구	연산제9동	연산제9동제2투	3219	2598	621	8	2590	1588	993	0	0	5	4
부산광역시	연제구	연산제9동	연산제9동제3투	2902	2279	623	2	2277	1413	859	0	1	2	2
부산광역시	연제구	연산제9동	연산제9동제4투	3596	2951	645	5	2946	1676	1266	1	0	2	1
부산광역시	연제구	연산제9동	연산제9동제5투	4163	3290	873	16	3274	1948	1311	5	0	3	7
부산광역시	연제구	연산제9동	연산제9동제6투	4973	3775	1198	5	3770	2106	1651	2	2	6	3
부산광역시	연제구	연산제9동	연산제9동제7투	3010	2192	818	4	2188	1265	911	0	0	9	3
부산광역시	연제구	연산제9동	연산제9동제8투	3666	2982	684	4	2978	1658	1305	0	5	7	3
부산광역시	연제구	연산제9동	연산제9동제9투	1514	1305	209	0	1305	877	423	1	0	1	3
부산광역시	수영구	계	계	148960	113856	35104	276	113580	70198	43059	28	41	166	88
부산광역시	수영구	재외투표	재외투표	980	687	293	7	680	297	380	1	0	0	2
부산광역시	수영구	국내부재자투표	국내부재자투표	3788	3506	282	43	3463	1675	1768	3	0	7	10
부산광역시	수영구	남천제1동	소계	11908	9162	2746	22	9140	5789	3322	1	9	14	5
부산광역시	수영구	남천제1동	남천제1동제1투	2608	1905	703	3	1902	1213	681	0	3	4	1
부산광역시	수영구	남천제1동	남천제1동제2투	3088	2412	676	6	2406	1572	829	0	1	2	2
부산광역시	수영구	남천제1동	남천제1동제3투	3264	2550	714	5	2545	1587	953	0	2	3	0
부산광역시	수영구	남천제1동	남천제1동제4투	2948	2295	653	8	2287	1417	859	1	3	5	2
부산광역시	수영구	남천제2동	소계	11637	9023	2614	16	9007	5732	3261	0	0	12	2
부산광역시	수영구	남천제2동	남천제2동제1투	3323	2680	643	3	2677	1605	1068	0	0	4	0
부산광역시	수영구	남천제2동	남천제2동제2투	3748	2887	861	4	2883	1870	1011	0	0	0	2
부산광역시	수영구	남천제2동	남천제2동제3투	4566	3456	1110	9	3447	2257	1182	0	0	8	0
부산광역시	수영구	수영동	소계	13181	10080	3101	28	10052	6495	3528	3	1	20	5
부산광역시	수영구	수영동	수영동제1투	2923	2069	854	12	2057	1384	664	0	0	6	3
부산광역시	수영구	수영동	수영동제2투	2261	1733	528	3	1730	1142	585	1	0	1	1
부산광역시	수영구	수영동	수영동제3투	2626	1898	728	5	1893	1216	676	0	0	0	1
부산광역시	수영구	수영동	수영동제4투	2807	2279	528	6	2273	1468	797	1	1	6	0
부산광역시	수영구	수영동	수영동제5투	2564	2101	463	2	2099	1285	806	1	0	7	0
부산광역시	수영구	망미제1동	소계	24701	18984	5717	35	18949	12022	6869	5	8	34	11
부산광역시	수영구	망미제1동	망미제1동제1투	5140	3951	1189	3	3948	2485	1453	0	0	7	3
부산광역시	수영구	망미제1동	망미제1동제2투	3219	2564	655	6	2558	1640	907	1	1	7	2
부산광역시	수영구	망미제1동	망미제1동제3투	3348	2555	793	5	2550	1627	917	1	0	4	1
부산광역시	수영구	망미제1동	망미제1동제4투	3607	2745	862	10	2735	1709	1018	0	2	5	1
부산광역시	수영구	망미제1동	망미제1동제5투	2824	2140	684	3	2137	1428	705	1	0	2	1
부산광역시	수영구	망미제1동	망미제1동제6투	3403	2608	795	1	2607	1624	973	1	2	5	2
부산광역시	수영구	망미제1동	망미제1동제7투	3160	2421	739	7	2414	1509	896	1	3	4	1
부산광역시	수영구	망미제2동	소계	11285	8654	2631	22	8632	5149	3458	3	1	12	9
부산광역시	수영구	망미제2동	망미제2동제1투	3799	2792	1007	11	2781	1722	1050	1	0	4	4
부산광역시	수영구	망미제2동	망미제2동제2투	3739	3036	703	5	3031	1633	1389	1	1	3	4
부산광역시	수영구	망미제2동	망미제2동제3투	3747	2826	921	6	2820	1794	1019	1	0	5	1
부산광역시	수영구	광안제1동	소계	19903	15253	4650	29	15224	9151	6019	6	9	23	16
부산광역시	수영구	광안제1동	광안제1동제1투	4248	3127	1121	3	3124	1907	1212	0	1	2	2
부산광역시	수영구	광안제1동	광안제1동제2투	3963	3234	729	4	3230	1901	1317	1	2	5	4
부산광역시	수영구	광안제1동	광안제1동제3투	3624	3010	614	7	3003	1796	1192	3	3	6	3
부산광역시	수영구	광안제1동	광안제1동제4투	4210	2984	1226	7	2977	1734	1234	1	2	4	2
부산광역시	수영구	광안제1동	광안제1동제5투	3858	2898	960	8	2890	1813	1064	1	1	6	5
부산광역시	수영구	광안제2동	소계	13065	9744	3321	15	9729	6103	3599	3	5	12	7
부산광역시	수영구	광안제2동	광안제2동제1투	3745	2711	1034	5	2706	1776	924	0	1	4	1
부산광역시	수영구	광안제2동	광안제2동제2투	3113	2353	760	5	2348	1422	918	0	1	3	4
부산광역시	수영구	광안제2동	광안제2동제3투	2750	2083	667	2	2081	1351	728	1	1	0	0
부산광역시	수영구	광안제2동	광안제2동제4투	3457	2597	860	3	2594	1554	1029	2	2	5	2
부산광역시	수영구	광안제3동	소계	8825	6498	2327	16	6482	4036	2430	1	2	5	8
부산광역시	수영구	광안제3동	광안제3동제1투	3395	2344	1051	5	2339	1370	965	1	0	0	3
부산광역시	수영구	광안제3동	광안제3동제2투	2913	2246	667	5	2241	1424	809	0	2	4	2
부산광역시	수영구	광안제3동	광안제3동제3투	2517	1908	609	6	1902	1242	656	0	0	1	3
부산광역시	수영구	광안제4동	소계	11928	9130	2798	17	9113	5390	3698	1	4	13	7
부산광역시	수영구	광안제4동	광안제4동제1투	4177	3100	1077	5	3095	1852	1238	1	0	3	1
부산광역시	수영구	광안제4동	광안제4동제2투	4012	3170	842	6	3164	1817	1337	0	2	7	1
부산광역시	수영구	광안제4동	광안제4동제3투	3739	2860	879	6	2854	1721	1123	0	2	3	5
부산광역시	수영구	민락동	소계	17759	13135	4624	26	13109	8359	4727	1	2	14	6
부산광역시	수영구	민락동	민락동제1투	4629	3241	1388	5	3236	2068	1165	0	0	3	0
부산광역시	수영구	민락동	민락동제2투	3283	2376	907	8	2368	1516	848	0	0	1	3
부산광역시	수영구	민락동	민락동제3투	3632	2671	961	6	2665	1694	963	0	2	5	1
부산광역시	수영구	민락동	민락동제4투	2573	1906	667	4	1902	1213	686	1	0	1	1
부산광역시	수영구	민락동	민락동제5투	3642	2941	701	3	2938	1868	1065	0	0	4	1
부산광역시	사상구	계	계	206782	158296	48486	456	157840	88100	69288	49	55	162	186
부산광역시	사상구	재외투표	재외투표	700	458	242	3	455	128	325	0	1	0	1
부산광역시	사상구	국내부재자투표	국내부재자투표	4938	4681	257	74	4607	2041	2531	6	9	6	14
부산광역시	사상구	삼락동	소계	6827	4779	2048	13	4766	2711	2032	4	2	3	14
부산광역시	사상구	삼락동	삼락동제1투	1156	837	319	2	835	527	301	1	1	1	4
부산광역시	사상구	삼락동	삼락동제2투	2909	1940	969	3	1937	1109	818	0	0	1	9
부산광역시	사상구	삼락동	삼락동제3투	2762	2002	760	8	1994	1075	913	3	1	1	1
부산광역시	사상구	모라제1동	소계	26716	20310	6406	46	20264	11414	8803	2	4	16	25
부산광역시	사상구	모라제1동	모라제1동제1투	4062	3228	834	7	3221	1765	1447	0	2	3	4
부산광역시	사상구	모라제1동	모라제1동제2투	3851	2976	875	7	2969	1568	1399	0	0	1	1
부산광역시	사상구	모라제1동	모라제1동제3투	3578	2830	748	5	2825	1629	1191	0	0	1	4
부산광역시	사상구	모라제1동	모라제1동제4투	4344	3494	850	7	3487	1787	1689	0	1	3	7
부산광역시	사상구	모라제1동	모라제1동제5투	3683	2579	1104	9	2570	1462	1104	0	0	2	2
부산광역시	사상구	모라제1동	모라제1동제6투	2558	1825	733	1	1824	1114	705	1	0	3	1
부산광역시	사상구	모라제1동	모라제1동제7투	2376	1739	637	4	1735	1059	670	1	0	1	4
부산광역시	사상구	모라제1동	모라제1동제8투	2264	1639	625	6	1633	1030	598	0	1	2	2
부산광역시	사상구	모라제3동	소계	12506	9385	3121	42	9343	5588	3714	7	2	12	20
부산광역시	사상구	모라제3동	모라제3동제1투	3645	2747	898	15	2732	1592	1124	0	2	5	9
부산광역시	사상구	모라제3동	모라제3동제2투	2932	2147	785	10	2137	1384	740	2	0	5	6
부산광역시	사상구	모라제3동	모라제3동제3투	3011	2222	789	9	2213	1337	868	4	0	1	3
부산광역시	사상구	모라제3동	모라제3동제4투	2918	2269	649	8	2261	1275	982	1	0	1	2
부산광역시	사상구	덕포제1동	소계	9846	7226	2620	21	7205	4105	3084	2	1	5	8
부산광역시	사상구	덕포제1동	덕포제1동제1투	3538	2620	918	6	2614	1535	1069	2	0	4	4
부산광역시	사상구	덕포제1동	덕포제1동제2투	3447	2354	1093	6	2348	1417	930	0	0	0	1
부산광역시	사상구	덕포제1동	덕포제1동제3투	2861	2252	609	9	2243	1153	1085	0	1	1	3
부산광역시	사상구	덕포제2동	소계	12850	9890	2960	27	9863	5306	4527	5	4	8	13
부산광역시	사상구	덕포제2동	덕포제2동제1투	2661	1981	680	4	1977	1102	867	1	1	1	5
부산광역시	사상구	덕포제2동	덕포제2동제2투	2682	2107	575	8	2099	1146	943	4	2	2	2
부산광역시	사상구	덕포제2동	덕포제2동제3투	3943	2992	951	9	2983	1611	1364	0	1	3	4
부산광역시	사상구	덕포제2동	덕포제2동제4투	3564	2810	754	6	2804	1447	1353	0	0	2	2
부산광역시	사상구	괘법동	소계	17883	13094	4789	34	13060	7315	5714	3	4	15	9
부산광역시	사상구	괘법동	괘법동제1투	3232	2377	855	8	2369	1450	912	1	1	3	2
부산광역시	사상구	괘법동	괘법동제2투	3524	2250	1274	7	2243	1317	923	2	0	1	0
부산광역시	사상구	괘법동	괘법동제3투	3519	2478	1041	8	2470	1475	988	0	0	4	3
부산광역시	사상구	괘법동	괘법동제4투	3737	2893	844	5	2888	1550	1331	0	1	4	2
부산광역시	사상구	괘법동	괘법동제5투	3871	3096	775	6	3090	1523	1560	0	2	3	2
부산광역시	사상구	감전동	소계	12950	9388	3562	31	9357	5776	3559	1	2	9	10
부산광역시	사상구	감전동	감전동제1투	3175	2393	782	6	2387	1411	974	0	0	1	1
부산광역시	사상구	감전동	감전동제2투	3478	2579	899	10	2569	1631	929	1	0	3	5
부산광역시	사상구	감전동	감전동제3투	3301	2380	921	9	2371	1504	863	0	2	0	2
부산광역시	사상구	감전동	감전동제4투	2996	2036	960	6	2030	1230	793	0	0	5	2
부산광역시	사상구	주례제1동	소계	14052	10759	3293	21	10738	6061	4647	5	4	10	11
부산광역시	사상구	주례제1동	주례제1동제1투	2554	1725	829	6	1719	1052	662	0	1	1	3
부산광역시	사상구	주례제1동	주례제1동제2투	3723	2949	774	6	2943	1598	1339	1	0	3	2
부산광역시	사상구	주례제1동	주례제1동제3투	3764	2933	831	7	2926	1659	1266	0	0	0	1
부산광역시	사상구	주례제1동	주례제1동제4투	4011	3152	859	2	3150	1752	1380	4	3	6	5
부산광역시	사상구	주례제2동	소계	21559	16544	5015	35	16509	9183	7290	1	5	14	16
부산광역시	사상구	주례제2동	주례제2동제1투	3032	2269	763	6	2263	1304	956	0	1	0	2
부산광역시	사상구	주례제2동	주례제2동제2투	3467	2293	1174	5	2288	1377	902	0	2	4	3
부산광역시	사상구	주례제2동	주례제2동제3투	2845	2076	769	5	2071	1200	870	0	0	0	1
부산광역시	사상구	주례제2동	주례제2동제4투	1790	1222	568	3	1219	765	450	0	2	1	1
부산광역시	사상구	주례제2동	주례제2동제5투	3128	2600	528	5	2595	1393	1200	0	0	0	2
부산광역시	사상구	주례제2동	주례제2동제6투	3496	2876	620	9	2867	1509	1350	0	0	5	3
부산광역시	사상구	주례제2동	주례제2동제7투	3801	3208	593	2	3206	1635	1562	1	0	4	4
부산광역시	사상구	주례제3동	소계	13026	10272	2754	32	10240	5766	4450	5	4	10	5
부산광역시	사상구	주례제3동	주례제3동제1투	3141	2297	844	11	2286	1318	964	0	0	4	0
부산광역시	사상구	주례제3동	주례제3동제2투	4329	3596	733	7	3589	1983	1598	2	3	1	2
부산광역시	사상구	주례제3동	주례제3동제3투	3148	2549	599	7	2542	1378	1157	2	1	4	0
부산광역시	사상구	주례제3동	주례제3동제4투	2408	1830	578	7	1823	1087	731	1	0	1	3
부산광역시	사상구	학장동	소계	27108	21260	5848	45	21215	11792	9363	3	7	27	23
부산광역시	사상구	학장동	학장동제1투	3523	2851	672	3	2848	1572	1265	0	1	7	3
부산광역시	사상구	학장동	학장동제2투	2716	1832	884	6	1826	1114	708	0	1	1	2
부산광역시	사상구	학장동	학장동제3투	3559	2837	722	7	2830	1605	1217	1	0	4	3
부산광역시	사상구	학장동	학장동제4투	3088	2409	679	3	2406	1308	1092	1	1	2	2
부산광역시	사상구	학장동	학장동제5투	3987	3284	703	6	3278	1812	1458	0	1	5	2
부산광역시	사상구	학장동	학장동제6투	2787	2021	766	9	2012	1191	813	0	1	2	5
부산광역시	사상구	학장동	학장동제7투	3370	2721	649	5	2716	1468	1237	1	1	4	5
부산광역시	사상구	학장동	학장동제8투	4078	3305	773	6	3299	1722	1573	0	1	2	1
부산광역시	사상구	엄궁동	소계	25821	20250	5571	32	20218	10914	9249	5	6	27	17
부산광역시	사상구	엄궁동	엄궁동제1투	3479	2640	839	4	2636	1412	1214	0	3	5	2
부산광역시	사상구	엄궁동	엄궁동제2투	3262	2287	975	5	2282	1434	837	2	1	3	5
부산광역시	사상구	엄궁동	엄궁동제3투	3871	3034	837	6	3028	1717	1304	0	1	5	1
부산광역시	사상구	엄궁동	엄궁동제4투	3740	2803	937	1	2802	1552	1239	1	0	6	4
부산광역시	사상구	엄궁동	엄궁동제5투	3938	3304	634	8	3296	1592	1700	1	0	2	1
부산광역시	사상구	엄궁동	엄궁동제6투	3131	2555	576	5	2550	1316	1227	1	0	2	4
부산광역시	사상구	엄궁동	엄궁동제7투	4400	3627	773	3	3624	1891	1728	0	1	4	0
대구광역시	중구	계	계	64938	49463	15475	127	49336	39910	9282	10	14	47	73
대구광역시	중구	재외투표	재외투표	450	323	127	4	319	183	135	0	0	1	0
대구광역시	중구	국내부재자투표	국내부재자투표	1418	1296	122	23	1273	864	397	0	2	1	9
대구광역시	중구	동인동	소계	9017	6665	2352	19	6646	5444	1174	2	3	7	16
대구광역시	중구	동인동	동인동제1투	3016	2162	854	5	2157	1785	361	1	1	4	5
대구광역시	중구	동인동	동인동제2투	3063	2244	819	7	2237	1774	454	1	1	2	5
대구광역시	중구	동인동	동인동제3투	2938	2259	679	7	2252	1885	359	0	1	1	6
대구광역시	중구	삼덕동	소계	3978	2824	1154	4	2820	2150	664	2	2	1	1
대구광역시	중구	삼덕동	삼덕동제1투	2165	1595	570	3	1592	1258	331	2	0	1	0
대구광역시	중구	삼덕동	삼덕동제2투	1813	1229	584	1	1228	892	333	0	2	0	1
대구광역시	중구	성내1동	소계	3942	2875	1067	6	2869	2274	588	0	0	3	4
대구광역시	중구	성내1동	성내1동제1투	2129	1432	697	3	1429	1150	276	0	0	2	1
대구광역시	중구	성내1동	성내1동제2투	1813	1443	370	3	1440	1124	312	0	0	1	3
대구광역시	중구	성내2동	소계	4585	3277	1308	9	3268	2728	533	1	0	4	2
대구광역시	중구	성내2동	성내2동제1투	2654	1874	780	4	1870	1550	314	1	0	3	2
대구광역시	중구	성내2동	성내2동제2투	1931	1403	528	5	1398	1178	219	0	0	1	0
대구광역시	중구	성내3동	소계	3490	2587	903	6	2581	2196	378	0	1	2	4
대구광역시	중구	성내3동	성내3동제1투	1882	1354	528	4	1350	1136	210	0	1	2	1
대구광역시	중구	성내3동	성내3동제2투	1608	1233	375	2	1231	1060	168	0	0	0	3
대구광역시	중구	대신동	소계	4323	3377	946	6	3371	2832	526	2	1	7	3
대구광역시	중구	대신동	대신동제1투	1877	1418	459	2	1416	1189	223	1	0	3	0
대구광역시	중구	대신동	대신동제2투	2446	1959	487	4	1955	1643	303	1	1	4	3
대구광역시	중구	남산1동	소계	3672	2717	955	10	2707	2224	474	0	1	3	5
대구광역시	중구	남산1동	남산1동제1투	2172	1588	584	9	1579	1300	275	0	0	0	4
대구광역시	중구	남산1동	남산1동제2투	1500	1129	371	1	1128	924	199	0	1	3	1
대구광역시	중구	남산2동	소계	4200	3159	1041	5	3154	2587	558	1	2	2	4
대구광역시	중구	남산2동	남산2동제1투	2344	1739	605	3	1736	1403	329	0	1	1	2
대구광역시	중구	남산2동	남산2동제2투	1856	1420	436	2	1418	1184	229	1	1	1	2
대구광역시	중구	남산3동	소계	4584	3451	1133	4	3447	2772	669	0	0	2	4
대구광역시	중구	남산3동	남산3동제1투	2234	1665	569	0	1665	1278	386	0	0	0	1
대구광역시	중구	남산3동	남산3동제2투	2350	1786	564	4	1782	1494	283	0	0	2	3
대구광역시	중구	남산4동	소계	11490	9281	2209	20	9261	7503	1736	2	1	6	13
대구광역시	중구	남산4동	남산4동제1투	3877	2933	944	7	2926	2447	471	1	0	1	6
대구광역시	중구	남산4동	남산4동제2투	4568	3786	782	11	3775	2922	846	1	0	2	4
대구광역시	중구	남산4동	남산4동제3투	3045	2562	483	2	2560	2134	419	0	1	3	3
대구광역시	중구	대봉1동	소계	6245	4941	1304	5	4936	3978	949	0	1	3	5
대구광역시	중구	대봉1동	대봉1동제1투	3300	2585	715	5	2580	2048	526	0	0	1	5
대구광역시	중구	대봉1동	대봉1동제2투	2945	2356	589	0	2356	1930	423	0	1	2	0
대구광역시	중구	대봉2동	소계	3544	2690	854	6	2684	2175	501	0	0	5	3
대구광역시	중구	대봉2동	대봉2동제1투	2015	1483	532	3	1480	1164	310	0	0	4	2
대구광역시	중구	대봉2동	대봉2동제2투	1529	1207	322	3	1204	1011	191	0	0	1	1
대구광역시	중구	잘못 투입·구분된 투표지	잘못 투입·구분된 투표지	0	0	0	0	0	0	0	0	0	0	0
대구광역시	동구	계	계	280065	221271	58794	668	220603	176185	43659	68	95	294	302
대구광역시	동구	재외투표	재외투표	1021	700	321	4	696	378	310	1	1	4	2
대구광역시	동구	국내부재자투표	국내부재자투표	7378	6893	485	209	6684	4441	2124	28	21	27	43
대구광역시	동구	신암1동	소계	11288	8696	2592	22	8674	7171	1485	1	2	6	9
대구광역시	동구	신암1동	신암1동제1투	3498	2625	873	7	2618	2135	479	0	0	2	2
대구광역시	동구	신암1동	신암1동제2투	2756	2182	574	1	2181	1785	391	1	0	2	2
대구광역시	동구	신암1동	신암1동제3투	2594	2024	570	9	2015	1702	309	0	0	1	3
대구광역시	동구	신암1동	신암1동제4투	2440	1865	575	5	1860	1549	306	0	2	1	2
대구광역시	동구	신암2동	소계	8708	7075	1633	15	7060	5671	1369	1	3	8	8
대구광역시	동구	신암2동	신암2동제1투	2877	2271	606	4	2267	1803	460	0	2	2	0
대구광역시	동구	신암2동	신암2동제2투	2737	2158	579	5	2153	1758	383	1	1	3	7
대구광역시	동구	신암2동	신암2동제3투	3094	2646	448	6	2640	2110	526	0	0	3	1
대구광역시	동구	신암3동	소계	8456	6480	1976	12	6468	5318	1130	2	2	7	9
대구광역시	동구	신암3동	신암3동제1투	2492	1810	682	3	1807	1472	327	1	0	2	5
대구광역시	동구	신암3동	신암3동제2투	3494	2816	678	5	2811	2232	572	1	1	3	2
대구광역시	동구	신암3동	신암3동제3투	2470	1854	616	4	1850	1614	231	0	1	2	2
대구광역시	동구	신암4동	소계	16263	12114	4149	15	12099	9850	2215	1	2	16	15
대구광역시	동구	신암4동	신암4동제1투	4148	2905	1243	1	2904	2342	556	1	1	3	1
대구광역시	동구	신암4동	신암4동제2투	3887	2911	976	5	2906	2394	506	0	0	2	4
대구광역시	동구	신암4동	신암4동제3투	3618	2841	777	4	2837	2299	524	0	0	8	6
대구광역시	동구	신암4동	신암4동제4투	4610	3457	1153	5	3452	2815	629	0	1	3	4
대구광역시	동구	신암5동	소계	7385	5714	1671	8	5706	4643	1044	1	2	10	6
대구광역시	동구	신암5동	신암5동제1투	2968	2294	674	2	2292	1848	435	0	2	5	2
대구광역시	동구	신암5동	신암5동제2투	1943	1501	442	4	1497	1229	263	1	0	3	1
대구광역시	동구	신암5동	신암5동제3투	2474	1919	555	2	1917	1566	346	0	0	2	3
대구광역시	동구	신천1·2동	소계	12137	9793	2344	17	9776	7730	2015	4	3	18	6
대구광역시	동구	신천1·2동	신천1·2동제1투	2539	2085	454	2	2083	1690	383	2	1	3	4
대구광역시	동구	신천1·2동	신천1·2동제2투	3094	2442	652	7	2435	1913	514	2	0	4	2
대구광역시	동구	신천1·2동	신천1·2동제3투	2982	2308	674	4	2304	1939	358	0	2	5	0
대구광역시	동구	신천1·2동	신천1·2동제4투	3522	2958	564	4	2954	2188	760	0	0	6	0
대구광역시	동구	신천3동	소계	10553	8350	2203	15	8335	6735	1568	0	6	14	12
대구광역시	동구	신천3동	신천3동제1투	2803	2070	733	7	2063	1731	320	0	3	4	5
대구광역시	동구	신천3동	신천3동제2투	4205	3457	748	5	3452	2711	733	0	0	2	6
대구광역시	동구	신천3동	신천3동제3투	3545	2823	722	3	2820	2293	515	0	3	8	1
대구광역시	동구	신천4동	소계	8093	6156	1937	16	6140	5090	1035	0	2	7	6
대구광역시	동구	신천4동	신천4동제1투	2553	1965	588	4	1961	1623	334	0	1	1	2
대구광역시	동구	신천4동	신천4동제2투	2949	2152	797	7	2145	1793	348	0	1	2	1
대구광역시	동구	신천4동	신천4동제3투	2591	2039	552	5	2034	1674	353	0	0	4	3
대구광역시	동구	효목1동	소계	13704	10571	3133	23	10548	8726	1797	4	8	9	4
대구광역시	동구	효목1동	효목1동제1투	2391	1877	514	4	1873	1560	309	2	1	0	1
대구광역시	동구	효목1동	효목1동제2투	2569	2049	520	5	2044	1712	328	0	2	1	1
대구광역시	동구	효목1동	효목1동제3투	2614	1952	662	2	1950	1630	317	1	0	2	0
대구광역시	동구	효목1동	효목1동제4투	3303	2705	598	8	2697	2139	555	1	1	1	0
대구광역시	동구	효목1동	효목1동제5투	2827	1988	839	4	1984	1685	288	0	4	5	2
대구광역시	동구	효목2동	소계	14295	11314	2981	17	11297	9116	2155	1	2	13	10
대구광역시	동구	효목2동	효목2동제1투	2196	1714	482	1	1713	1428	278	0	1	4	2
대구광역시	동구	효목2동	효목2동제2투	3133	2403	730	2	2401	1974	424	0	0	1	2
대구광역시	동구	효목2동	효목2동제3투	2828	2187	641	3	2184	1794	386	0	0	1	3
대구광역시	동구	효목2동	효목2동제4투	2274	1779	495	5	1774	1456	316	1	0	1	0
대구광역시	동구	효목2동	효목2동제5투	3864	3231	633	6	3225	2464	751	0	1	6	3
대구광역시	동구	도평동	소계	4304	3409	895	7	3402	2736	652	0	2	3	9
대구광역시	동구	도평동	도평동제1투	2654	2137	517	3	2134	1811	315	0	1	3	4
대구광역시	동구	도평동	도평동제2투	1650	1272	378	4	1268	925	337	0	1	0	5
대구광역시	동구	불로·봉무동	소계	12084	9666	2418	26	9640	7947	1660	1	1	14	17
대구광역시	동구	불로·봉무동	불로·봉무동제1투	3068	2378	690	7	2371	2002	356	1	0	5	7
대구광역시	동구	불로·봉무동	불로·봉무동제2투	2352	2012	340	4	2008	1581	420	0	0	1	6
대구광역시	동구	불로·봉무동	불로·봉무동제3투	2838	2224	614	6	2218	1860	352	0	0	3	3
대구광역시	동구	불로·봉무동	불로·봉무동제4투	3826	3052	774	9	3043	2504	532	0	1	5	1
대구광역시	동구	지저동	소계	9687	7551	2136	12	7539	6288	1231	2	2	2	14
대구광역시	동구	지저동	지저동제1투	3707	2822	885	6	2816	2355	455	0	0	1	5
대구광역시	동구	지저동	지저동제2투	3592	2819	773	3	2816	2376	431	0	2	1	6
대구광역시	동구	지저동	지저동제3투	2388	1910	478	3	1907	1557	345	2	0	0	3
대구광역시	동구	동촌동	소계	11745	8986	2759	19	8967	7461	1488	0	2	9	7
대구광역시	동구	동촌동	동촌동제1투	2773	2142	631	1	2141	1805	333	0	0	2	1
대구광역시	동구	동촌동	동촌동제2투	2207	1699	508	1	1698	1418	277	0	0	0	3
대구광역시	동구	동촌동	동촌동제3투	3476	2637	839	8	2629	2134	488	0	1	5	1
대구광역시	동구	동촌동	동촌동제4투	3289	2508	781	9	2499	2104	390	0	1	2	2
대구광역시	동구	방촌동	소계	16924	13844	3080	31	13813	11133	2637	3	3	19	18
대구광역시	동구	방촌동	방촌동제1투	2895	2366	529	1	2365	1952	406	0	0	4	3
대구광역시	동구	방촌동	방촌동제2투	2852	2223	629	5	2218	1817	395	1	1	3	1
대구광역시	동구	방촌동	방촌동제3투	3065	2467	598	8	2459	1996	457	0	0	2	4
대구광역시	동구	방촌동	방촌동제4투	3254	2777	477	4	2773	2151	613	0	1	4	4
대구광역시	동구	방촌동	방촌동제5투	2276	1907	369	7	1900	1514	380	2	0	2	2
대구광역시	동구	방촌동	방촌동제6투	2582	2104	478	6	2098	1703	386	0	1	4	4
대구광역시	동구	해안동	소계	15214	11782	3432	22	11760	9731	1998	2	6	8	15
대구광역시	동구	해안동	해안동제1투	3910	3016	894	4	3012	2461	540	2	2	2	5
대구광역시	동구	해안동	해안동제2투	2996	2337	659	5	2332	1899	428	0	1	2	2
대구광역시	동구	해안동	해안동제3투	2922	2213	709	7	2206	1836	365	0	0	2	3
대구광역시	동구	해안동	해안동제4투	2586	2022	564	4	2018	1652	362	0	1	0	3
대구광역시	동구	해안동	해안동제5투	2800	2194	606	2	2192	1883	303	0	2	2	2
대구광역시	동구	안심1동	소계	33546	26288	7258	65	26223	20550	5597	3	10	28	35
대구광역시	동구	안심1동	안심1동제1투	3680	2653	1027	7	2646	2204	430	0	4	2	6
대구광역시	동구	안심1동	안심1동제2투	3378	2571	807	9	2562	2111	448	0	0	0	3
대구광역시	동구	안심1동	안심1동제3투	3826	2945	881	6	2939	2432	499	0	0	4	4
대구광역시	동구	안심1동	안심1동제4투	4170	3277	893	6	3271	2672	591	0	0	2	6
대구광역시	동구	안심1동	안심1동제5투	3575	2800	775	8	2792	2187	592	0	2	6	5
대구광역시	동구	안심1동	안심1동제6투	3207	2525	682	10	2515	2000	508	0	2	3	2
대구광역시	동구	안심1동	안심1동제7투	3651	2847	804	8	2839	2204	627	1	0	3	4
대구광역시	동구	안심1동	안심1동제8투	4417	3588	829	7	3581	2564	1007	1	0	5	4
대구광역시	동구	안심1동	안심1동제9투	3642	3082	560	4	3078	2176	895	1	2	3	1
대구광역시	동구	안심2동	소계	8941	6959	1982	9	6950	5656	1272	3	2	6	11
대구광역시	동구	안심2동	안심2동제1투	3605	2746	859	2	2744	2235	498	2	0	4	5
대구광역시	동구	안심2동	안심2동제2투	3293	2731	562	3	2728	2164	555	1	2	2	4
대구광역시	동구	안심2동	안심2동제3투	2043	1482	561	4	1478	1257	219	0	0	0	2
대구광역시	동구	안심3·4동	소계	35665	28809	6856	66	28743	21565	7084	6	11	47	30
대구광역시	동구	안심3·4동	안심3·4동제1투	2818	2060	758	6	2054	1695	352	0	0	4	3
대구광역시	동구	안심3·4동	안심3·4동제2투	3615	2903	712	19	2884	2257	617	1	0	5	4
대구광역시	동구	안심3·4동	안심3·4동제3투	4453	3638	815	9	3629	2779	839	0	1	7	3
대구광역시	동구	안심3·4동	안심3·4동제4투	4334	3484	850	2	3482	2564	909	0	1	4	4
대구광역시	동구	안심3·4동	안심3·4동제5투	4145	3306	839	8	3298	2680	607	2	2	2	5
대구광역시	동구	안심3·4동	안심3·4동제6투	3764	3076	688	2	3074	2287	776	1	0	7	3
대구광역시	동구	안심3·4동	안심3·4동제7투	458	360	98	2	358	314	43	1	0	0	0
대구광역시	동구	안심3·4동	안심3·4동제8투	4058	3278	780	4	3274	2180	1087	0	1	3	3
대구광역시	동구	안심3·4동	안심3·4동제9투	4359	3648	711	7	3641	2602	1027	0	4	7	1
대구광역시	동구	안심3·4동	안심3·4동제10투	3661	3056	605	7	3049	2207	827	1	2	8	4
대구광역시	동구	공산동	소계	12674	10121	2553	38	10083	8249	1793	4	2	19	16
대구광역시	동구	공산동	공산동제1투	3391	2525	866	18	2507	2183	310	0	2	5	7
대구광역시	동구	공산동	공산동제2투	3956	3204	752	8	3196	2549	638	0	0	7	2
대구광역시	동구	공산동	공산동제3투	3773	3180	593	3	3177	2486	680	3	0	5	3
대구광역시	동구	공산동	공산동제4투	1554	1212	342	9	1203	1031	165	1	0	2	4
대구광역시	동구	잘못 투입·구분된 투표지	잘못 투입·구분된 투표지	0	0	0	0	0	0	0	0	0	0	0
대구광역시	서구	계	계	185772	143549	42223	361	143188	120625	22092	37	56	152	226
대구광역시	서구	재외투표	재외투표	480	340	140	1	339	185	152	0	1	0	1
대구광역시	서구	국내부재자투표	국내부재자투표	4192	3968	224	69	3899	2748	1119	4	8	6	14
대구광역시	서구	내당1동	소계	10115	7765	2350	12	7753	6509	1219	3	2	9	11
대구광역시	서구	내당1동	내당1동제1투	3551	2752	799	7	2745	2297	439	1	1	3	4
대구광역시	서구	내당1동	내당1동제2투	3475	2553	922	4	2549	2085	453	1	1	4	5
대구광역시	서구	내당1동	내당1동제3투	3089	2460	629	1	2459	2127	327	1	0	2	2
대구광역시	서구	내당2·3동	소계	10596	8147	2449	23	8124	6963	1132	2	4	4	19
대구광역시	서구	내당2·3동	내당2·3동제1투	3811	2854	957	10	2844	2395	436	0	3	3	7
대구광역시	서구	내당2·3동	내당2·3동제2투	3342	2601	741	4	2597	2262	328	1	1	1	4
대구광역시	서구	내당2·3동	내당2·3동제3투	3443	2692	751	9	2683	2306	368	1	0	0	8
대구광역시	서구	내당4동	소계	15967	12620	3347	21	12599	10349	2214	2	4	18	12
대구광역시	서구	내당4동	내당4동제1투	2483	1888	595	3	1885	1574	300	1	0	10	0
대구광역시	서구	내당4동	내당4동제2투	3545	2771	774	4	2767	2221	540	0	1	5	0
대구광역시	서구	내당4동	내당4동제3투	3734	3040	694	3	3037	2438	592	1	1	1	4
대구광역시	서구	내당4동	내당4동제4투	3069	2440	629	4	2436	2026	403	0	2	1	4
대구광역시	서구	내당4동	내당4동제5투	3136	2481	655	7	2474	2090	379	0	0	1	4
대구광역시	서구	비산1동	소계	10609	7974	2635	22	7952	6872	1056	1	5	5	13
대구광역시	서구	비산1동	비산1동제1투	3162	2319	843	5	2314	2006	301	0	1	2	4
대구광역시	서구	비산1동	비산1동제2투	2755	2067	688	9	2058	1779	270	1	1	3	4
대구광역시	서구	비산1동	비산1동제3투	2349	1828	521	3	1825	1565	256	0	1	0	3
대구광역시	서구	비산1동	비산1동제4투	2343	1760	583	5	1755	1522	229	0	2	0	2
대구광역시	서구	비산2·3동	소계	10721	7993	2728	29	7964	6919	1018	3	4	6	14
대구광역시	서구	비산2·3동	비산2·3동제1투	3355	2575	780	7	2568	2237	322	2	2	2	3
대구광역시	서구	비산2·3동	비산2·3동제2투	3548	2702	846	10	2692	2355	324	1	1	4	7
대구광역시	서구	비산2·3동	비산2·3동제3투	3818	2716	1102	12	2704	2327	372	0	1	0	4
대구광역시	서구	비산4동	소계	10045	7766	2279	11	7755	6563	1158	2	1	19	12
대구광역시	서구	비산4동	비산4동제1투	3496	2605	891	3	2602	2233	358	1	0	6	4
대구광역시	서구	비산4동	비산4동제2투	3345	2573	772	2	2571	2167	391	1	1	4	7
대구광역시	서구	비산4동	비산4동제3투	3204	2588	616	6	2582	2163	409	0	0	9	1
대구광역시	서구	비산5동	소계	6742	5168	1574	15	5153	4486	654	0	0	0	13
대구광역시	서구	비산5동	비산5동제1투	3333	2606	727	6	2600	2256	336	0	0	0	8
대구광역시	서구	비산5동	비산5동제2투	3409	2562	847	9	2553	2230	318	0	0	0	5
대구광역시	서구	비산6동	소계	8167	6255	1912	11	6244	5324	906	2	1	5	6
대구광역시	서구	비산6동	비산6동제1투	3945	3039	906	4	3035	2585	444	0	0	3	3
대구광역시	서구	비산6동	비산6동제2투	4222	3216	1006	7	3209	2739	462	2	1	2	3
대구광역시	서구	비산7동	소계	11796	8890	2906	14	8876	7689	1161	1	2	7	16
대구광역시	서구	비산7동	비산7동제1투	2716	1978	738	1	1977	1704	271	0	0	0	2
대구광역시	서구	비산7동	비산7동제2투	2673	2103	570	3	2100	1827	270	0	0	1	2
대구광역시	서구	비산7동	비산7동제3투	3059	2262	797	8	2254	1935	312	1	2	3	1
대구광역시	서구	비산7동	비산7동제4투	3348	2547	801	2	2545	2223	308	0	0	3	11
대구광역시	서구	평리1동	소계	7839	6025	1814	8	6017	5133	865	3	3	3	10
대구광역시	서구	평리1동	평리1동제1투	2367	1857	510	1	1856	1568	282	0	1	1	4
대구광역시	서구	평리1동	평리1동제2투	2555	1956	599	6	1950	1660	287	0	1	0	2
대구광역시	서구	평리1동	평리1동제3투	2917	2212	705	1	2211	1905	296	3	1	2	4
대구광역시	서구	평리2동	소계	7444	5834	1610	14	5820	4728	1076	1	2	7	6
대구광역시	서구	평리2동	평리2동제1투	4222	3367	855	4	3363	2680	671	1	2	6	3
대구광역시	서구	평리2동	평리2동제2투	3222	2467	755	10	2457	2048	405	0	0	1	3
대구광역시	서구	평리3동	소계	12120	9146	2974	26	9120	7757	1336	3	1	6	17
대구광역시	서구	평리3동	평리3동제1투	3224	2326	898	2	2324	1971	344	1	0	4	4
대구광역시	서구	평리3동	평리3동제2투	3027	2280	747	8	2272	1993	274	0	0	1	4
대구광역시	서구	평리3동	평리3동제3투	2958	2234	724	5	2229	1908	314	1	0	1	5
대구광역시	서구	평리3동	평리3동제4투	2911	2306	605	11	2295	1885	404	1	1	0	4
대구광역시	서구	평리4동	소계	16327	12682	3645	15	12667	10529	2099	4	5	17	13
대구광역시	서구	평리4동	평리4동제1투	4274	3282	992	2	3280	2672	595	3	1	5	4
대구광역시	서구	평리4동	평리4동제2투	3938	3022	916	5	3017	2570	431	1	1	9	5
대구광역시	서구	평리4동	평리4동제3투	3948	3088	860	3	3085	2573	504	0	2	3	3
대구광역시	서구	평리4동	평리4동제4투	4167	3290	877	5	3285	2714	569	0	1	0	1
대구광역시	서구	평리5동	소계	6745	5129	1616	13	5116	4381	720	0	0	7	8
대구광역시	서구	평리5동	평리5동제1투	3275	2444	831	8	2436	2095	331	0	0	4	6
대구광역시	서구	평리5동	평리5동제2투	3470	2685	785	5	2680	2286	389	0	0	3	2
대구광역시	서구	평리6동	소계	8000	6058	1942	11	6047	5191	838	1	3	4	10
대구광역시	서구	평리6동	평리6동제1투	2827	2116	711	4	2112	1817	289	0	1	2	3
대구광역시	서구	평리6동	평리6동제2투	2707	2104	603	4	2100	1801	293	1	0	1	4
대구광역시	서구	평리6동	평리6동제3투	2466	1838	628	3	1835	1573	256	0	2	1	3
대구광역시	서구	상중이동	소계	18590	14758	3832	25	14733	12199	2485	4	6	17	22
대구광역시	서구	상중이동	상중이동제1투	1951	1258	693	2	1256	1074	177	1	1	0	3
대구광역시	서구	상중이동	상중이동제2투	3666	2895	771	4	2891	2445	439	1	1	3	2
대구광역시	서구	상중이동	상중이동제3투	3636	2912	724	4	2908	2393	510	0	3	2	0
대구광역시	서구	상중이동	상중이동제4투	3286	2626	660	4	2622	2188	424	0	0	5	5
대구광역시	서구	상중이동	상중이동제5투	4331	3757	574	4	3753	2961	778	2	1	7	4
대구광역시	서구	상중이동	상중이동제6투	879	675	204	2	673	587	85	0	0	0	1
대구광역시	서구	상중이동	상중이동제7투	841	635	206	5	630	551	72	0	0	0	7
대구광역시	서구	원대동	소계	9277	7031	2246	21	7010	6100	884	1	4	12	9
대구광역시	서구	원대동	원대동제1투	3021	2192	829	8	2184	1907	268	0	1	5	3
대구광역시	서구	원대동	원대동제2투	3052	2406	646	4	2402	2071	321	0	2	6	2
대구광역시	서구	원대동	원대동제3투	3204	2433	771	9	2424	2122	295	1	1	1	4
대구광역시	서구	잘못 투입·구분된 투표지	잘못 투입·구분된 투표지	0	0	0	0	0	0	0	0	0	0	0
대구광역시	남구	계	계	143826	109075	34751	241	108834	88347	20092	30	47	156	162
대구광역시	남구	재외투표	재외투표	609	425	184	3	422	228	192	1	1	0	0
대구광역시	남구	국내부재자투표	국내부재자투표	3283	3025	258	43	2982	2022	931	1	7	5	16
대구광역시	남구	이천동	소계	12300	9667	2633	23	9644	7773	1836	2	2	22	9
대구광역시	남구	이천동	이천동제1투	2888	2045	843	10	2035	1693	338	1	0	2	1
대구광역시	남구	이천동	이천동제2투	3382	2675	707	4	2671	2171	489	1	1	6	3
대구광역시	남구	이천동	이천동제3투	2896	2376	520	4	2372	1825	536	0	1	10	0
대구광역시	남구	이천동	이천동제4투	3134	2571	563	5	2566	2084	473	0	0	4	5
대구광역시	남구	봉덕1동	소계	8622	6247	2375	10	6237	5165	1049	1	3	7	12
대구광역시	남구	봉덕1동	봉덕1동제1투	2450	1662	788	2	1660	1407	246	0	0	4	3
대구광역시	남구	봉덕1동	봉덕1동제2투	2999	2336	663	3	2333	1950	379	0	0	1	3
대구광역시	남구	봉덕1동	봉덕1동제3투	3173	2249	924	5	2244	1808	424	1	3	2	6
대구광역시	남구	봉덕2동	소계	10563	8364	2199	11	8353	6943	1388	1	1	8	12
대구광역시	남구	봉덕2동	봉덕2동제1투	2461	1759	702	3	1756	1497	250	1	1	3	4
대구광역시	남구	봉덕2동	봉덕2동제2투	2246	1775	471	3	1772	1465	304	0	0	1	2
대구광역시	남구	봉덕2동	봉덕2동제3투	2893	2344	549	2	2342	1946	392	0	0	1	3
대구광역시	남구	봉덕2동	봉덕2동제4투	2963	2486	477	3	2483	2035	442	0	0	3	3
대구광역시	남구	봉덕3동	소계	15324	11220	4104	16	11204	9229	1947	4	2	16	6
대구광역시	남구	봉덕3동	봉덕3동제1투	4594	2892	1702	4	2888	2408	472	1	1	3	3
대구광역시	남구	봉덕3동	봉덕3동제2투	4167	3102	1065	3	3099	2542	549	2	0	5	1
대구광역시	남구	봉덕3동	봉덕3동제3투	3236	2482	754	6	2476	2022	447	0	1	5	1
대구광역시	남구	봉덕3동	봉덕3동제4투	3327	2744	583	3	2741	2257	479	1	0	3	1
대구광역시	남구	대명1동	소계	10396	7961	2435	17	7944	6375	1543	3	4	13	6
대구광역시	남구	대명1동	대명1동제1투	3686	2703	983	6	2697	2176	512	2	1	4	2
대구광역시	남구	대명1동	대명1동제2투	2913	2218	695	7	2211	1794	411	1	0	2	3
대구광역시	남구	대명1동	대명1동제3투	3797	3040	757	4	3036	2405	620	0	3	7	1
대구광역시	남구	대명2동	소계	11470	8568	2902	12	8556	6723	1798	5	4	11	15
대구광역시	남구	대명2동	대명2동제1투	3315	2302	1013	3	2299	1706	585	2	2	2	2
대구광역시	남구	대명2동	대명2동제2투	2364	1850	514	5	1845	1494	346	0	0	3	2
대구광역시	남구	대명2동	대명2동제3투	3003	2280	723	2	2278	1800	469	1	1	3	4
대구광역시	남구	대명2동	대명2동제4투	2788	2136	652	2	2134	1723	398	2	1	3	7
대구광역시	남구	대명3동	소계	12862	9541	3321	21	9520	7861	1622	3	4	6	24
대구광역시	남구	대명3동	대명3동제1투	3609	2584	1025	4	2580	2091	479	0	0	2	8
대구광역시	남구	대명3동	대명3동제2투	3186	2358	828	4	2354	1935	411	1	2	1	4
대구광역시	남구	대명3동	대명3동제3투	3022	2309	713	4	2305	1936	359	1	0	2	7
대구광역시	남구	대명3동	대명3동제4투	3045	2290	755	9	2281	1899	373	1	2	1	5
대구광역시	남구	대명4동	소계	10893	8260	2633	20	8240	6962	1248	1	3	12	14
대구광역시	남구	대명4동	대명4동제1투	3168	2325	843	7	2318	1971	336	1	3	4	3
대구광역시	남구	대명4동	대명4동제2투	2969	2244	725	7	2237	1876	358	0	0	1	2
대구광역시	남구	대명4동	대명4동제3투	2529	1989	540	5	1984	1725	247	0	0	6	6
대구광역시	남구	대명4동	대명4동제4투	2227	1702	525	1	1701	1390	307	0	0	1	3
대구광역시	남구	대명5동	소계	7796	5799	1997	11	5788	4738	1031	1	3	9	6
대구광역시	남구	대명5동	대명5동제1투	2746	1933	813	5	1928	1565	358	0	1	0	4
대구광역시	남구	대명5동	대명5동제2투	2839	2206	633	5	2201	1801	394	1	2	2	1
대구광역시	남구	대명5동	대명5동제3투	2211	1660	551	1	1659	1372	279	0	0	7	1
대구광역시	남구	대명6동	소계	8733	6641	2092	7	6634	5385	1221	2	5	11	10
대구광역시	남구	대명6동	대명6동제1투	2792	2044	748	5	2039	1644	388	1	1	4	1
대구광역시	남구	대명6동	대명6동제2투	3052	2374	678	2	2372	1943	419	0	2	6	2
대구광역시	남구	대명6동	대명6동제3투	2889	2223	666	0	2223	1798	414	1	2	1	7
대구광역시	남구	대명9동	소계	13686	10143	3543	29	10114	8108	1973	3	1	18	11
대구광역시	남구	대명9동	대명9동제1투	3662	2600	1062	6	2594	2085	498	2	0	6	3
대구광역시	남구	대명9동	대명9동제2투	3044	2399	645	10	2389	1955	425	0	0	5	4
대구광역시	남구	대명9동	대명9동제3투	3631	2711	920	7	2704	2125	572	0	0	4	3
대구광역시	남구	대명9동	대명9동제4투	3349	2433	916	6	2427	1943	478	1	1	3	1
대구광역시	남구	대명10동	소계	8793	6768	2025	12	6756	5491	1245	0	3	7	10
대구광역시	남구	대명10동	대명10동제1투	3171	2414	757	1	2413	1947	461	0	0	2	3
대구광역시	남구	대명10동	대명10동제2투	2508	1912	596	3	1909	1566	338	0	0	3	2
대구광역시	남구	대명10동	대명10동제3투	3114	2442	672	8	2434	1978	446	0	3	2	5
대구광역시	남구	대명11동	소계	8496	6446	2050	6	6440	5344	1068	2	4	11	11
대구광역시	남구	대명11동	대명11동제1투	3058	2266	792	3	2263	1875	380	1	1	2	4
대구광역시	남구	대명11동	대명11동제2투	2728	2062	666	3	2059	1728	322	1	0	4	4
대구광역시	남구	대명11동	대명11동제3투	2710	2118	592	0	2118	1741	366	0	3	5	3
대구광역시	남구	잘못 투입·구분된 투표지	잘못 투입·구분된 투표지	0	0	0	0	0	0	0	0	0	0	0
대구광역시	북구	계	계	347154	278722	68432	661	278061	220974	56240	52	101	368	326
대구광역시	북구	재외투표	재외투표	1055	725	330	5	720	369	347	0	0	3	1
대구광역시	북구	국내부재자투표	국내부재자투표	9481	8783	698	148	8635	5886	2665	10	19	21	34
대구광역시	북구	고성동	소계	5948	4603	1345	14	4589	3842	737	2	0	4	4
대구광역시	북구	고성동	고성동제1투	2734	2102	632	1	2101	1744	355	0	0	1	1
대구광역시	북구	고성동	고성동제2투	3214	2501	713	13	2488	2098	382	2	0	3	3
대구광역시	북구	칠성동	소계	15912	12940	2972	29	12911	10305	2567	3	3	19	14
대구광역시	북구	칠성동	칠성동제1투	3498	2737	761	6	2731	2359	365	1	1	2	3
대구광역시	북구	칠성동	칠성동제2투	3110	2587	523	3	2584	1868	704	1	2	5	4
대구광역시	북구	칠성동	칠성동제3투	2343	1705	638	7	1698	1441	253	0	0	3	1
대구광역시	북구	칠성동	칠성동제4투	4259	3596	663	9	3587	2815	756	1	0	9	6
대구광역시	북구	칠성동	칠성동제5투	2702	2315	387	4	2311	1822	489	0	0	0	0
대구광역시	북구	침산1동	소계	4885	3706	1179	17	3689	3174	503	3	1	4	4
대구광역시	북구	침산1동	침산1동제1투	2498	1881	617	6	1875	1622	247	1	1	3	1
대구광역시	북구	침산1동	침산1동제2투	2387	1825	562	11	1814	1552	256	2	0	1	3
대구광역시	북구	침산2동	소계	12450	10355	2095	17	10338	8188	2123	2	2	17	6
대구광역시	북구	침산2동	침산2동제1투	3807	3140	667	7	3133	2562	559	1	1	6	4
대구광역시	북구	침산2동	침산2동제2투	3962	3191	771	4	3187	2579	599	1	0	7	1
대구광역시	북구	침산2동	침산2동제3투	4681	4024	657	6	4018	3047	965	0	1	4	1
대구광역시	북구	침산3동	소계	15447	12880	2567	18	12862	10484	2349	1	5	10	13
대구광역시	북구	침산3동	침산3동제1투	2957	2284	673	6	2278	1975	297	1	1	0	4
대구광역시	북구	침산3동	침산3동제2투	3936	3286	650	5	3281	2680	595	0	3	2	1
대구광역시	북구	침산3동	침산3동제3투	4178	3543	635	3	3540	2859	675	0	0	4	2
대구광역시	북구	침산3동	침산3동제4투	4376	3767	609	4	3763	2970	782	0	1	4	6
대구광역시	북구	노원동	소계	10498	8080	2418	20	8060	7043	1002	0	1	9	5
대구광역시	북구	노원동	노원동제1투	2011	1624	387	5	1619	1402	214	0	1	1	1
대구광역시	북구	노원동	노원동제2투	3578	2662	916	9	2653	2292	352	0	0	8	1
대구광역시	북구	노원동	노원동제3투	2865	2274	591	4	2270	2004	264	0	0	0	2
대구광역시	북구	노원동	노원동제4투	2044	1520	524	2	1518	1345	172	0	0	0	1
대구광역시	북구	산격1동	소계	10579	8159	2420	31	8128	6932	1172	2	5	9	8
대구광역시	북구	산격1동	산격1동제1투	3632	2729	903	6	2723	2349	364	1	3	4	2
대구광역시	북구	산격1동	산격1동제2투	3600	2885	715	9	2876	2429	439	1	0	4	3
대구광역시	북구	산격1동	산격1동제3투	3347	2545	802	16	2529	2154	369	0	2	1	3
대구광역시	북구	산격2동	소계	10295	8510	1785	11	8499	6914	1561	0	2	11	11
대구광역시	북구	산격2동	산격2동제1투	3218	2657	561	2	2655	2174	474	0	1	3	3
대구광역시	북구	산격2동	산격2동제2투	3059	2419	640	5	2414	1968	440	0	0	1	5
대구광역시	북구	산격2동	산격2동제3투	4018	3434	584	4	3430	2772	647	0	1	7	3
대구광역시	북구	산격3동	소계	8367	6394	1973	11	6383	5065	1296	2	2	9	9
대구광역시	북구	산격3동	산격3동제1투	4058	3050	1008	6	3044	2308	720	2	2	8	4
대구광역시	북구	산격3동	산격3동제2투	4309	3344	965	5	3339	2757	576	0	0	1	5
대구광역시	북구	산격4동	소계	8757	6795	1962	14	6781	5646	1117	0	3	8	7
대구광역시	북구	산격4동	산격4동제1투	2957	2257	700	3	2254	1854	392	0	1	4	3
대구광역시	북구	산격4동	산격4동제2투	3028	2364	664	7	2357	1982	368	0	2	2	3
대구광역시	북구	산격4동	산격4동제3투	2772	2174	598	4	2170	1810	357	0	0	2	1
대구광역시	북구	복현1동	소계	6443	4797	1646	8	4789	3670	1099	1	3	6	10
대구광역시	북구	복현1동	복현1동제1투	3194	2368	826	2	2366	1851	506	1	2	3	3
대구광역시	북구	복현1동	복현1동제2투	3249	2429	820	6	2423	1819	593	0	1	3	7
대구광역시	북구	복현2동	소계	21838	17672	4166	35	17637	13774	3804	3	6	26	24
대구광역시	북구	복현2동	복현2동제1투	4216	3246	970	7	3239	2441	785	1	1	4	7
대구광역시	북구	복현2동	복현2동제2투	3061	2330	731	7	2323	1833	482	0	0	2	6
대구광역시	북구	복현2동	복현2동제3투	3591	3020	571	2	3018	2270	732	0	3	11	2
대구광역시	북구	복현2동	복현2동제4투	3806	3176	630	7	3169	2547	619	0	0	2	1
대구광역시	북구	복현2동	복현2동제5투	3538	2799	739	8	2791	2187	596	1	1	4	2
대구광역시	북구	복현2동	복현2동제6투	3626	3101	525	4	3097	2496	590	1	1	3	6
대구광역시	북구	대현동	소계	14795	11432	3363	26	11406	9153	2225	2	3	8	15
대구광역시	북구	대현동	대현동제1투	3392	2537	855	3	2534	2083	447	0	0	2	2
대구광역시	북구	대현동	대현동제2투	3213	2427	786	5	2422	1913	503	0	0	1	5
대구광역시	북구	대현동	대현동제3투	4205	3127	1078	12	3115	2493	612	1	1	3	5
대구광역시	북구	대현동	대현동제4투	3985	3341	644	6	3335	2664	663	1	2	2	3
대구광역시	북구	검단동	소계	7259	5664	1595	7	5657	4741	894	1	1	4	16
대구광역시	북구	검단동	검단동제1투	3776	2932	844	5	2927	2473	437	1	1	3	12
대구광역시	북구	검단동	검단동제2투	3483	2732	751	2	2730	2268	457	0	0	1	4
대구광역시	북구	무태조야동	소계	23057	18560	4497	24	18536	14477	3999	2	3	34	21
대구광역시	북구	무태조야동	무태조야동제1투	4389	3513	876	6	3507	2708	790	0	1	6	2
대구광역시	북구	무태조야동	무태조야동제2투	3267	2653	614	5	2648	2077	563	1	0	3	4
대구광역시	북구	무태조야동	무태조야동제3투	4015	3235	780	6	3229	2489	731	0	0	6	3
대구광역시	북구	무태조야동	무태조야동제4투	2815	1984	831	1	1983	1585	390	1	1	3	3
대구광역시	북구	무태조야동	무태조야동제5투	2613	2201	412	0	2201	1640	554	0	0	5	2
대구광역시	북구	무태조야동	무태조야동제6투	4250	3625	625	1	3624	2814	798	0	1	8	3
대구광역시	북구	무태조야동	무태조야동제7투	1708	1349	359	5	1344	1164	173	0	0	3	4
대구광역시	북구	관문동	소계	13778	11186	2592	18	11168	9136	2002	1	5	10	14
대구광역시	북구	관문동	관문동제1투	4880	3938	942	4	3934	3119	806	1	1	5	2
대구광역시	북구	관문동	관문동제2투	4627	3700	927	7	3693	3045	637	0	3	2	6
대구광역시	북구	관문동	관문동제3투	1071	841	230	4	837	732	100	0	1	1	3
대구광역시	북구	관문동	관문동제4투	3200	2707	493	3	2704	2240	459	0	0	2	3
대구광역시	북구	태전1동	소계	18648	14729	3919	32	14697	11814	2835	1	5	21	21
대구광역시	북구	태전1동	태전1동제1투	4067	3139	928	6	3133	2545	576	0	1	5	6
대구광역시	북구	태전1동	태전1동제2투	4696	3899	797	8	3891	3168	709	1	1	5	7
대구광역시	북구	태전1동	태전1동제3투	2516	1867	649	4	1863	1509	349	0	0	4	1
대구광역시	북구	태전1동	태전1동제4투	3631	2727	904	8	2719	2198	513	0	3	3	2
대구광역시	북구	태전1동	태전1동제5투	3738	3097	641	6	3091	2394	688	0	0	4	5
대구광역시	북구	태전2동	소계	19963	15991	3972	25	15966	12911	3012	1	4	25	13
대구광역시	북구	태전2동	태전2동제1투	4255	3549	706	5	3544	2883	652	0	1	6	2
대구광역시	북구	태전2동	태전2동제2투	3905	3072	833	7	3065	2529	528	0	1	5	2
대구광역시	북구	태전2동	태전2동제3투	3780	2862	918	5	2857	2317	534	0	1	3	2
대구광역시	북구	태전2동	태전2동제4투	3853	3150	703	5	3145	2545	590	0	0	7	3
대구광역시	북구	태전2동	태전2동제5투	4170	3358	812	3	3355	2637	708	1	1	4	4
대구광역시	북구	구암동	소계	29198	23972	5226	44	23928	18518	5350	1	6	34	19
대구광역시	북구	구암동	구암동제1투	3157	2452	705	10	2442	2027	412	0	0	2	1
대구광역시	북구	구암동	구암동제2투	3831	3236	595	4	3232	2542	684	0	0	6	0
대구광역시	북구	구암동	구암동제3투	3294	2666	628	6	2660	2151	505	0	0	4	0
대구광역시	북구	구암동	구암동제4투	3205	2707	498	5	2702	2125	569	0	2	3	3
대구광역시	북구	구암동	구암동제5투	3707	3008	699	3	3005	2278	718	0	1	6	2
대구광역시	북구	구암동	구암동제6투	3931	3185	746	5	3180	2415	756	0	1	6	2
대구광역시	북구	구암동	구암동제7투	3785	3127	658	5	3122	2324	785	1	1	4	7
대구광역시	북구	구암동	구암동제8투	4288	3591	697	6	3585	2656	921	0	1	3	4
대구광역시	북구	관음동	소계	16294	12665	3629	18	12647	10313	2304	4	4	11	11
대구광역시	북구	관음동	관음동제1투	4303	3100	1203	7	3093	2595	491	1	2	2	2
대구광역시	북구	관음동	관음동제2투	4498	3520	978	5	3515	2844	666	1	0	2	2
대구광역시	북구	관음동	관음동제3투	3609	2795	814	1	2794	2263	522	2	1	3	3
대구광역시	북구	관음동	관음동제4투	3884	3250	634	5	3245	2611	625	0	1	4	4
대구광역시	북구	읍내동	소계	22454	17727	4727	35	17692	14074	3563	5	6	26	18
대구광역시	북구	읍내동	읍내동제1투	4365	3227	1138	6	3221	2580	632	3	1	2	3
대구광역시	북구	읍내동	읍내동제2투	4471	3704	767	4	3700	2881	806	0	1	7	5
대구광역시	북구	읍내동	읍내동제3투	4587	3590	997	6	3584	2841	736	0	0	5	2
대구광역시	북구	읍내동	읍내동제4투	4471	3535	936	7	3528	2857	661	0	1	4	5
대구광역시	북구	읍내동	읍내동제5투	4560	3671	889	12	3659	2915	728	2	3	8	3
대구광역시	북구	동천동	소계	21560	17725	3835	35	17690	13402	4238	2	8	24	16
대구광역시	북구	동천동	동천동제1투	3692	2871	821	9	2862	2238	615	1	2	4	2
대구광역시	북구	동천동	동천동제2투	2884	2349	535	4	2345	1803	536	0	1	1	4
대구광역시	북구	동천동	동천동제3투	3045	2648	397	4	2644	1974	661	1	1	6	1
대구광역시	북구	동천동	동천동제4투	3526	2889	637	7	2882	2202	671	0	1	5	3
대구광역시	북구	동천동	동천동제5투	4436	3778	658	4	3774	2804	961	0	3	3	3
대구광역시	북구	동천동	동천동제6투	3977	3190	787	7	3183	2381	794	0	0	5	3
대구광역시	북구	국우동	소계	18193	14672	3521	19	14653	11143	3476	3	4	15	12
대구광역시	북구	국우동	국우동제1투	4732	3820	912	3	3817	2963	843	1	1	5	4
대구광역시	북구	국우동	국우동제2투	3234	2471	763	5	2466	1932	527	1	0	1	5
대구광역시	북구	국우동	국우동제3투	3655	3022	633	5	3017	2262	750	0	0	3	2
대구광역시	북구	국우동	국우동제4투	3167	2655	512	3	2652	1988	659	0	3	2	0
대구광역시	북구	국우동	국우동제5투	3405	2704	701	3	2701	1998	697	1	0	4	1
대구광역시	북구	잘못 투입·구분된 투표지	잘못 투입·구분된 투표지	0	0	0	0	0	0	0	0	0	0	0
대구광역시	수성구	계	계	353557	286479	67078	586	285893	225052	60016	46	94	441	244
대구광역시	수성구	재외투표	재외투표	1755	1234	521	8	1226	643	580	1	0	2	0
대구광역시	수성구	국내부재자투표	국내부재자투표	11017	10221	796	107	10114	6917	3127	6	17	28	19
대구광역시	수성구	범어1동	소계	13684	11326	2358	15	11311	9048	2228	1	4	21	9
대구광역시	수성구	범어1동	범어1동제1투	4491	3582	909	6	3576	2882	685	0	1	4	4
대구광역시	수성구	범어1동	범어1동제2투	4081	3423	658	4	3419	2745	662	0	1	10	1
대구광역시	수성구	범어1동	범어1동제3투	5112	4321	791	5	4316	3421	881	1	2	7	4
대구광역시	수성구	범어2동	소계	10672	8474	2198	11	8463	6935	1510	1	1	9	7
대구광역시	수성구	범어2동	범어2동제1투	2699	2040	659	3	2037	1569	462	0	0	5	1
대구광역시	수성구	범어2동	범어2동제2투	2574	2027	547	1	2026	1634	384	1	1	2	4
대구광역시	수성구	범어2동	범어2동제3투	2424	1879	545	5	1874	1533	339	0	0	0	2
대구광역시	수성구	범어2동	범어2동제4투	2975	2528	447	2	2526	2199	325	0	0	2	0
대구광역시	수성구	범어3동	소계	8793	7083	1710	15	7068	5497	1557	1	3	7	3
대구광역시	수성구	범어3동	범어3동제1투	4658	3696	962	10	3686	2866	816	0	0	3	1
대구광역시	수성구	범어3동	범어3동제2투	4135	3387	748	5	3382	2631	741	1	3	4	2
대구광역시	수성구	범어4동	소계	13409	11049	2360	13	11036	8651	2349	0	4	18	14
대구광역시	수성구	범어4동	범어4동제1투	3060	2428	632	3	2425	1968	449	0	0	2	6
대구광역시	수성구	범어4동	범어4동제2투	3834	3175	659	1	3174	2379	786	0	0	7	2
대구광역시	수성구	범어4동	범어4동제3투	3049	2522	527	7	2515	2037	467	0	4	4	3
대구광역시	수성구	범어4동	범어4동제4투	3466	2924	542	2	2922	2267	647	0	0	5	3
대구광역시	수성구	만촌1동	소계	19218	15811	3407	22	15789	12449	3303	0	3	26	8
대구광역시	수성구	만촌1동	만촌1동제1투	3627	2875	752	5	2870	2262	601	0	2	3	2
대구광역시	수성구	만촌1동	만촌1동제2투	3733	3221	512	3	3218	2434	777	0	0	7	0
대구광역시	수성구	만촌1동	만촌1동제3투	2845	2351	494	3	2348	1856	483	0	1	6	2
대구광역시	수성구	만촌1동	만촌1동제4투	4374	3433	941	4	3429	2707	713	0	0	6	3
대구광역시	수성구	만촌1동	만촌1동제5투	4639	3931	708	7	3924	3190	729	0	0	4	1
대구광역시	수성구	만촌2동	소계	10359	8283	2076	12	8271	6621	1629	4	0	11	6
대구광역시	수성구	만촌2동	만촌2동제1투	4447	3507	940	4	3503	2726	771	0	0	4	2
대구광역시	수성구	만촌2동	만촌2동제2투	2881	2315	566	3	2312	1898	408	1	0	5	0
대구광역시	수성구	만촌2동	만촌2동제3투	3031	2461	570	5	2456	1997	450	3	0	2	4
대구광역시	수성구	만촌3동	소계	15823	13067	2756	28	13039	10355	2651	4	4	18	7
대구광역시	수성구	만촌3동	만촌3동제1투	4903	3920	983	8	3912	3194	708	2	2	4	2
대구광역시	수성구	만촌3동	만촌3동제2투	3507	2778	729	9	2769	2225	538	0	0	3	3
대구광역시	수성구	만촌3동	만촌3동제3투	2996	2532	464	3	2529	1998	522	1	1	5	2
대구광역시	수성구	만촌3동	만촌3동제4투	4417	3837	580	8	3829	2938	883	1	1	6	0
대구광역시	수성구	수성1가동	소계	14019	11375	2644	21	11354	9155	2169	2	2	15	11
대구광역시	수성구	수성1가동	수성1가동제1투	2839	2278	561	3	2275	1712	559	0	1	2	1
대구광역시	수성구	수성1가동	수성1가동제2투	3437	2902	535	9	2893	2322	562	0	1	3	5
대구광역시	수성구	수성1가동	수성1가동제3투	3818	3176	642	5	3171	2594	566	2	0	7	2
대구광역시	수성구	수성1가동	수성1가동제4투	3925	3019	906	4	3015	2527	482	0	0	3	3
대구광역시	수성구	수성2·3가동	소계	9703	7850	1853	11	7839	6379	1433	0	2	14	11
대구광역시	수성구	수성2·3가동	수성2·3가동제1투	4968	4046	922	6	4040	3268	760	0	1	9	2
대구광역시	수성구	수성2·3가동	수성2·3가동제2투	4735	3804	931	5	3799	3111	673	0	1	5	9
대구광역시	수성구	수성4가동	소계	13457	11115	2342	23	11092	8939	2122	2	1	16	12
대구광역시	수성구	수성4가동	수성4가동제1투	4120	3390	730	7	3383	2690	683	1	0	5	4
대구광역시	수성구	수성4가동	수성4가동제2투	3676	3016	660	6	3010	2441	561	0	1	3	4
대구광역시	수성구	수성4가동	수성4가동제3투	2624	2122	502	4	2118	1759	350	1	0	6	2
대구광역시	수성구	수성4가동	수성4가동제4투	3037	2587	450	6	2581	2049	528	0	0	2	2
대구광역시	수성구	황금1동	소계	17806	14795	3011	29	14766	11567	3160	3	0	27	9
대구광역시	수성구	황금1동	황금1동제1투	4354	3588	766	4	3584	2878	694	0	0	11	1
대구광역시	수성구	황금1동	황금1동제2투	2439	1884	555	11	1873	1533	331	2	0	4	3
대구광역시	수성구	황금1동	황금1동제3투	4167	3452	715	7	3445	2713	727	0	0	3	2
대구광역시	수성구	황금1동	황금1동제4투	3827	3275	552	4	3271	2472	790	1	0	7	1
대구광역시	수성구	황금1동	황금1동제5투	3019	2596	423	3	2593	1971	618	0	0	2	2
대구광역시	수성구	황금2동	소계	10374	7836	2538	15	7821	6399	1397	4	4	12	5
대구광역시	수성구	황금2동	황금2동제1투	3723	2785	938	5	2780	2289	479	0	0	9	3
대구광역시	수성구	황금2동	황금2동제2투	3158	2408	750	5	2403	1946	449	4	2	1	1
대구광역시	수성구	황금2동	황금2동제3투	3493	2643	850	5	2638	2164	469	0	2	2	1
대구광역시	수성구	중동	소계	11379	8497	2882	17	8480	7083	1375	1	1	14	6
대구광역시	수성구	중동	중동제1투	3188	2275	913	5	2270	1887	374	0	0	6	3
대구광역시	수성구	중동	중동제2투	2796	2139	657	3	2136	1804	327	1	0	3	1
대구광역시	수성구	중동	중동제3투	2694	1976	718	3	1973	1658	311	0	1	2	1
대구광역시	수성구	중동	중동제4투	2701	2107	594	6	2101	1734	363	0	0	3	1
대구광역시	수성구	상동	소계	13732	10522	3210	29	10493	8633	1834	1	4	13	8
대구광역시	수성구	상동	상동제1투	3501	2456	1045	3	2453	1992	456	1	1	3	0
대구광역시	수성구	상동	상동제2투	3971	3110	861	9	3101	2575	521	0	1	2	2
대구광역시	수성구	상동	상동제3투	3482	2845	637	9	2836	2345	482	0	1	4	4
대구광역시	수성구	상동	상동제4투	2778	2111	667	8	2103	1721	375	0	1	4	2
대구광역시	수성구	파동	소계	10987	8596	2391	8	8588	7033	1535	1	1	9	9
대구광역시	수성구	파동	파동제1투	3947	3021	926	3	3018	2449	562	0	0	2	5
대구광역시	수성구	파동	파동제2투	3554	2742	812	2	2740	2258	473	0	1	5	3
대구광역시	수성구	파동	파동제3투	3486	2833	653	3	2830	2326	500	1	0	2	1
대구광역시	수성구	두산동	소계	10987	8142	2845	10	8132	6602	1511	1	5	8	5
대구광역시	수성구	두산동	두산동제1투	3646	2598	1048	6	2592	2108	477	0	2	3	2
대구광역시	수성구	두산동	두산동제2투	3660	2578	1082	2	2576	2055	514	1	1	3	2
대구광역시	수성구	두산동	두산동제3투	3681	2966	715	2	2964	2439	520	0	2	2	1
대구광역시	수성구	지산1동	소계	20617	16141	4476	27	16114	13020	3039	2	10	25	18
대구광역시	수성구	지산1동	지산1동제1투	3621	2872	749	3	2869	2305	552	0	3	7	2
대구광역시	수성구	지산1동	지산1동제2투	2504	1960	544	4	1956	1555	398	0	1	1	1
대구광역시	수성구	지산1동	지산1동제3투	2799	2147	652	5	2142	1774	361	0	0	1	6
대구광역시	수성구	지산1동	지산1동제4투	4057	3333	724	7	3326	2676	633	1	3	10	3
대구광역시	수성구	지산1동	지산1동제5투	3843	2966	877	7	2959	2383	568	0	1	4	3
대구광역시	수성구	지산1동	지산1동제6투	3793	2863	930	1	2862	2327	527	1	2	2	3
대구광역시	수성구	지산2동	소계	17912	14357	3555	30	14327	11433	2857	3	3	25	6
대구광역시	수성구	지산2동	지산2동제1투	3692	2756	936	6	2750	2197	541	1	1	8	2
대구광역시	수성구	지산2동	지산2동제2투	4117	3469	648	4	3465	2764	693	2	0	5	1
대구광역시	수성구	지산2동	지산2동제3투	3584	2908	676	5	2903	2303	595	0	1	4	0
대구광역시	수성구	지산2동	지산2동제4투	3217	2561	656	11	2550	2076	468	0	1	4	1
대구광역시	수성구	지산2동	지산2동제5투	3302	2663	639	4	2659	2093	560	0	0	4	2
대구광역시	수성구	범물1동	소계	12015	9410	2605	15	9395	7640	1725	1	2	13	14
대구광역시	수성구	범물1동	범물1동제1투	3236	2351	885	4	2347	1950	392	0	0	1	4
대구광역시	수성구	범물1동	범물1동제2투	2457	1846	611	4	1842	1534	299	0	0	3	6
대구광역시	수성구	범물1동	범물1동제3투	3179	2705	474	2	2703	2118	576	1	1	4	3
대구광역시	수성구	범물1동	범물1동제4투	3143	2508	635	5	2503	2038	458	0	1	5	1
대구광역시	수성구	범물2동	소계	14022	11291	2731	17	11274	8881	2369	1	1	14	8
대구광역시	수성구	범물2동	범물2동제1투	3688	2857	831	4	2853	2277	572	0	0	2	2
대구광역시	수성구	범물2동	범물2동제2투	3190	2539	651	5	2534	1938	588	0	0	5	3
대구광역시	수성구	범물2동	범물2동제3투	3674	3093	581	5	3088	2426	655	1	1	4	1
대구광역시	수성구	범물2동	범물2동제4투	3470	2802	668	3	2799	2240	554	0	0	3	2
대구광역시	수성구	고산1동	소계	24832	20869	3963	36	20833	15586	5181	4	9	38	15
대구광역시	수성구	고산1동	고산1동제1투	2455	2031	424	2	2029	1512	508	0	2	5	2
대구광역시	수성구	고산1동	고산1동제2투	3589	2919	670	5	2914	2283	624	0	2	3	2
대구광역시	수성구	고산1동	고산1동제3투	3599	3006	593	6	3000	2271	721	1	1	4	2
대구광역시	수성구	고산1동	고산1동제4투	3104	2554	550	2	2552	1914	632	1	0	3	2
대구광역시	수성구	고산1동	고산1동제5투	3662	3188	474	9	3179	2447	719	0	2	10	1
대구광역시	수성구	고산1동	고산1동제6투	4696	3922	774	6	3916	2859	1041	1	1	10	4
대구광역시	수성구	고산1동	고산1동제7투	3727	3249	478	6	3243	2300	936	1	1	3	2
대구광역시	수성구	고산2동	소계	21900	18121	3779	21	18100	13708	4344	0	8	31	9
대구광역시	수성구	고산2동	고산2동제1투	4046	3250	796	4	3246	2521	714	0	2	7	2
대구광역시	수성구	고산2동	고산2동제2투	4206	3526	680	4	3522	2641	871	0	3	4	3
대구광역시	수성구	고산2동	고산2동제3투	4351	3532	819	6	3526	2747	777	0	1	1	0
대구광역시	수성구	고산2동	고산2동제4투	4399	3767	632	2	3765	2736	1018	0	1	9	1
대구광역시	수성구	고산2동	고산2동제5투	4898	4046	852	5	4041	3063	964	0	1	10	3
대구광역시	수성구	고산3동	소계	25085	21014	4071	46	20968	15878	5031	2	5	27	25
대구광역시	수성구	고산3동	고산3동제1투	4187	3400	787	9	3391	2632	749	1	0	6	3
대구광역시	수성구	고산3동	고산3동제2투	3778	3085	693	12	3073	2394	670	0	1	3	5
대구광역시	수성구	고산3동	고산3동제3투	3944	3328	616	4	3324	2455	854	0	0	9	6
대구광역시	수성구	고산3동	고산3동제4투	4715	3928	787	6	3922	2908	1005	0	2	6	1
대구광역시	수성구	고산3동	고산3동제5투	3927	3361	566	6	3355	2527	820	1	0	1	6
대구광역시	수성구	고산3동	고산3동제6투	4534	3912	622	9	3903	2962	933	0	2	2	4
대구광역시	수성구	잘못 투입·구분된 투표지	잘못 투입·구분된 투표지	0	0	0	0	0	0	0	0	0	0	0
대구광역시	달서구	계	계	472596	382874	89722	897	381977	304535	76363	82	163	427	407
대구광역시	달서구	재외투표	재외투표	1516	1014	502	13	1001	505	489	0	1	3	3
대구광역시	달서구	국내부재자투표	국내부재자투표	13520	12631	889	159	12472	8545	3854	9	20	14	30
대구광역시	달서구	성당동	소계	21324	16735	4589	34	16701	13495	3155	4	5	14	28
대구광역시	달서구	성당동	성당동제1투	4574	3407	1167	10	3397	2835	551	0	2	1	8
대구광역시	달서구	성당동	성당동제2투	3260	2443	817	8	2435	2043	383	1	0	2	6
대구광역시	달서구	성당동	성당동제3투	4070	3103	967	6	3097	2604	483	1	2	1	6
대구광역시	달서구	성당동	성당동제4투	4675	3907	768	5	3902	2907	982	0	1	9	3
대구광역시	달서구	성당동	성당동제5투	4745	3875	870	5	3870	3106	756	2	0	1	5
대구광역시	달서구	두류1·2동	소계	15611	11766	3845	34	11732	9848	1833	5	11	15	20
대구광역시	달서구	두류1·2동	두류1·2동제1투	2748	1973	775	7	1966	1680	281	0	1	2	2
대구광역시	달서구	두류1·2동	두류1·2동제2투	2983	2263	720	7	2256	1917	323	1	5	6	4
대구광역시	달서구	두류1·2동	두류1·2동제3투	3150	2430	720	10	2420	2079	326	2	2	4	7
대구광역시	달서구	두류1·2동	두류1·2동제4투	3029	2338	691	7	2331	1926	398	0	2	3	2
대구광역시	달서구	두류1·2동	두류1·2동제5투	3701	2762	939	3	2759	2246	505	2	1	0	5
대구광역시	달서구	두류3동	소계	8928	7221	1707	17	7204	5916	1268	0	2	9	9
대구광역시	달서구	두류3동	두류3동제1투	3722	3142	580	7	3135	2551	574	0	0	5	5
대구광역시	달서구	두류3동	두류3동제2투	2938	2200	738	6	2194	1795	394	0	1	3	1
대구광역시	달서구	두류3동	두류3동제3투	2268	1879	389	4	1875	1570	300	0	1	1	3
대구광역시	달서구	본리동	소계	18508	14602	3906	26	14576	11534	3012	2	6	12	10
대구광역시	달서구	본리동	본리동제1투	4911	3839	1072	7	3832	3064	759	1	2	4	2
대구광역시	달서구	본리동	본리동제2투	4365	3156	1209	7	3149	2540	604	0	1	3	1
대구광역시	달서구	본리동	본리동제3투	4609	3735	874	6	3729	2975	747	0	0	3	4
대구광역시	달서구	본리동	본리동제4투	4623	3872	751	6	3866	2955	902	1	3	2	3
대구광역시	달서구	감삼동	소계	21672	17549	4123	34	17515	14329	3142	2	6	17	19
대구광역시	달서구	감삼동	감삼동제1투	3466	2580	886	5	2575	2127	442	1	1	1	3
대구광역시	달서구	감삼동	감삼동제2투	3885	3039	846	4	3035	2555	471	0	1	4	4
대구광역시	달서구	감삼동	감삼동제3투	2937	2283	654	6	2277	1918	353	0	0	3	3
대구광역시	달서구	감삼동	감삼동제4투	3992	3267	725	11	3256	2594	652	1	2	3	4
대구광역시	달서구	감삼동	감삼동제5투	4806	4153	653	6	4147	3289	851	0	2	1	4
대구광역시	달서구	감삼동	감삼동제6투	2586	2227	359	2	2225	1846	373	0	0	5	1
대구광역시	달서구	죽전동	소계	13658	10624	3034	18	10606	8831	1746	5	2	11	11
대구광역시	달서구	죽전동	죽전동제1투	4080	3176	904	5	3171	2675	491	2	0	1	2
대구광역시	달서구	죽전동	죽전동제2투	2847	2213	634	5	2208	1811	389	2	1	3	2
대구광역시	달서구	죽전동	죽전동제3투	3631	2750	881	5	2745	2292	445	0	0	4	4
대구광역시	달서구	죽전동	죽전동제4투	3100	2485	615	3	2482	2053	421	1	1	3	3
대구광역시	달서구	장기동	소계	13996	11425	2571	22	11403	9141	2235	1	7	9	10
대구광역시	달서구	장기동	장기동제1투	4047	3248	799	4	3244	2621	615	0	4	3	1
대구광역시	달서구	장기동	장기동제2투	2230	1757	473	4	1753	1459	287	0	1	3	3
대구광역시	달서구	장기동	장기동제3투	4472	3848	624	8	3840	2994	839	1	1	1	4
대구광역시	달서구	장기동	장기동제4투	3247	2572	675	6	2566	2067	494	0	1	2	2
대구광역시	달서구	용산1동	소계	25462	21195	4267	44	21151	16981	4134	3	4	16	13
대구광역시	달서구	용산1동	용산1동제1투	3587	2856	731	8	2848	2326	519	0	0	1	2
대구광역시	달서구	용산1동	용산1동제2투	3795	3229	566	6	3223	2579	638	1	2	2	1
대구광역시	달서구	용산1동	용산1동제3투	3045	2450	595	4	2446	1964	475	1	1	3	2
대구광역시	달서구	용산1동	용산1동제4투	3590	3096	494	9	3087	2467	612	0	0	5	3
대구광역시	달서구	용산1동	용산1동제5투	3700	2954	746	6	2948	2346	598	0	1	1	2
대구광역시	달서구	용산1동	용산1동제6투	3792	3183	609	9	3174	2587	582	1	0	1	3
대구광역시	달서구	용산1동	용산1동제7투	3953	3427	526	2	3425	2712	710	0	0	3	0
대구광역시	달서구	용산2동	소계	25063	20806	4257	36	20770	16469	4255	5	5	17	19
대구광역시	달서구	용산2동	용산2동제1투	3306	2571	735	4	2567	2100	465	0	0	0	2
대구광역시	달서구	용산2동	용산2동제2투	4340	3339	1001	4	3335	2661	665	1	0	4	4
대구광역시	달서구	용산2동	용산2동제3투	2329	1990	339	2	1988	1572	413	0	1	1	1
대구광역시	달서구	용산2동	용산2동제4투	3725	3258	467	8	3250	2531	714	1	2	0	2
대구광역시	달서구	용산2동	용산2동제5투	4410	3698	712	6	3692	2939	739	1	0	9	4
대구광역시	달서구	용산2동	용산2동제6투	3242	2787	455	7	2780	2169	608	0	1	1	1
대구광역시	달서구	용산2동	용산2동제7투	3711	3163	548	5	3158	2497	651	2	1	2	5
대구광역시	달서구	이곡1동	소계	19839	16265	3574	28	16237	12881	3302	5	8	23	18
대구광역시	달서구	이곡1동	이곡1동제1투	3033	2255	778	6	2249	1833	410	0	2	2	2
대구광역시	달서구	이곡1동	이곡1동제2투	2397	2078	319	1	2077	1686	387	0	2	0	2
대구광역시	달서구	이곡1동	이곡1동제3투	3544	3032	512	3	3029	2339	675	1	0	11	3
대구광역시	달서구	이곡1동	이곡1동제4투	3084	2520	564	8	2512	2007	497	1	1	2	4
대구광역시	달서구	이곡1동	이곡1동제5투	3097	2614	483	3	2611	2057	547	2	1	2	2
대구광역시	달서구	이곡1동	이곡1동제6투	4684	3766	918	7	3759	2959	786	1	2	6	5
대구광역시	달서구	이곡2동	소계	15169	12427	2742	28	12399	9928	2431	4	8	17	11
대구광역시	달서구	이곡2동	이곡2동제1투	3405	2733	672	3	2730	2111	613	0	3	1	2
대구광역시	달서구	이곡2동	이곡2동제2투	3958	3029	929	9	3020	2363	646	2	1	6	2
대구광역시	달서구	이곡2동	이곡2동제3투	3879	3335	544	6	3329	2713	605	2	2	5	2
대구광역시	달서구	이곡2동	이곡2동제4투	3927	3330	597	10	3320	2741	567	0	2	5	5
대구광역시	달서구	신당동	소계	29106	22376	6730	66	22310	17710	4528	5	17	24	26
대구광역시	달서구	신당동	신당동제1투	4120	2826	1294	10	2816	2235	568	1	6	3	3
대구광역시	달서구	신당동	신당동제2투	2386	1702	684	3	1699	1348	345	1	1	4	0
대구광역시	달서구	신당동	신당동제3투	2017	1462	555	4	1458	1146	310	0	1	0	1
대구광역시	달서구	신당동	신당동제4투	3253	2399	854	10	2389	1966	409	0	2	2	10
대구광역시	달서구	신당동	신당동제5투	3626	2812	814	13	2799	2289	499	2	2	4	3
대구광역시	달서구	신당동	신당동제6투	3659	3177	482	5	3172	2559	605	1	0	6	1
대구광역시	달서구	신당동	신당동제7투	3706	2570	1136	9	2561	1916	639	0	2	2	2
대구광역시	달서구	신당동	신당동제8투	4395	3754	641	6	3748	2978	762	0	0	3	5
대구광역시	달서구	신당동	신당동제9투	1944	1674	270	6	1668	1273	391	0	3	0	1
대구광역시	달서구	월성1동	소계	26011	22119	3892	33	22086	16653	5369	5	6	34	19
대구광역시	달서구	월성1동	월성1동제1투	4495	3686	809	4	3682	2720	955	1	0	3	3
대구광역시	달서구	월성1동	월성1동제2투	2884	2456	428	6	2450	1848	594	0	0	4	4
대구광역시	달서구	월성1동	월성1동제3투	3531	3067	464	4	3063	2295	760	1	1	3	3
대구광역시	달서구	월성1동	월성1동제4투	2790	2457	333	4	2453	1791	650	1	3	6	2
대구광역시	달서구	월성1동	월성1동제5투	3921	3306	615	3	3303	2636	657	1	1	7	1
대구광역시	달서구	월성1동	월성1동제6투	2722	2317	405	3	2314	1840	465	0	0	5	4
대구광역시	달서구	월성1동	월성1동제7투	3882	3295	587	5	3290	2418	865	1	0	5	1
대구광역시	달서구	월성1동	월성1동제8투	1786	1535	251	4	1531	1105	423	0	1	1	1
대구광역시	달서구	월성2동	소계	16759	13234	3525	30	13204	10834	2323	3	5	16	23
대구광역시	달서구	월성2동	월성2동제1투	2595	1873	722	4	1869	1597	266	2	0	0	4
대구광역시	달서구	월성2동	월성2동제2투	2830	2243	587	7	2236	1823	407	0	0	3	3
대구광역시	달서구	월성2동	월성2동제3투	3050	2405	645	5	2400	1972	416	0	0	5	7
대구광역시	달서구	월성2동	월성2동제4투	3277	2741	536	4	2737	2227	505	0	2	3	0
대구광역시	달서구	월성2동	월성2동제5투	2378	1823	555	5	1818	1498	307	0	3	4	6
대구광역시	달서구	월성2동	월성2동제6투	2629	2149	480	5	2144	1717	422	1	0	1	3
대구광역시	달서구	진천동	소계	41153	33685	7468	55	33630	26822	6730	7	11	29	31
대구광역시	달서구	진천동	진천동제1투	4761	3700	1061	5	3695	2934	753	0	2	3	3
대구광역시	달서구	진천동	진천동제2투	3958	3182	776	8	3174	2638	531	0	0	4	1
대구광역시	달서구	진천동	진천동제3투	4128	3217	911	8	3209	2700	507	1	0	0	1
대구광역시	달서구	진천동	진천동제4투	3920	3143	777	6	3137	2509	618	0	1	3	6
대구광역시	달서구	진천동	진천동제5투	3732	3204	528	3	3201	2470	722	2	2	1	4
대구광역시	달서구	진천동	진천동제6투	3774	3110	664	1	3109	2470	629	1	1	6	2
대구광역시	달서구	진천동	진천동제7투	3855	3145	710	7	3138	2490	640	0	1	3	4
대구광역시	달서구	진천동	진천동제8투	2815	2360	455	3	2357	1894	459	0	2	1	1
대구광역시	달서구	진천동	진천동제9투	3638	3131	507	1	3130	2367	754	0	0	4	5
대구광역시	달서구	진천동	진천동제10투	4318	3591	727	12	3579	2927	644	1	0	3	4
대구광역시	달서구	진천동	진천동제11투	2254	1902	352	1	1901	1423	473	2	2	1	0
대구광역시	달서구	상인1동	소계	32563	27747	4816	50	27697	21674	5952	2	12	39	18
대구광역시	달서구	상인1동	상인1동제1투	4182	3528	654	5	3523	2800	714	0	2	6	1
대구광역시	달서구	상인1동	상인1동제2투	2637	2231	406	6	2225	1799	421	0	0	3	2
대구광역시	달서구	상인1동	상인1동제3투	3744	3157	587	9	3148	2466	674	0	2	4	2
대구광역시	달서구	상인1동	상인1동제4투	2585	2092	493	9	2083	1658	420	1	2	2	0
대구광역시	달서구	상인1동	상인1동제5투	2309	1982	327	3	1979	1567	404	0	0	5	3
대구광역시	달서구	상인1동	상인1동제6투	3946	3352	594	7	3345	2698	640	0	1	5	1
대구광역시	달서구	상인1동	상인1동제7투	3932	3411	521	2	3409	2609	793	1	0	4	2
대구광역시	달서구	상인1동	상인1동제8투	3631	3173	458	5	3168	2490	670	0	1	2	5
대구광역시	달서구	상인1동	상인1동제9투	2626	2231	395	2	2229	1736	488	0	1	4	0
대구광역시	달서구	상인1동	상인1동제10투	2971	2590	381	2	2588	1851	728	0	3	4	2
대구광역시	달서구	상인2동	소계	19655	15567	4088	25	15542	12673	2830	0	1	17	21
대구광역시	달서구	상인2동	상인2동제1투	3384	2510	874	7	2503	2053	446	0	1	1	2
대구광역시	달서구	상인2동	상인2동제2투	3135	2481	654	2	2479	2033	439	0	0	3	4
대구광역시	달서구	상인2동	상인2동제3투	3142	2437	705	7	2430	1996	424	0	0	5	5
대구광역시	달서구	상인2동	상인2동제4투	3755	3101	654	4	3097	2454	637	0	0	4	2
대구광역시	달서구	상인2동	상인2동제5투	2882	2363	519	2	2361	1909	446	0	0	1	5
대구광역시	달서구	상인2동	상인2동제6투	3357	2675	682	3	2672	2228	438	0	0	3	3
대구광역시	달서구	상인3동	소계	12767	9889	2878	21	9868	8145	1701	2	5	7	8
대구광역시	달서구	상인3동	상인3동제1투	2979	2308	671	1	2307	1877	427	0	1	1	1
대구광역시	달서구	상인3동	상인3동제2투	3389	2685	704	1	2684	2185	495	0	2	1	1
대구광역시	달서구	상인3동	상인3동제3투	3586	2703	883	12	2691	2302	380	2	1	1	5
대구광역시	달서구	상인3동	상인3동제4투	2813	2193	620	7	2186	1781	399	0	1	4	1
대구광역시	달서구	도원동	소계	30787	25884	4903	46	25838	20217	5538	6	10	41	26
대구광역시	달서구	도원동	도원동제1투	3543	2865	678	7	2858	2251	592	3	0	7	5
대구광역시	달서구	도원동	도원동제2투	3140	2567	573	4	2563	1987	565	1	0	5	5
대구광역시	달서구	도원동	도원동제3투	3382	2816	566	8	2808	2191	609	1	1	4	2
대구광역시	달서구	도원동	도원동제4투	2960	2488	472	5	2483	1974	502	0	1	5	1
대구광역시	달서구	도원동	도원동제5투	2664	2292	372	3	2289	1780	503	1	3	2	0
대구광역시	달서구	도원동	도원동제6투	2952	2467	485	5	2462	1934	518	0	2	7	1
대구광역시	달서구	도원동	도원동제7투	3124	2685	439	3	2682	2098	576	0	2	3	3
대구광역시	달서구	도원동	도원동제8투	3736	3212	524	4	3208	2508	693	0	0	4	3
대구광역시	달서구	도원동	도원동제9투	2675	2250	425	3	2247	1803	438	0	0	2	4
대구광역시	달서구	도원동	도원동제10투	2611	2242	369	4	2238	1691	542	0	1	2	2
대구광역시	달서구	송현1동	소계	18626	14072	4554	27	14045	11707	2301	4	3	16	14
대구광역시	달서구	송현1동	송현1동제1투	3495	2683	812	7	2676	2272	398	2	0	2	2
대구광역시	달서구	송현1동	송현1동제2투	3543	2597	946	6	2591	2185	400	0	2	4	0
대구광역시	달서구	송현1동	송현1동제3투	3812	2897	915	5	2892	2391	492	0	0	5	4
대구광역시	달서구	송현1동	송현1동제4투	4222	3213	1009	2	3211	2624	578	0	1	1	7
대구광역시	달서구	송현1동	송현1동제5투	3554	2682	872	7	2675	2235	433	2	0	4	1
대구광역시	달서구	송현2동	소계	18538	14355	4183	31	14324	11714	2575	3	5	14	13
대구광역시	달서구	송현2동	송현2동제1투	3517	2558	959	3	2555	2112	438	0	1	2	2
대구광역시	달서구	송현2동	송현2동제2투	2595	2043	552	7	2036	1682	347	1	0	5	1
대구광역시	달서구	송현2동	송현2동제3투	3290	2490	800	8	2482	2016	458	1	2	2	3
대구광역시	달서구	송현2동	송현2동제4투	3112	2486	626	5	2481	1974	501	0	1	2	3
대구광역시	달서구	송현2동	송현2동제5투	2932	2400	532	2	2398	1953	439	1	1	2	2
대구광역시	달서구	송현2동	송현2동제6투	3092	2378	714	6	2372	1977	392	0	0	1	2
대구광역시	달서구	본동	소계	12365	9686	2679	20	9666	7983	1660	0	3	13	7
대구광역시	달서구	본동	본동제1투	2582	1883	699	4	1879	1557	322	0	0	0	0
대구광역시	달서구	본동	본동제2투	3530	3000	530	8	2992	2457	527	0	0	7	1
대구광역시	달서구	본동	본동제3투	2848	2242	606	5	2237	1788	441	0	2	4	2
대구광역시	달서구	본동	본동제4투	3405	2561	844	3	2558	2181	370	0	1	2	4
대구광역시	달서구	잘못 투입·구분된 투표지	잘못 투입·구분된 투표지	0	0	0	0	0	0	0	0	0	0	0
대구광역시	달성군	계	계	142838	114373	28465	425	113948	92161	21290	41	54	158	244
대구광역시	달성군	재외투표	재외투표	534	374	160	1	373	221	149	1	0	1	1
대구광역시	달성군	국내부재자투표	국내부재자투표	4676	4273	403	113	4160	3045	1043	14	18	20	20
대구광역시	달성군	화원읍	소계	40621	32474	8147	70	32404	26238	6072	5	6	47	36
대구광역시	달성군	화원읍	화원읍제1투	4235	3078	1157	9	3069	2586	468	0	2	5	8
대구광역시	달성군	화원읍	화원읍제2투	4053	3312	741	4	3308	2756	543	0	1	3	5
대구광역시	달성군	화원읍	화원읍제3투	3354	2640	714	6	2634	2221	404	0	1	5	3
대구광역시	달성군	화원읍	화원읍제4투	3662	2375	1287	2	2373	1893	473	1	0	4	2
대구광역시	달성군	화원읍	화원읍제5투	3868	3275	593	5	3270	2543	723	0	0	1	3
대구광역시	달성군	화원읍	화원읍제6투	4121	3384	737	7	3377	2747	619	0	0	9	2
대구광역시	달성군	화원읍	화원읍제7투	1325	1105	220	2	1103	939	159	1	0	4	0
대구광역시	달성군	화원읍	화원읍제8투	2860	2236	624	9	2227	1927	295	0	1	1	3
대구광역시	달성군	화원읍	화원읍제9투	4568	3716	852	10	3706	2982	712	1	0	6	5
대구광역시	달성군	화원읍	화원읍제10투	3178	2675	503	7	2668	2098	564	2	1	1	2
대구광역시	달성군	화원읍	화원읍제11투	2174	1809	365	4	1805	1400	401	0	0	3	1
대구광역시	달성군	화원읍	화원읍제12투	3223	2869	354	5	2864	2146	711	0	0	5	2
대구광역시	달성군	논공읍	소계	16756	12806	3950	40	12766	10420	2290	2	5	18	31
대구광역시	달성군	논공읍	논공읍제1투	1899	1532	367	4	1528	1373	143	0	1	1	10
대구광역시	달성군	논공읍	논공읍제2투	1076	864	212	3	861	747	107	1	1	1	4
대구광역시	달성군	논공읍	논공읍제3투	2967	2184	783	7	2177	1766	404	1	1	3	2
대구광역시	달성군	논공읍	논공읍제4투	1991	1575	416	5	1570	1255	313	0	0	1	1
대구광역시	달성군	논공읍	논공읍제5투	2940	2313	627	8	2305	1805	495	0	2	2	1
대구광역시	달성군	논공읍	논공읍제6투	3272	2294	978	7	2287	1844	432	0	0	4	7
대구광역시	달성군	논공읍	논공읍제7투	2611	2044	567	6	2038	1630	396	0	0	6	6
대구광역시	달성군	다사읍	소계	44184	36244	7940	63	36181	28398	7670	8	20	48	37
대구광역시	달성군	다사읍	다사읍제1투	5016	3913	1103	11	3902	3082	803	2	4	6	5
대구광역시	달성군	다사읍	다사읍제2투	3292	2655	637	3	2652	1998	642	0	2	5	5
대구광역시	달성군	다사읍	다사읍제3투	3284	2550	734	4	2546	2076	459	0	3	6	2
대구광역시	달성군	다사읍	다사읍제4투	725	599	126	2	597	518	76	0	0	0	3
대구광역시	달성군	다사읍	다사읍제5투	3020	2466	554	3	2463	1940	517	0	0	4	2
대구광역시	달성군	다사읍	다사읍제6투	3127	2584	543	8	2576	2031	542	1	0	1	1
대구광역시	달성군	다사읍	다사읍제7투	3671	3028	643	5	3023	2511	499	2	2	4	5
대구광역시	달성군	다사읍	다사읍제8투	4367	3632	735	10	3622	2869	741	0	3	6	3
대구광역시	달성군	다사읍	다사읍제9투	2926	2403	523	0	2403	1931	467	0	1	2	2
대구광역시	달성군	다사읍	다사읍제10투	3861	3259	602	6	3253	2521	722	1	2	3	4
대구광역시	달성군	다사읍	다사읍제11투	4410	3717	693	4	3713	2741	965	1	2	3	1
대구광역시	달성군	다사읍	다사읍제12투	3339	2744	595	5	2739	2178	553	1	1	4	2
대구광역시	달성군	다사읍	다사읍제13투	3146	2694	452	2	2692	2002	684	0	0	4	2
대구광역시	달성군	가창면	소계	7141	5575	1566	27	5548	4641	874	3	1	6	23
대구광역시	달성군	가창면	가창면제1투	2092	1622	470	5	1617	1322	291	1	0	2	1
대구광역시	달성군	가창면	가창면제2투	1709	1327	382	11	1316	1088	218	1	1	2	6
대구광역시	달성군	가창면	가창면제3투	2134	1702	432	8	1694	1445	240	0	0	0	9
대구광역시	달성군	가창면	가창면제4투	1206	924	282	3	921	786	125	1	0	2	7
대구광역시	달성군	하빈면	소계	3815	2992	823	19	2973	2562	392	0	0	4	15
대구광역시	달성군	하빈면	하빈면제1투	1930	1521	409	11	1510	1321	184	0	0	0	5
대구광역시	달성군	하빈면	하빈면제2투	1885	1471	414	8	1463	1241	208	0	0	4	10
대구광역시	달성군	옥포면	소계	8607	6887	1720	23	6864	5943	900	0	1	2	18
대구광역시	달성군	옥포면	옥포면제1투	2963	2389	574	11	2378	2035	339	0	0	0	4
대구광역시	달성군	옥포면	옥포면제2투	2253	1796	457	5	1791	1586	199	0	0	0	6
대구광역시	달성군	옥포면	옥포면제3투	3391	2702	689	7	2695	2322	362	0	1	2	8
대구광역시	달성군	현풍면	소계	8379	6431	1948	36	6395	5406	959	4	0	2	24
대구광역시	달성군	현풍면	현풍면제1투	2569	1965	604	7	1958	1630	320	1	0	1	6
대구광역시	달성군	현풍면	현풍면제2투	2743	2089	654	7	2082	1740	336	0	0	1	5
대구광역시	달성군	현풍면	현풍면제3투	2006	1544	462	8	1536	1328	203	2	0	0	3
대구광역시	달성군	현풍면	현풍면제4투	1061	833	228	14	819	708	100	1	0	0	10
대구광역시	달성군	유가면	소계	2251	1759	492	14	1745	1566	165	0	1	4	9
대구광역시	달성군	유가면	유가면제1투	877	692	185	3	689	631	54	0	1	1	2
대구광역시	달성군	유가면	유가면제2투	1374	1067	307	11	1056	935	111	0	0	3	7
대구광역시	달성군	구지면	소계	5874	4558	1316	19	4539	3721	776	4	2	6	30
대구광역시	달성군	구지면	구지면제1투	1627	1241	386	10	1231	1070	141	2	0	5	13
대구광역시	달성군	구지면	구지면제2투	880	702	178	3	699	626	62	1	1	0	9
대구광역시	달성군	구지면	구지면제3투	3367	2615	752	6	2609	2025	573	1	1	1	8
대구광역시	달성군	잘못 투입·구분된 투표지	잘못 투입·구분된 투표지	0	0	0	0	0	0	0	0	0	0	0
인천광역시	중구	계	계	78606	55585	23021	214	55371	30613	24538	13	25	116	66
인천광역시	중구	재외투표	재외투표	443	292	151	2	290	124	166	0	0	0	0
인천광역시	중구	국내부재자투표	국내부재자투표	1463	1359	104	23	1336	686	639	1	1	3	6
인천광역시	중구	신포동	소계	5215	3621	1594	11	3610	2185	1408	1	3	11	2
인천광역시	중구	신포동	신포동제1투	2701	1993	708	5	1988	1131	847	0	1	7	2
인천광역시	중구	신포동	신포동제2투	2514	1628	886	6	1622	1054	561	1	2	4	0
인천광역시	중구	연안동	소계	6831	4677	2154	15	4662	2765	1880	0	3	13	1
인천광역시	중구	연안동	연안동제1투	1195	770	425	4	766	439	325	0	0	1	1
인천광역시	중구	연안동	연안동제2투	2779	1830	949	4	1826	1101	719	0	1	5	0
인천광역시	중구	연안동	연안동제3투	2857	2077	780	7	2070	1225	836	0	2	7	0
인천광역시	중구	신흥동	소계	12486	9020	3466	27	8993	5204	3756	3	3	18	9
인천광역시	중구	신흥동	신흥동제1투	2931	1982	949	4	1978	1230	741	2	0	3	2
인천광역시	중구	신흥동	신흥동제2투	3586	2732	854	8	2724	1544	1172	1	0	6	1
인천광역시	중구	신흥동	신흥동제3투	769	518	251	1	517	274	243	0	0	0	0
인천광역시	중구	신흥동	신흥동제4투	3098	2379	719	9	2370	1295	1061	0	3	7	4
인천광역시	중구	신흥동	신흥동제5투	2102	1409	693	5	1404	861	539	0	0	2	2
인천광역시	중구	도원동	소계	4188	2839	1349	7	2832	1721	1104	0	0	2	5
인천광역시	중구	도원동	도원동제1투	2334	1538	796	5	1533	903	626	0	0	2	2
인천광역시	중구	도원동	도원동제2투	1854	1301	553	2	1299	818	478	0	0	0	3
인천광역시	중구	율목동	소계	3819	2579	1240	11	2568	1510	1044	0	0	10	4
인천광역시	중구	율목동	율목동투표소	3819	2579	1240	11	2568	1510	1044	0	0	10	4
인천광역시	중구	동인천동	소계	5786	3904	1882	20	3884	2372	1504	1	0	4	3
인천광역시	중구	동인천동	동인천동제1투	1884	1213	671	10	1203	782	417	0	0	2	2
인천광역시	중구	동인천동	동인천동제2투	3902	2691	1211	10	2681	1590	1087	1	0	2	1
인천광역시	중구	북성동	소계	3420	2430	990	17	2413	1425	974	1	1	9	3
인천광역시	중구	북성동	북성동제1투	2522	1741	781	14	1727	1000	718	1	1	6	1
인천광역시	중구	북성동	북성동제2투	898	689	209	3	686	425	256	0	0	3	2
인천광역시	중구	송월동	소계	4807	3456	1351	11	3445	1976	1449	1	4	9	6
인천광역시	중구	송월동	송월동제1투	3060	2204	856	7	2197	1231	953	0	2	6	5
인천광역시	중구	송월동	송월동제2투	1747	1252	495	4	1248	745	496	1	2	3	1
인천광역시	중구	영종동	소계	10862	7555	3307	34	7521	4232	3264	1	3	15	6
인천광역시	중구	영종동	영종동제1투	2244	1536	708	7	1529	997	528	0	1	3	0
인천광역시	중구	영종동	영종동제2투	1479	1075	404	4	1071	482	585	0	1	3	0
인천광역시	중구	영종동	영종동제3투	1952	1350	602	4	1346	863	476	1	0	5	1
인천광역시	중구	영종동	영종동제4투	2364	1532	832	10	1522	997	521	0	0	1	3
인천광역시	중구	영종동	영종동제5투	2823	2062	761	9	2053	893	1154	0	1	3	2
인천광역시	중구	운서동	소계	14720	10736	3984	24	10712	4182	6485	3	7	18	17
인천광역시	중구	운서동	운서동제1투	3322	2616	706	7	2609	937	1664	0	2	5	1
인천광역시	중구	운서동	운서동제2투	3093	2094	999	4	2090	837	1239	0	2	5	7
인천광역시	중구	운서동	운서동제3투	2801	2144	657	9	2135	872	1254	1	2	3	3
인천광역시	중구	운서동	운서동제4투	2450	1558	892	2	1556	650	900	1	0	3	2
인천광역시	중구	운서동	운서동제5투	3054	2324	730	2	2322	886	1428	1	1	2	4
인천광역시	중구	용유동	소계	4566	3117	1449	12	3105	2231	865	1	0	4	4
인천광역시	중구	용유동	용유동제1투	2036	1385	651	1	1384	970	411	1	0	2	0
인천광역시	중구	용유동	용유동제2투	1763	1173	590	10	1163	823	337	0	0	1	2
인천광역시	중구	용유동	용유동제3투	701	508	193	0	508	394	111	0	0	1	2
인천광역시	중구	용유동	용유동제4투	66	51	15	1	50	44	6	0	0	0	0
인천광역시	중구	잘못 투입·구분된 투표지	잘못 투입·구분된 투표지	0	0	0	0	0	0	0	0	0	0	0
인천광역시	동구	계	계	62787	46837	15950	157	46680	25911	20584	15	29	66	75
인천광역시	동구	재외투표	재외투표	248	171	77	3	168	73	94	1	0	0	0
인천광역시	동구	국내부재자투표	국내부재자투표	1079	1019	60	16	1003	479	514	1	4	0	5
인천광역시	동구	만석동	소계	5998	4310	1688	14	4296	2297	1985	0	2	5	7
인천광역시	동구	만석동	만석동제1투	2504	1687	817	9	1678	968	705	0	1	2	2
인천광역시	동구	만석동	만석동제2투	3494	2623	871	5	2618	1329	1280	0	1	3	5
인천광역시	동구	화수1·화평동	소계	6356	4653	1703	13	4640	2709	1908	3	4	11	5
인천광역시	동구	화수1·화평동	화수1·화평동제1투	3101	2152	949	4	2148	1287	853	0	1	4	3
인천광역시	동구	화수1·화평동	화수1·화평동제2투	3255	2501	754	9	2492	1422	1055	3	3	7	2
인천광역시	동구	화수2동	소계	7771	5903	1868	7	5896	3326	2549	3	0	7	11
인천광역시	동구	화수2동	화수2동제1투	2538	1800	738	3	1797	1015	772	1	0	3	6
인천광역시	동구	화수2동	화수2동제2투	2675	1989	686	2	1987	1124	857	1	0	2	3
인천광역시	동구	화수2동	화수2동제3투	2558	2114	444	2	2112	1187	920	1	0	2	2
인천광역시	동구	송현1·2동	소계	9701	7531	2170	9	7522	3946	3547	3	6	12	8
인천광역시	동구	송현1·2동	송현1·2동제1투	3054	2316	738	3	2313	1383	925	0	1	2	2
인천광역시	동구	송현1·2동	송현1·2동제2투	3054	2415	639	3	2412	1270	1133	2	1	4	2
인천광역시	동구	송현1·2동	송현1·2동제3투	3593	2800	793	3	2797	1293	1489	1	4	6	4
인천광역시	동구	송현3동	소계	3934	2907	1027	17	2890	1658	1222	0	2	2	6
인천광역시	동구	송현3동	송현3동제1투	1983	1501	482	10	1491	845	642	0	1	0	3
인천광역시	동구	송현3동	송현3동제2투	1951	1406	545	7	1399	813	580	0	1	2	3
인천광역시	동구	송림1동	소계	2667	1983	684	9	1974	1199	768	0	2	2	3
인천광역시	동구	송림1동	송림1동제1투	1497	1081	416	8	1073	629	441	0	1	1	1
인천광역시	동구	송림1동	송림1동제2투	1170	902	268	1	901	570	327	0	1	1	2
인천광역시	동구	송림2동	소계	3301	2350	951	19	2331	1469	857	0	0	1	4
인천광역시	동구	송림2동	송림2동제1투	1562	1066	496	9	1057	654	401	0	0	1	1
인천광역시	동구	송림2동	송림2동제2투	1739	1284	455	10	1274	815	456	0	0	0	3
인천광역시	동구	송림3·5동	소계	7946	5748	2198	12	5736	3042	2671	1	4	12	6
인천광역시	동구	송림3·5동	송림3·5동제1투	2577	1809	768	4	1805	1020	779	0	2	1	3
인천광역시	동구	송림3·5동	송림3·5동제2투	2492	1782	710	6	1776	1141	627	1	0	5	2
인천광역시	동구	송림3·5동	송림3·5동제3투	2877	2157	720	2	2155	881	1265	0	2	6	1
인천광역시	동구	송림4동	소계	4367	3317	1050	10	3307	1791	1502	1	3	3	7
인천광역시	동구	송림4동	송림4동제1투	1606	1101	505	5	1096	660	428	0	1	3	4
인천광역시	동구	송림4동	송림4동제2투	2761	2216	545	5	2211	1131	1074	1	2	0	3
인천광역시	동구	송림6동	소계	6076	4553	1523	20	4533	2442	2074	1	1	6	9
인천광역시	동구	송림6동	송림6동제1투	2282	1580	702	8	1572	1013	553	1	0	1	4
인천광역시	동구	송림6동	송림6동제2투	3794	2973	821	12	2961	1429	1521	0	1	5	5
인천광역시	동구	금창동	소계	3343	2392	951	8	2384	1480	893	1	1	5	4
인천광역시	동구	금창동	금창동제1투	1654	1148	506	3	1145	720	419	1	0	2	3
인천광역시	동구	금창동	금창동제2투	1689	1244	445	5	1239	760	474	0	1	3	1
인천광역시	남구	계	계	339766	243682	96084	679	243003	133464	108637	79	132	394	297
인천광역시	남구	재외투표	재외투표	1421	970	451	5	965	422	541	0	0	2	0
인천광역시	남구	국내부재자투표	국내부재자투표	6582	6247	335	103	6144	3153	2923	6	19	17	26
인천광역시	남구	숭의1·3동	소계	9999	6882	3117	15	6867	4083	2755	4	6	16	3
인천광역시	남구	숭의1·3동	숭의1·3동제1투	3386	2287	1099	7	2280	1363	908	2	0	6	1
인천광역시	남구	숭의1·3동	숭의1·3동제2투	3677	2505	1172	7	2498	1442	1043	1	3	7	2
인천광역시	남구	숭의1·3동	숭의1·3동제3투	2936	2090	846	1	2089	1278	804	1	3	3	0
인천광역시	남구	숭의2동	소계	8831	6233	2598	16	6217	3812	2387	0	1	5	12
인천광역시	남구	숭의2동	숭의2동제1투	3887	2735	1152	5	2730	1612	1110	0	0	3	5
인천광역시	남구	숭의2동	숭의2동제2투	4944	3498	1446	11	3487	2200	1277	0	1	2	7
인천광역시	남구	숭의4동	소계	13025	9106	3919	36	9070	5272	3758	4	2	21	13
인천광역시	남구	숭의4동	숭의4동제1투	4953	3449	1504	11	3438	2028	1397	1	1	6	5
인천광역시	남구	숭의4동	숭의4동제2투	4121	2818	1303	17	2801	1626	1163	1	0	6	5
인천광역시	남구	숭의4동	숭의4동제3투	3951	2839	1112	8	2831	1618	1198	2	1	9	3
인천광역시	남구	용현1·4동	소계	16772	11883	4889	35	11848	6658	5141	4	13	21	11
인천광역시	남구	용현1·4동	용현1·4동제1투	3626	2374	1252	4	2370	1406	957	1	2	3	1
인천광역시	남구	용현1·4동	용현1·4동제2투	3244	2250	994	6	2244	1301	933	0	1	4	5
인천광역시	남구	용현1·4동	용현1·4동제3투	3965	2868	1097	10	2858	1680	1168	2	3	4	1
인천광역시	남구	용현1·4동	용현1·4동제4투	2593	1945	648	7	1938	991	940	0	4	1	2
인천광역시	남구	용현1·4동	용현1·4동제5투	3344	2446	898	8	2438	1280	1143	1	3	9	2
인천광역시	남구	용현2동	소계	13811	10213	3598	34	10179	5676	4466	2	7	16	12
인천광역시	남구	용현2동	용현2동제1투	3442	2383	1059	10	2373	1237	1127	1	5	2	1
인천광역시	남구	용현2동	용현2동제2투	2257	1552	705	5	1547	944	600	0	0	2	1
인천광역시	남구	용현2동	용현2동제3투	3867	2944	923	9	2935	1690	1239	1	0	1	4
인천광역시	남구	용현2동	용현2동제4투	4245	3334	911	10	3324	1805	1500	0	2	11	6
인천광역시	남구	용현3동	소계	7766	5097	2669	25	5072	3000	2049	1	3	12	7
인천광역시	남구	용현3동	용현3동제1투	3986	2533	1453	13	2520	1548	963	0	1	5	3
인천광역시	남구	용현3동	용현3동제2투	3780	2564	1216	12	2552	1452	1086	1	2	7	4
인천광역시	남구	용현5동	소계	28395	20780	7615	45	20735	11311	9367	9	9	24	15
인천광역시	남구	용현5동	용현5동제1투	4321	3082	1239	13	3069	1647	1413	2	0	6	1
인천광역시	남구	용현5동	용현5동제2투	4140	2847	1293	8	2839	1564	1261	2	2	5	5
인천광역시	남구	용현5동	용현5동제3투	3149	2285	864	4	2281	1306	969	1	1	1	3
인천광역시	남구	용현5동	용현5동제4투	4092	2659	1433	3	2656	1507	1144	1	0	2	2
인천광역시	남구	용현5동	용현5동제5투	4683	3582	1101	5	3577	1939	1632	0	4	1	1
인천광역시	남구	용현5동	용현5동제6투	4589	3647	942	6	3641	2049	1581	1	1	6	3
인천광역시	남구	용현5동	용현5동제7투	3421	2678	743	6	2672	1299	1367	2	1	3	0
인천광역시	남구	학익1동	소계	27008	20719	6289	33	20686	11114	9495	6	7	37	27
인천광역시	남구	학익1동	학익1동제1투	4664	3476	1188	6	3470	1983	1479	0	1	4	3
인천광역시	남구	학익1동	학익1동제2투	3516	2374	1142	4	2370	1264	1096	2	1	2	5
인천광역시	남구	학익1동	학익1동제3투	3762	3083	679	3	3080	1752	1310	2	1	12	3
인천광역시	남구	학익1동	학익1동제4투	3981	2989	992	3	2986	1549	1427	0	1	7	2
인천광역시	남구	학익1동	학익1동제5투	3103	2307	796	3	2304	1206	1093	0	0	1	4
인천광역시	남구	학익1동	학익1동제6투	3098	2351	747	5	2346	1289	1048	1	1	3	4
인천광역시	남구	학익1동	학익1동제7투	4884	4139	745	9	4130	2071	2042	1	2	8	6
인천광역시	남구	학익2동	소계	17002	12825	4177	28	12797	7084	5664	3	3	31	12
인천광역시	남구	학익2동	학익2동제1투	3140	2120	1020	6	2114	1191	917	1	0	3	2
인천광역시	남구	학익2동	학익2동제2투	3279	2168	1111	3	2165	1249	906	1	0	7	2
인천광역시	남구	학익2동	학익2동제3투	3472	2734	738	6	2728	1419	1302	0	1	6	0
인천광역시	남구	학익2동	학익2동제4투	3509	2880	629	4	2876	1643	1222	1	1	5	4
인천광역시	남구	학익2동	학익2동제5투	3602	2923	679	9	2914	1582	1317	0	1	10	4
인천광역시	남구	도화1동	소계	16229	11103	5126	33	11070	6100	4943	4	4	13	6
인천광역시	남구	도화1동	도화1동제1투	5138	3354	1784	9	3345	1832	1509	1	0	1	2
인천광역시	남구	도화1동	도화1동제2투	4053	2711	1342	10	2701	1496	1195	0	0	7	3
인천광역시	남구	도화1동	도화1동제3투	3300	2454	846	3	2451	1324	1122	0	2	2	1
인천광역시	남구	도화1동	도화1동제4투	3738	2584	1154	11	2573	1448	1117	3	2	3	0
인천광역시	남구	도화2·3동	소계	16924	11706	5218	30	11676	6527	5106	1	6	15	21
인천광역시	남구	도화2·3동	도화2·3동제1투	3259	2119	1140	7	2112	1196	911	1	0	2	2
인천광역시	남구	도화2·3동	도화2·3동제2투	4303	3019	1284	4	3015	1659	1346	0	1	5	4
인천광역시	남구	도화2·3동	도화2·3동제3투	4033	2933	1100	8	2925	1536	1378	0	3	2	6
인천광역시	남구	도화2·3동	도화2·3동제4투	2352	1592	760	6	1586	969	607	0	0	4	6
인천광역시	남구	도화2·3동	도화2·3동제5투	2977	2043	934	5	2038	1167	864	0	2	2	3
인천광역시	남구	주안1동	소계	10890	6803	4087	9	6794	3338	3432	4	6	6	8
인천광역시	남구	주안1동	주안1동제1투	5549	3502	2047	5	3497	1677	1812	1	4	3	0
인천광역시	남구	주안1동	주안1동제2투	5341	3301	2040	4	3297	1661	1620	3	2	3	8
인천광역시	남구	주안2동	소계	20661	14146	6515	30	14116	8103	5964	5	5	27	12
인천광역시	남구	주안2동	주안2동제1투	4824	3115	1709	9	3106	1773	1321	1	3	6	2
인천광역시	남구	주안2동	주안2동제2투	4411	3053	1358	8	3045	1774	1261	1	1	6	2
인천광역시	남구	주안2동	주안2동제3투	3604	2592	1012	3	2589	1430	1150	0	0	7	2
인천광역시	남구	주안2동	주안2동제4투	4184	2856	1328	7	2849	1662	1177	1	0	3	6
인천광역시	남구	주안2동	주안2동제5투	3638	2530	1108	3	2527	1464	1055	2	1	5	0
인천광역시	남구	주안3동	소계	10139	7077	3062	23	7054	4071	2957	1	4	11	10
인천광역시	남구	주안3동	주안3동제1투	3493	2375	1118	7	2368	1314	1042	1	3	4	4
인천광역시	남구	주안3동	주안3동제2투	3594	2522	1072	11	2511	1459	1044	0	0	5	3
인천광역시	남구	주안3동	주안3동제3투	3052	2180	872	5	2175	1298	871	0	1	2	3
인천광역시	남구	주안4동	소계	19277	13575	5702	32	13543	7926	5570	1	9	20	17
인천광역시	남구	주안4동	주안4동제1투	4410	3008	1402	10	2998	1682	1301	0	1	10	4
인천광역시	남구	주안4동	주안4동제2투	4151	2938	1213	5	2933	1705	1219	1	1	4	3
인천광역시	남구	주안4동	주안4동제3투	3469	2458	1011	3	2455	1478	969	0	0	3	5
인천광역시	남구	주안4동	주안4동제4투	3444	2471	973	5	2466	1508	954	0	2	1	1
인천광역시	남구	주안4동	주안4동제5투	3803	2700	1103	9	2691	1553	1127	0	5	2	4
인천광역시	남구	주안5동	소계	18841	13585	5256	32	13553	6806	6688	8	6	20	25
인천광역시	남구	주안5동	주안5동제1투	4094	2848	1246	1	2847	1460	1373	0	1	6	7
인천광역시	남구	주안5동	주안5동제2투	4154	3038	1116	7	3031	1518	1495	3	3	10	2
인천광역시	남구	주안5동	주안5동제3투	3113	2288	825	13	2275	1164	1106	1	0	1	3
인천광역시	남구	주안5동	주안5동제4투	3496	2302	1194	5	2297	1164	1121	2	1	2	7
인천광역시	남구	주안5동	주안5동제5투	3984	3109	875	6	3103	1500	1593	2	1	1	6
인천광역시	남구	주안6동	소계	17687	12801	4886	25	12776	6403	6332	4	5	19	13
인천광역시	남구	주안6동	주안6동제1투	3197	2167	1030	7	2160	1058	1096	1	0	4	1
인천광역시	남구	주안6동	주안6동제2투	3883	2536	1347	7	2529	1293	1228	0	2	3	3
인천광역시	남구	주안6동	주안6동제3투	3063	2101	962	4	2097	1195	896	0	1	3	2
인천광역시	남구	주안6동	주안6동제4투	3401	2761	640	4	2757	1285	1462	2	0	5	3
인천광역시	남구	주안6동	주안6동제5투	4143	3236	907	3	3233	1572	1650	1	2	4	4
인천광역시	남구	주안7동	소계	12897	9236	3661	26	9210	5091	4092	5	2	12	8
인천광역시	남구	주안7동	주안7동제1투	3345	2477	868	6	2471	1392	1071	0	0	6	2
인천광역시	남구	주안7동	주안7동제2투	3386	2501	885	9	2492	1372	1112	1	1	4	2
인천광역시	남구	주안7동	주안7동제3투	3200	2132	1068	5	2127	1169	954	0	1	1	2
인천광역시	남구	주안7동	주안7동제4투	2966	2126	840	6	2120	1158	955	4	0	1	2
인천광역시	남구	주안8동	소계	18863	13884	4979	28	13856	7385	6419	5	7	22	18
인천광역시	남구	주안8동	주안8동제1투	3604	2649	955	6	2643	1371	1264	1	0	4	3
인천광역시	남구	주안8동	주안8동제2투	3675	2470	1205	8	2462	1278	1175	1	1	4	3
인천광역시	남구	주안8동	주안8동제3투	3924	2852	1072	5	2847	1554	1281	1	4	5	2
인천광역시	남구	주안8동	주안8동제4투	3810	2996	814	6	2990	1633	1347	1	0	2	7
인천광역시	남구	주안8동	주안8동제5투	3850	2917	933	3	2914	1549	1352	1	2	7	3
인천광역시	남구	관교동	소계	14424	11055	3369	23	11032	6088	4914	1	4	14	11
인천광역시	남구	관교동	관교동제1투	4139	3340	799	6	3334	2077	1251	1	1	4	0
인천광역시	남구	관교동	관교동제2투	3127	2310	817	5	2305	1249	1049	0	1	5	1
인천광역시	남구	관교동	관교동제3투	3133	2494	639	2	2492	1337	1146	0	1	3	5
인천광역시	남구	관교동	관교동제4투	4025	2911	1114	10	2901	1425	1468	0	1	2	5
인천광역시	남구	문학동	소계	12322	7756	4566	13	7743	4041	3674	1	4	13	10
인천광역시	남구	문학동	문학동제1투	4563	2777	1786	3	2774	1388	1375	1	1	3	6
인천광역시	남구	문학동	문학동제2투	3783	2441	1342	5	2436	1262	1165	0	2	3	4
인천광역시	남구	문학동	문학동제3투	3976	2538	1438	5	2533	1391	1134	0	1	7	0
인천광역시	연수구	계	계	224398	172068	52330	491	171577	91538	79429	52	80	315	163
인천광역시	연수구	재외투표	재외투표	1274	850	424	7	843	339	501	0	0	2	1
인천광역시	연수구	국내부재자투표	국내부재자투표	6074	5703	371	88	5615	2851	2715	5	8	18	18
인천광역시	연수구	옥련1동	소계	17079	12865	4214	24	12841	7074	5724	3	8	22	10
인천광역시	연수구	옥련1동	옥련1동제1투	3762	2832	930	2	2830	1600	1221	1	0	6	2
인천광역시	연수구	옥련1동	옥련1동제2투	2230	1593	637	5	1588	962	617	0	4	4	1
인천광역시	연수구	옥련1동	옥련1동제3투	3351	2361	990	5	2356	1383	962	0	3	4	4
인천광역시	연수구	옥련1동	옥련1동제4투	3738	2958	780	5	2953	1495	1457	0	1	0	0
인천광역시	연수구	옥련1동	옥련1동제5투	3998	3121	877	7	3114	1634	1467	2	0	8	3
인천광역시	연수구	옥련2동	소계	18132	13823	4309	28	13795	7497	6266	4	2	20	6
인천광역시	연수구	옥련2동	옥련2동제1투	3239	2244	995	4	2240	1288	943	1	0	6	2
인천광역시	연수구	옥련2동	옥련2동제2투	2896	2093	803	5	2088	1173	911	0	0	4	0
인천광역시	연수구	옥련2동	옥련2동제3투	4244	3388	856	6	3382	1982	1392	0	1	4	3
인천광역시	연수구	옥련2동	옥련2동제4투	3825	2943	882	5	2938	1422	1511	1	0	4	0
인천광역시	연수구	옥련2동	옥련2동제5투	3928	3155	773	8	3147	1632	1509	2	1	2	1
인천광역시	연수구	선학동	소계	16983	12354	4629	30	12324	6698	5576	3	5	25	17
인천광역시	연수구	선학동	선학동제1투	3176	2430	746	4	2426	1286	1133	0	0	6	1
인천광역시	연수구	선학동	선학동제2투	3404	2785	619	6	2779	1573	1199	0	0	4	3
인천광역시	연수구	선학동	선학동제3투	3992	2911	1081	7	2904	1603	1285	1	2	8	5
인천광역시	연수구	선학동	선학동제4투	2692	1531	1161	7	1524	778	743	0	1	1	1
인천광역시	연수구	선학동	선학동제5투	3719	2697	1022	6	2691	1458	1216	2	2	6	7
인천광역시	연수구	연수1동	소계	21018	13460	7558	33	13427	7121	6262	6	5	18	15
인천광역시	연수구	연수1동	연수1동제1투	3607	2586	1021	4	2582	1372	1200	1	0	6	3
인천광역시	연수구	연수1동	연수1동제2투	3612	2823	789	11	2812	1412	1389	1	2	4	4
인천광역시	연수구	연수1동	연수1동제3투	3444	2564	880	3	2561	1441	1112	1	1	3	3
인천광역시	연수구	연수1동	연수1동제4투	3631	1688	1943	3	1685	884	799	0	0	1	1
인천광역시	연수구	연수1동	연수1동제5투	3322	2091	1231	5	2086	1113	969	1	1	2	0
인천광역시	연수구	연수1동	연수1동제6투	3402	1708	1694	7	1701	899	793	2	1	2	4
인천광역시	연수구	연수2동	소계	19303	14747	4556	47	14700	7408	7229	4	11	31	17
인천광역시	연수구	연수2동	연수2동제1투	3872	3043	829	4	3039	1675	1352	0	3	7	2
인천광역시	연수구	연수2동	연수2동제2투	3626	2969	657	7	2962	1405	1550	0	2	4	1
인천광역시	연수구	연수2동	연수2동제3투	3634	2610	1024	14	2596	1397	1176	3	1	8	11
인천광역시	연수구	연수2동	연수2동제4투	2594	2095	499	9	2086	926	1156	1	1	1	1
인천광역시	연수구	연수2동	연수2동제5투	3377	2525	852	5	2520	1207	1302	0	4	5	2
인천광역시	연수구	연수2동	연수2동제6투	2200	1505	695	8	1497	798	693	0	0	6	0
인천광역시	연수구	연수3동	소계	15857	12211	3646	35	12176	6055	6076	3	9	17	16
인천광역시	연수구	연수3동	연수3동제1투	3571	2945	626	3	2942	1469	1464	0	2	3	4
인천광역시	연수구	연수3동	연수3동제2투	3519	2679	840	8	2671	1193	1470	2	2	2	2
인천광역시	연수구	연수3동	연수3동제3투	3200	2451	749	11	2440	1222	1207	0	3	3	5
인천광역시	연수구	연수3동	연수3동제4투	2796	1944	852	7	1937	1138	790	1	1	3	4
인천광역시	연수구	연수3동	연수3동제5투	2771	2192	579	6	2186	1033	1145	0	1	6	1
인천광역시	연수구	청학동	소계	24329	17453	6876	38	17415	9674	7681	8	8	21	23
인천광역시	연수구	청학동	청학동제1투	4689	3274	1415	7	3267	1830	1428	0	2	1	6
인천광역시	연수구	청학동	청학동제2투	3062	2383	679	4	2379	1288	1082	0	2	4	3
인천광역시	연수구	청학동	청학동제3투	3177	2470	707	6	2464	1282	1174	1	0	7	0
인천광역시	연수구	청학동	청학동제4투	3755	2624	1131	5	2619	1400	1209	2	1	3	4
인천광역시	연수구	청학동	청학동제5투	3712	2626	1086	6	2620	1472	1139	2	0	4	3
인천광역시	연수구	청학동	청학동제6투	3166	2191	975	2	2189	1239	938	2	3	1	6
인천광역시	연수구	청학동	청학동제7투	2768	1885	883	8	1877	1163	711	1	0	1	1
인천광역시	연수구	동춘1동	소계	12810	10087	2723	27	10060	5374	4653	1	8	15	9
인천광역시	연수구	동춘1동	동춘1동제1투	2293	1552	741	12	1540	971	567	0	0	1	1
인천광역시	연수구	동춘1동	동춘1동제2투	3447	2847	600	7	2840	1414	1417	0	4	3	2
인천광역시	연수구	동춘1동	동춘1동제3투	3295	2620	675	1	2619	1369	1241	0	1	5	3
인천광역시	연수구	동춘1동	동춘1동제4투	3775	3068	707	7	3061	1620	1428	1	3	6	3
인천광역시	연수구	동춘2동	소계	15933	12778	3155	33	12745	6196	6500	7	4	32	6
인천광역시	연수구	동춘2동	동춘2동제1투	3701	2842	859	8	2834	1298	1526	3	0	3	4
인천광역시	연수구	동춘2동	동춘2동제2투	3911	3151	760	7	3144	1532	1601	1	1	9	0
인천광역시	연수구	동춘2동	동춘2동제3투	3830	3136	694	5	3131	1529	1591	0	2	9	0
인천광역시	연수구	동춘2동	동춘2동제4투	4491	3649	842	13	3636	1837	1782	3	1	11	2
인천광역시	연수구	동춘3동	소계	14587	12198	2389	22	12176	6655	5484	2	3	23	9
인천광역시	연수구	동춘3동	동춘3동제1투	3562	2991	571	7	2984	1734	1239	0	1	9	1
인천광역시	연수구	동춘3동	동춘3동제2투	3730	3102	628	4	3098	1670	1420	0	1	4	3
인천광역시	연수구	동춘3동	동춘3동제3투	4080	3411	669	5	3406	1868	1529	0	0	7	2
인천광역시	연수구	동춘3동	동춘3동제4투	3215	2694	521	6	2688	1383	1296	2	1	3	3
인천광역시	연수구	송도1동	소계	24419	20241	4178	54	20187	11149	8969	3	6	51	9
인천광역시	연수구	송도1동	송도1동제1투	3454	2851	603	9	2842	1396	1438	0	0	5	3
인천광역시	연수구	송도1동	송도1동제2투	3701	3123	578	6	3117	1784	1319	0	0	12	2
인천광역시	연수구	송도1동	송도1동제3투	3600	2952	648	5	2947	1465	1473	0	0	9	0
인천광역시	연수구	송도1동	송도1동제4투	3145	2634	511	6	2628	1443	1179	1	1	4	0
인천광역시	연수구	송도1동	송도1동제5투	3262	2773	489	11	2762	1640	1112	1	2	6	1
인천광역시	연수구	송도1동	송도1동제6투	3293	2657	636	8	2649	1437	1203	1	1	7	0
인천광역시	연수구	송도1동	송도1동제7투	3964	3251	713	9	3242	1984	1245	0	2	8	3
인천광역시	연수구	송도2동	소계	16600	13298	3302	25	13273	7447	5793	3	3	20	7
인천광역시	연수구	송도2동	송도2동제1투	2934	2274	660	6	2268	1226	1034	1	0	3	4
인천광역시	연수구	송도2동	송도2동제2투	2851	2214	637	1	2213	1278	932	0	1	2	0
인천광역시	연수구	송도2동	송도2동제3투	3768	3112	656	7	3105	1771	1323	0	1	8	2
인천광역시	연수구	송도2동	송도2동제4투	2712	2191	521	2	2189	1113	1073	0	1	1	1
인천광역시	연수구	송도2동	송도2동제5투	2976	2379	597	7	2372	1451	915	1	0	5	0
인천광역시	연수구	송도2동	송도2동제6투	1359	1128	231	2	1126	608	516	1	0	1	0
인천광역시	남동구	계	계	393970	293649	100321	739	292910	148815	143099	81	182	458	275
인천광역시	남동구	재외투표	재외투표	1564	1091	473	7	1084	407	670	1	1	4	1
인천광역시	남동구	국내부재자투표	국내부재자투표	8905	8373	532	118	8255	4120	4043	13	19	23	37
인천광역시	남동구	구월1동	소계	22367	15264	7103	45	15219	7509	7658	2	6	26	18
인천광역시	남동구	구월1동	구월1동제1투	3855	2620	1235	9	2611	1240	1365	0	0	2	4
인천광역시	남동구	구월1동	구월1동제2투	3058	2118	940	3	2115	1080	1026	1	0	4	4
인천광역시	남동구	구월1동	구월1동제3투	3512	2718	794	8	2710	1484	1211	0	1	7	7
인천광역시	남동구	구월1동	구월1동제4투	4076	3016	1060	6	3010	1573	1427	0	3	6	1
인천광역시	남동구	구월1동	구월1동제5투	4392	2541	1851	8	2533	994	1534	1	1	2	1
인천광역시	남동구	구월1동	구월1동제6투	3474	2251	1223	11	2240	1138	1095	0	1	5	1
인천광역시	남동구	구월2동	소계	30671	24065	6606	43	24022	12021	11922	6	20	35	18
인천광역시	남동구	구월2동	구월2동제1투	3970	3042	928	5	3037	1537	1490	1	4	5	0
인천광역시	남동구	구월2동	구월2동제2투	4511	3761	750	4	3757	1812	1932	0	3	7	3
인천광역시	남동구	구월2동	구월2동제3투	3942	3241	701	6	3235	1595	1626	1	4	5	4
인천광역시	남동구	구월2동	구월2동제4투	3677	3076	601	3	3073	1479	1585	1	3	5	0
인천광역시	남동구	구월2동	구월2동제5투	4475	3613	862	7	3606	1693	1904	1	1	6	1
인천광역시	남동구	구월2동	구월2동제6투	3206	2428	778	8	2420	1287	1130	1	0	0	2
인천광역시	남동구	구월2동	구월2동제7투	3579	2527	1052	5	2522	1441	1068	0	4	6	3
인천광역시	남동구	구월2동	구월2동제8투	3311	2377	934	5	2372	1177	1187	1	1	1	5
인천광역시	남동구	구월3동	소계	10955	7574	3381	18	7556	4062	3469	0	7	13	5
인천광역시	남동구	구월3동	구월3동제1투	4723	3215	1508	10	3205	1709	1484	0	3	7	2
인천광역시	남동구	구월3동	구월3동제2투	3190	2239	951	3	2236	1225	1007	0	2	2	0
인천광역시	남동구	구월3동	구월3동제3투	3042	2120	922	5	2115	1128	978	0	2	4	3
인천광역시	남동구	구월4동	소계	15666	10359	5307	31	10328	5423	4866	4	6	17	12
인천광역시	남동구	구월4동	구월4동제1투	3236	2048	1188	3	2045	1088	948	2	1	4	2
인천광역시	남동구	구월4동	구월4동제2투	2976	1908	1068	8	1900	1039	856	0	0	4	1
인천광역시	남동구	구월4동	구월4동제3투	3141	2064	1077	5	2059	1050	997	2	3	4	3
인천광역시	남동구	구월4동	구월4동제4투	3534	2453	1081	8	2445	1258	1178	0	1	3	5
인천광역시	남동구	구월4동	구월4동제5투	2779	1886	893	7	1879	988	887	0	1	2	1
인천광역시	남동구	간석1동	소계	21056	15252	5804	32	15220	7819	7344	4	7	37	9
인천광역시	남동구	간석1동	간석1동제1투	5407	3769	1638	6	3763	1781	1969	0	1	9	3
인천광역시	남동구	간석1동	간석1동제2투	4919	3252	1667	9	3243	1742	1492	1	1	6	1
인천광역시	남동구	간석1동	간석1동제3투	3502	2571	931	9	2562	1223	1326	2	2	7	2
인천광역시	남동구	간석1동	간석1동제4투	3903	3184	719	4	3180	1738	1431	1	2	5	3
인천광역시	남동구	간석1동	간석1동제5투	3325	2476	849	4	2472	1335	1126	0	1	10	0
인천광역시	남동구	간석2동	소계	15670	12421	3249	27	12394	6679	5677	4	6	17	11
인천광역시	남동구	간석2동	간석2동제1투	2838	1959	879	4	1955	1116	831	1	1	2	4
인천광역시	남동구	간석2동	간석2동제2투	2585	1858	727	6	1852	1063	785	0	1	1	2
인천광역시	남동구	간석2동	간석2동제3투	4288	3585	703	7	3578	1824	1743	2	1	5	3
인천광역시	남동구	간석2동	간석2동제4투	3644	3090	554	7	3083	1627	1445	1	2	8	0
인천광역시	남동구	간석2동	간석2동제5투	2315	1929	386	3	1926	1049	873	0	1	1	2
인천광역시	남동구	간석3동	소계	22943	15546	7397	30	15516	8147	7310	6	12	17	24
인천광역시	남동구	간석3동	간석3동제1투	4789	3046	1743	4	3042	1635	1393	3	4	2	5
인천광역시	남동구	간석3동	간석3동제2투	4196	2553	1643	6	2547	1330	1202	0	1	2	12
인천광역시	남동구	간석3동	간석3동제3투	3284	2197	1087	5	2192	1204	987	0	0	1	0
인천광역시	남동구	간석3동	간석3동제4투	3757	2937	820	9	2928	1471	1448	1	4	2	2
인천광역시	남동구	간석3동	간석3동제5투	4670	3192	1478	4	3188	1653	1523	1	0	7	4
인천광역시	남동구	간석3동	간석3동제6투	2247	1621	626	2	1619	854	757	1	3	3	1
인천광역시	남동구	간석4동	소계	23500	17284	6216	36	17248	8874	8330	0	14	15	15
인천광역시	남동구	간석4동	간석4동제1투	3772	2533	1239	4	2529	1370	1153	0	4	1	1
인천광역시	남동구	간석4동	간석4동제2투	4725	3120	1605	7	3113	1548	1555	0	3	5	2
인천광역시	남동구	간석4동	간석4동제3투	4427	3411	1016	7	3404	1863	1536	0	4	0	1
인천광역시	남동구	간석4동	간석4동제4투	3606	2970	636	4	2966	1539	1420	0	1	4	2
인천광역시	남동구	간석4동	간석4동제5투	3267	2380	887	9	2371	1133	1230	0	2	4	2
인천광역시	남동구	간석4동	간석4동제6투	3703	2870	833	5	2865	1421	1436	0	0	1	7
인천광역시	남동구	만수1동	소계	15647	10901	4746	37	10864	5811	5018	4	6	12	13
인천광역시	남동구	만수1동	만수1동제1투	3361	2466	895	6	2460	1248	1205	2	0	3	2
인천광역시	남동구	만수1동	만수1동제2투	3186	2107	1079	6	2101	1140	958	0	0	0	3
인천광역시	남동구	만수1동	만수1동제3투	3814	2582	1232	9	2573	1387	1178	1	2	2	3
인천광역시	남동구	만수1동	만수1동제4투	2696	1869	827	10	1859	1107	740	1	3	4	4
인천광역시	남동구	만수1동	만수1동제5투	2590	1877	713	6	1871	929	937	0	1	3	1
인천광역시	남동구	만수2동	소계	23874	18276	5598	33	18243	8856	9320	5	7	32	23
인천광역시	남동구	만수2동	만수2동제1투	3174	2239	935	3	2236	1092	1139	0	0	2	3
인천광역시	남동구	만수2동	만수2동제2투	4774	3462	1312	6	3456	1660	1783	0	1	6	6
인천광역시	남동구	만수2동	만수2동제3투	4605	3452	1153	6	3446	1781	1654	1	0	4	6
인천광역시	남동구	만수2동	만수2동제4투	3769	2874	895	4	2870	1447	1408	2	3	7	3
인천광역시	남동구	만수2동	만수2동제5투	4083	3434	649	8	3426	1637	1776	0	2	8	3
인천광역시	남동구	만수2동	만수2동제6투	3469	2815	654	6	2809	1239	1560	2	1	5	2
인천광역시	남동구	만수3동	소계	15761	11706	4055	34	11672	5949	5692	1	5	16	9
인천광역시	남동구	만수3동	만수3동제1투	4586	3403	1183	6	3397	1691	1695	0	0	5	6
인천광역시	남동구	만수3동	만수3동제2투	2727	1796	931	6	1790	970	818	0	1	1	0
인천광역시	남동구	만수3동	만수3동제3투	3165	2179	986	7	2172	1162	1006	1	0	2	1
인천광역시	남동구	만수3동	만수3동제4투	5283	4328	955	15	4313	2126	2173	0	4	8	2
인천광역시	남동구	만수4동	소계	16405	12710	3695	26	12684	6314	6325	3	6	27	9
인천광역시	남동구	만수4동	만수4동제1투	3082	2228	854	9	2219	1076	1136	0	0	3	4
인천광역시	남동구	만수4동	만수4동제2투	3146	2529	617	2	2527	1286	1236	0	1	2	2
인천광역시	남동구	만수4동	만수4동제3투	3411	2660	751	4	2656	1239	1409	0	0	8	0
인천광역시	남동구	만수4동	만수4동제4투	3685	2968	717	4	2964	1483	1465	2	5	7	2
인천광역시	남동구	만수4동	만수4동제5투	3081	2325	756	7	2318	1230	1079	1	0	7	1
인천광역시	남동구	만수5동	소계	15665	10998	4667	29	10969	5832	5099	3	6	24	5
인천광역시	남동구	만수5동	만수5동제1투	4134	2789	1345	10	2779	1466	1306	1	2	3	1
인천광역시	남동구	만수5동	만수5동제2투	4018	3090	928	7	3083	1674	1393	1	1	12	2
인천광역시	남동구	만수5동	만수5동제3투	3571	2476	1095	4	2472	1311	1153	1	2	4	1
인천광역시	남동구	만수5동	만수5동제4투	3942	2643	1299	8	2635	1381	1247	0	1	5	1
인천광역시	남동구	만수6동	소계	22471	17122	5349	28	17094	8677	8370	2	10	19	16
인천광역시	남동구	만수6동	만수6동제1투	3332	2327	1005	3	2324	1246	1066	0	2	5	5
인천광역시	남동구	만수6동	만수6동제2투	3553	2736	817	5	2731	1329	1395	0	1	3	3
인천광역시	남동구	만수6동	만수6동제3투	4086	3085	1001	5	3080	1534	1540	1	2	2	1
인천광역시	남동구	만수6동	만수6동제4투	3882	3145	737	5	3140	1588	1544	1	4	3	0
인천광역시	남동구	만수6동	만수6동제5투	4160	2999	1161	6	2993	1352	1632	0	1	3	5
인천광역시	남동구	만수6동	만수6동제6투	3458	2830	628	4	2826	1628	1193	0	0	3	2
인천광역시	남동구	장수서창동	소계	19829	15680	4149	46	15634	7732	7831	10	18	31	12
인천광역시	남동구	장수서창동	장수서창동제1투	4687	3699	988	9	3690	1834	1843	0	7	5	1
인천광역시	남동구	장수서창동	장수서창동제2투	335	262	73	2	260	202	54	0	1	1	2
인천광역시	남동구	장수서창동	장수서창동제3투	4419	3327	1092	11	3316	1777	1523	3	3	7	3
인천광역시	남동구	장수서창동	장수서창동제4투	2906	2421	485	2	2419	1177	1231	1	2	8	0
인천광역시	남동구	장수서창동	장수서창동제5투	3332	2518	814	14	2504	1185	1307	5	1	3	3
인천광역시	남동구	장수서창동	장수서창동제6투	2015	1658	357	4	1654	757	888	0	2	5	2
인천광역시	남동구	장수서창동	장수서창동제7투	2135	1795	340	4	1791	800	985	1	2	2	1
인천광역시	남동구	남촌도림동	소계	19083	13922	5161	33	13889	7403	6435	4	5	32	10
인천광역시	남동구	남촌도림동	남촌도림동제1투	3196	2090	1106	5	2085	1169	907	2	1	2	4
인천광역시	남동구	남촌도림동	남촌도림동제2투	3528	2547	981	4	2543	1309	1220	0	3	8	3
인천광역시	남동구	남촌도림동	남촌도림동제3투	4386	3170	1216	9	3161	1660	1494	2	0	4	1
인천광역시	남동구	남촌도림동	남촌도림동제4투	4813	3583	1230	12	3571	1984	1575	0	0	11	1
인천광역시	남동구	남촌도림동	남촌도림동제5투	3160	2532	628	3	2529	1281	1239	0	1	7	1
인천광역시	남동구	논현1동	소계	22880	17197	5683	28	17169	8342	8789	2	12	17	7
인천광역시	남동구	논현1동	논현1동제1투	3154	2307	847	7	2300	937	1356	1	2	3	1
인천광역시	남동구	논현1동	논현1동제2투	2456	1623	833	2	1621	826	789	1	2	2	1
인천광역시	남동구	논현1동	논현1동제3투	3501	2723	778	2	2721	1278	1435	0	2	4	2
인천광역시	남동구	논현1동	논현1동제4투	3342	2238	1104	6	2232	1207	1020	0	1	4	0
인천광역시	남동구	논현1동	논현1동제5투	3024	2222	802	3	2219	1048	1167	0	1	1	2
인천광역시	남동구	논현1동	논현1동제6투	4408	3666	742	5	3661	1764	1892	0	3	2	0
인천광역시	남동구	논현1동	논현1동제7투	2995	2418	577	3	2415	1282	1130	0	1	1	1
인천광역시	남동구	논현2동	소계	25367	19125	6242	32	19093	9563	9485	5	8	26	6
인천광역시	남동구	논현2동	논현2동제1투	3866	2628	1238	8	2620	1324	1293	1	1	1	0
인천광역시	남동구	논현2동	논현2동제2투	2649	2205	444	4	2201	1216	979	0	1	3	2
인천광역시	남동구	논현2동	논현2동제3투	2826	2232	594	1	2231	1246	979	0	1	3	2
인천광역시	남동구	논현2동	논현2동제4투	4578	3205	1373	9	3196	1529	1660	0	2	5	0
인천광역시	남동구	논현2동	논현2동제5투	4660	3507	1153	6	3501	1633	1863	0	1	4	0
인천광역시	남동구	논현2동	논현2동제6투	2815	2310	505	2	2308	1168	1131	3	1	4	1
인천광역시	남동구	논현2동	논현2동제7투	2555	2008	547	1	2007	885	1117	1	1	3	0
인천광역시	남동구	논현2동	논현2동제8투	1418	1030	388	1	1029	562	463	0	0	3	1
인천광역시	남동구	논현고잔동	소계	23691	18783	4908	26	18757	9275	9446	2	1	18	15
인천광역시	남동구	논현고잔동	논현고잔동제1투	1639	1315	324	0	1315	668	643	0	0	2	2
인천광역시	남동구	논현고잔동	논현고잔동제2투	4984	3557	1427	7	3550	1850	1694	0	0	1	5
인천광역시	남동구	논현고잔동	논현고잔동제3투	2327	1928	399	2	1926	852	1071	0	0	2	1
인천광역시	남동구	논현고잔동	논현고잔동제4투	3922	3186	736	5	3181	1336	1838	1	0	6	0
인천광역시	남동구	논현고잔동	논현고잔동제5투	3166	2635	531	5	2630	1601	1025	0	0	2	2
인천광역시	남동구	논현고잔동	논현고잔동제6투	3709	3097	612	2	3095	1390	1696	1	1	4	3
인천광역시	남동구	논현고잔동	논현고잔동제7투	3006	2490	516	3	2487	1233	1252	0	0	1	1
인천광역시	남동구	논현고잔동	논현고잔동제8투	938	575	363	2	573	345	227	0	0	0	1
인천광역시	부평구	계	계	445709	330418	115291	956	329462	159386	168820	104	242	553	357
인천광역시	부평구	재외투표	재외투표	2003	1389	614	7	1382	552	824	0	0	4	2
인천광역시	부평구	국내부재자투표	국내부재자투표	9886	9297	589	156	9141	4383	4633	16	27	38	44
인천광역시	부평구	부평1동	소계	27238	20720	6518	42	20678	10157	10456	5	18	30	12
인천광역시	부평구	부평1동	부평1동제1투	3893	2904	989	4	2900	1390	1501	0	0	6	3
인천광역시	부평구	부평1동	부평1동제2투	5011	3285	1726	7	3278	1482	1787	0	6	2	1
인천광역시	부평구	부평1동	부평1동제3투	3640	3051	589	9	3042	1628	1408	1	1	1	3
인천광역시	부평구	부평1동	부평1동제4투	4068	3265	803	10	3255	1679	1568	1	2	5	0
인천광역시	부평구	부평1동	부평1동제5투	3807	2989	818	3	2986	1442	1529	3	1	8	3
인천광역시	부평구	부평1동	부평1동제6투	4410	3526	884	4	3522	1702	1806	0	7	6	1
인천광역시	부평구	부평1동	부평1동제7투	2409	1700	709	5	1695	834	857	0	1	2	1
인천광역시	부평구	부평2동	소계	17785	12255	5530	19	12236	5776	6428	2	6	11	13
인천광역시	부평구	부평2동	부평2동제1투	3896	2519	1377	5	2514	1219	1285	1	2	5	2
인천광역시	부평구	부평2동	부평2동제2투	3448	2429	1019	3	2426	1120	1302	0	1	0	3
인천광역시	부평구	부평2동	부평2동제3투	3635	2494	1141	3	2491	1152	1334	1	0	2	2
인천광역시	부평구	부평2동	부평2동제4투	3661	2618	1043	4	2614	1204	1402	0	3	2	3
인천광역시	부평구	부평2동	부평2동제5투	3145	2195	950	4	2191	1081	1105	0	0	2	3
인천광역시	부평구	부평3동	소계	12605	8593	4012	31	8562	4331	4204	5	6	10	6
인천광역시	부평구	부평3동	부평3동제1투	4593	3009	1584	11	2998	1477	1508	3	6	3	1
인천광역시	부평구	부평3동	부평3동제2투	1963	1387	576	7	1380	737	641	0	0	0	2
인천광역시	부평구	부평3동	부평3동제3투	3549	2531	1018	6	2525	1259	1261	1	0	1	3
인천광역시	부평구	부평3동	부평3동제4투	2500	1666	834	7	1659	858	794	1	0	6	0
인천광역시	부평구	부평4동	소계	21287	13987	7300	35	13952	6844	7057	0	17	20	14
인천광역시	부평구	부평4동	부평4동제1투	5555	3473	2082	7	3466	1752	1695	0	6	9	4
인천광역시	부평구	부평4동	부평4동제2투	4683	3028	1655	8	3020	1403	1611	0	0	3	3
인천광역시	부평구	부평4동	부평4동제3투	2752	1805	947	3	1802	860	934	0	1	5	2
인천광역시	부평구	부평4동	부평4동제4투	4249	2907	1342	6	2901	1351	1542	0	3	2	3
인천광역시	부평구	부평4동	부평4동제5투	4048	2774	1274	11	2763	1478	1275	0	7	1	2
인천광역시	부평구	부평5동	소계	19970	13477	6493	31	13446	6583	6807	1	16	22	17
인천광역시	부평구	부평5동	부평5동제1투	5422	3279	2143	9	3270	1587	1669	0	4	5	5
인천광역시	부평구	부평5동	부평5동제2투	4814	3307	1507	6	3301	1562	1725	0	2	8	4
인천광역시	부평구	부평5동	부평5동제3투	4351	3073	1278	4	3069	1567	1496	0	2	2	2
인천광역시	부평구	부평5동	부평5동제4투	5383	3818	1565	12	3806	1867	1917	1	8	7	6
인천광역시	부평구	부평6동	소계	13101	9096	4005	37	9059	4222	4806	3	5	13	10
인천광역시	부평구	부평6동	부평6동제1투	2786	1809	977	5	1804	913	885	0	0	3	3
인천광역시	부평구	부평6동	부평6동제2투	2960	2102	858	19	2083	1021	1056	1	0	2	3
인천광역시	부평구	부평6동	부평6동제3투	3449	2349	1100	6	2343	1035	1298	2	2	4	2
인천광역시	부평구	부평6동	부평6동제4투	3906	2836	1070	7	2829	1253	1567	0	3	4	2
인천광역시	부평구	산곡1동	소계	16276	11360	4916	49	11311	5845	5423	3	10	16	14
인천광역시	부평구	산곡1동	산곡1동제1투	3282	2023	1259	8	2015	1120	890	1	1	2	1
인천광역시	부평구	산곡1동	산곡1동제2투	3325	2496	829	13	2483	1319	1153	0	3	4	4
인천광역시	부평구	산곡1동	산곡1동제3투	3152	2240	912	10	2230	1179	1041	0	3	4	3
인천광역시	부평구	산곡1동	산곡1동제4투	3242	2314	928	12	2302	1127	1168	0	1	4	2
인천광역시	부평구	산곡1동	산곡1동제5투	3275	2287	988	6	2281	1100	1171	2	2	2	4
인천광역시	부평구	산곡2동	소계	26244	20787	5457	44	20743	10019	10670	4	8	26	16
인천광역시	부평구	산곡2동	산곡2동제1투	4085	3181	904	3	3178	1432	1736	0	4	5	1
인천광역시	부평구	산곡2동	산곡2동제2투	3392	2784	608	7	2777	1318	1450	2	1	6	0
인천광역시	부평구	산곡2동	산곡2동제3투	5208	4086	1122	6	4080	1986	2081	1	2	5	5
인천광역시	부평구	산곡2동	산곡2동제4투	4695	3765	930	14	3751	1942	1804	0	1	3	1
인천광역시	부평구	산곡2동	산곡2동제5투	4613	3631	982	5	3626	1764	1853	1	0	3	5
인천광역시	부평구	산곡2동	산곡2동제6투	4251	3340	911	9	3331	1577	1746	0	0	4	4
인천광역시	부평구	산곡3동	소계	20698	16069	4629	44	16025	8626	7341	2	8	33	15
인천광역시	부평구	산곡3동	산곡3동제1투	4415	3586	829	10	3576	1921	1640	0	4	8	3
인천광역시	부평구	산곡3동	산곡3동제2투	3871	2949	922	9	2940	1585	1342	0	0	8	5
인천광역시	부평구	산곡3동	산곡3동제3투	2709	2173	536	6	2167	1109	1053	0	1	4	0
인천광역시	부평구	산곡3동	산곡3동제4투	3166	2271	895	6	2265	1186	1066	1	2	6	4
인천광역시	부평구	산곡3동	산곡3동제5투	3121	2584	537	8	2576	1445	1124	0	0	5	2
인천광역시	부평구	산곡3동	산곡3동제6투	3416	2506	910	5	2501	1380	1116	1	1	2	1
인천광역시	부평구	산곡4동	소계	15371	12272	3099	25	12247	6204	6012	9	6	13	3
인천광역시	부평구	산곡4동	산곡4동제1투	4000	3174	826	11	3163	1547	1605	1	4	5	1
인천광역시	부평구	산곡4동	산곡4동제2투	3463	2666	797	3	2663	1359	1300	2	0	1	1
인천광역시	부평구	산곡4동	산곡4동제3투	4378	3589	789	6	3583	1868	1704	5	1	4	1
인천광역시	부평구	산곡4동	산곡4동제4투	3530	2843	687	5	2838	1430	1403	1	1	3	0
인천광역시	부평구	청천1동	소계	13276	8774	4502	31	8743	4582	4123	4	3	18	13
인천광역시	부평구	청천1동	청천1동제1투	2927	2013	914	15	1998	1067	922	1	1	5	2
인천광역시	부평구	청천1동	청천1동제2투	3479	2170	1309	8	2162	1134	1019	1	1	5	2
인천광역시	부평구	청천1동	청천1동제3투	3247	2113	1134	7	2106	1129	972	0	0	1	4
인천광역시	부평구	청천1동	청천1동제4투	3623	2478	1145	1	2477	1252	1210	2	1	7	5
인천광역시	부평구	청천2동	소계	28579	21621	6958	64	21557	10206	11259	4	26	36	26
인천광역시	부평구	청천2동	청천2동제1투	3958	2417	1541	8	2409	1185	1212	1	2	6	3
인천광역시	부평구	청천2동	청천2동제2투	3965	3041	924	9	3032	1504	1516	0	4	3	5
인천광역시	부평구	청천2동	청천2동제3투	3396	2807	589	5	2802	1391	1391	2	9	4	5
인천광역시	부평구	청천2동	청천2동제4투	3336	2674	662	0	2674	1155	1506	0	2	8	3
인천광역시	부평구	청천2동	청천2동제5투	3339	2774	565	11	2763	1225	1530	0	4	2	2
인천광역시	부평구	청천2동	청천2동제6투	3279	2536	743	14	2522	1136	1374	1	2	6	3
인천광역시	부평구	청천2동	청천2동제7투	3537	2665	872	6	2659	1201	1449	0	2	3	4
인천광역시	부평구	청천2동	청천2동제8투	3769	2707	1062	11	2696	1409	1281	0	1	4	1
인천광역시	부평구	갈산1동	소계	14710	10567	4143	33	10534	4965	5527	6	10	11	15
인천광역시	부평구	갈산1동	갈산1동제1투	2997	1957	1040	3	1954	958	988	0	2	3	3
인천광역시	부평구	갈산1동	갈산1동제2투	3914	2799	1115	14	2785	1348	1430	1	2	2	2
인천광역시	부평구	갈산1동	갈산1동제3투	4005	2991	1014	11	2980	1428	1540	2	2	4	4
인천광역시	부평구	갈산1동	갈산1동제4투	3794	2820	974	5	2815	1231	1569	3	4	2	6
인천광역시	부평구	갈산2동	소계	18489	14081	4408	34	14047	6873	7118	3	5	25	23
인천광역시	부평구	갈산2동	갈산2동제1투	4152	3340	812	2	3338	1664	1662	1	1	5	5
인천광역시	부평구	갈산2동	갈산2동제2투	3865	2823	1042	6	2817	1242	1559	0	2	6	8
인천광역시	부평구	갈산2동	갈산2동제3투	3861	2973	888	12	2961	1505	1442	2	1	6	5
인천광역시	부평구	갈산2동	갈산2동제4투	4404	3465	939	8	3457	1740	1709	0	1	4	3
인천광역시	부평구	갈산2동	갈산2동제5투	2207	1480	727	6	1474	722	746	0	0	4	2
인천광역시	부평구	삼산1동	소계	30166	22719	7447	61	22658	10250	12326	4	15	41	22
인천광역시	부평구	삼산1동	삼산1동제1투	4210	2931	1279	13	2918	1337	1575	0	3	3	0
인천광역시	부평구	삼산1동	삼산1동제2투	5303	4069	1234	4	4065	1986	2065	1	4	6	3
인천광역시	부평구	삼산1동	삼산1동제3투	3768	2793	975	7	2786	1300	1475	2	1	6	2
인천광역시	부평구	삼산1동	삼산1동제4투	4247	3224	1023	6	3218	1265	1945	0	2	2	4
인천광역시	부평구	삼산1동	삼산1동제5투	2665	1854	811	16	1838	1114	709	1	0	5	9
인천광역시	부평구	삼산1동	삼산1동제6투	5758	4423	1335	9	4414	2002	2397	0	1	11	3
인천광역시	부평구	삼산1동	삼산1동제7투	4215	3425	790	6	3419	1246	2160	0	4	8	1
인천광역시	부평구	삼산2동	소계	22331	18004	4327	29	17975	7930	9986	8	3	32	16
인천광역시	부평구	삼산2동	삼산2동제1투	4312	3369	943	3	3366	1282	2072	1	1	6	4
인천광역시	부평구	삼산2동	삼산2동제2투	3687	3116	571	2	3114	1154	1951	3	1	4	1
인천광역시	부평구	삼산2동	삼산2동제3투	3230	2554	676	8	2546	1296	1248	0	0	2	0
인천광역시	부평구	삼산2동	삼산2동제4투	3594	2696	898	6	2690	1331	1342	1	0	7	9
인천광역시	부평구	삼산2동	삼산2동제5투	4007	3422	585	9	3413	1639	1763	1	1	8	1
인천광역시	부평구	삼산2동	삼산2동제6투	3501	2847	654	1	2846	1228	1610	2	0	5	1
인천광역시	부평구	부개1동	소계	16398	11614	4784	29	11585	5867	5669	7	4	18	20
인천광역시	부평구	부개1동	부개1동제1투	3917	2725	1192	8	2717	1327	1378	3	0	5	4
인천광역시	부평구	부개1동	부개1동제2투	2703	1862	841	5	1857	895	951	1	1	4	5
인천광역시	부평구	부개1동	부개1동제3투	2715	2114	601	2	2112	1083	1020	2	2	2	3
인천광역시	부평구	부개1동	부개1동제4투	3951	2658	1293	7	2651	1361	1284	1	1	1	3
인천광역시	부평구	부개1동	부개1동제5투	3112	2255	857	7	2248	1201	1036	0	0	6	5
인천광역시	부평구	부개2동	소계	19306	14640	4666	36	14604	6889	7674	2	7	20	12
인천광역시	부평구	부개2동	부개2동제1투	4664	3329	1335	9	3320	1654	1654	2	1	6	3
인천광역시	부평구	부개2동	부개2동제2투	3665	2625	1040	7	2618	1264	1347	0	2	2	3
인천광역시	부평구	부개2동	부개2동제3투	4800	3732	1068	10	3722	1615	2099	0	2	4	2
인천광역시	부평구	부개2동	부개2동제4투	3238	2545	693	8	2537	1217	1312	0	1	3	4
인천광역시	부평구	부개2동	부개2동제5투	2939	2409	530	2	2407	1139	1262	0	1	5	0
인천광역시	부평구	부개3동	소계	27766	21601	6165	32	21569	9570	11924	6	18	38	13
인천광역시	부평구	부개3동	부개3동제1투	3536	2640	896	6	2634	1206	1421	0	2	3	2
인천광역시	부평구	부개3동	부개3동제2투	3677	2531	1146	2	2529	1106	1412	3	4	2	2
인천광역시	부평구	부개3동	부개3동제3투	4024	3153	871	3	3150	1324	1812	0	4	9	1
인천광역시	부평구	부개3동	부개3동제4투	3788	2985	803	3	2982	1189	1780	1	4	7	1
인천광역시	부평구	부개3동	부개3동제5투	4528	3647	881	8	3639	1887	1741	0	2	7	2
인천광역시	부평구	부개3동	부개3동제6투	4105	3431	674	5	3426	1437	1974	2	1	8	4
인천광역시	부평구	부개3동	부개3동제7투	4108	3214	894	5	3209	1421	1784	0	1	2	1
인천광역시	부평구	일신동	소계	11288	8806	2482	13	8793	4246	4516	2	4	18	7
인천광역시	부평구	일신동	일신동제1투	4318	3279	1039	5	3274	1614	1645	0	2	9	4
인천광역시	부평구	일신동	일신동제2투	3744	2944	800	3	2941	1354	1577	2	1	4	3
인천광역시	부평구	일신동	일신동제3투	3226	2583	643	5	2578	1278	1294	0	1	5	0
인천광역시	부평구	십정1동	소계	17447	12276	5171	34	12242	6250	5942	1	10	28	11
인천광역시	부평구	십정1동	십정1동제1투	3710	2417	1293	8	2409	1324	1071	0	2	7	5
인천광역시	부평구	십정1동	십정1동제2투	3227	2247	980	3	2244	1270	969	0	3	2	0
인천광역시	부평구	십정1동	십정1동제3투	4329	3009	1320	13	2996	1538	1441	1	2	10	4
인천광역시	부평구	십정1동	십정1동제4투	2426	1705	721	3	1702	860	839	0	1	2	0
인천광역시	부평구	십정1동	십정1동제5투	3755	2898	857	7	2891	1258	1622	0	2	7	2
인천광역시	부평구	십정2동	소계	23489	16413	7076	40	16373	8216	8095	7	10	32	13
인천광역시	부평구	십정2동	십정2동제1투	4344	2800	1544	7	2793	1444	1335	1	2	6	5
인천광역시	부평구	십정2동	십정2동제2투	3843	2668	1175	9	2659	1407	1243	2	3	4	0
인천광역시	부평구	십정2동	십정2동제3투	3600	2513	1087	6	2507	1275	1223	0	2	4	3
인천광역시	부평구	십정2동	십정2동제4투	3638	2434	1204	4	2430	1266	1161	0	0	2	1
인천광역시	부평구	십정2동	십정2동제5투	3894	2569	1325	6	2563	1243	1313	1	1	4	1
인천광역시	부평구	십정2동	십정2동제6투	4170	3429	741	8	3421	1581	1820	3	2	12	3
인천광역시	부평구	잘못 투입·구분된 투표지	잘못 투입·구분된 투표지	0	0	0	0	0	0	0	0	0	0	0
인천광역시	계양구	계	계	267899	197466	70433	554	196912	92670	103499	53	120	357	213
인천광역시	계양구	재외투표	재외투표	1097	753	344	5	748	315	431	0	0	1	1
인천광역시	계양구	국내부재자투표	국내부재자투표	6426	6096	330	109	5987	2829	3112	7	8	10	21
인천광역시	계양구	효성1동	소계	25647	18852	6795	59	18793	9081	9648	9	6	28	21
인천광역시	계양구	효성1동	효성1동제1투	4339	3159	1180	7	3152	1598	1547	2	0	1	4
인천광역시	계양구	효성1동	효성1동제2투	3219	2287	932	10	2277	1075	1190	1	1	8	2
인천광역시	계양구	효성1동	효성1동제3투	4519	3329	1190	10	3319	1622	1687	2	1	6	1
인천광역시	계양구	효성1동	효성1동제4투	4025	2844	1181	11	2833	1382	1442	1	2	2	4
인천광역시	계양구	효성1동	효성1동제5투	3000	2136	864	6	2130	1030	1090	1	0	3	6
인천광역시	계양구	효성1동	효성1동제6투	3202	2383	819	5	2378	1163	1209	1	1	3	1
인천광역시	계양구	효성1동	효성1동제7투	3343	2714	629	10	2704	1211	1483	1	1	5	3
인천광역시	계양구	효성2동	소계	26460	19553	6907	41	19512	9603	9849	0	12	25	23
인천광역시	계양구	효성2동	효성2동제1투	4152	2821	1331	10	2811	1438	1365	0	3	2	3
인천광역시	계양구	효성2동	효성2동제2투	4533	3019	1514	7	3012	1485	1518	0	0	4	5
인천광역시	계양구	효성2동	효성2동제3투	4680	3762	918	7	3755	1808	1942	0	0	2	3
인천광역시	계양구	효성2동	효성2동제4투	4482	3494	988	4	3490	1658	1818	0	1	7	6
인천광역시	계양구	효성2동	효성2동제5투	4005	2833	1172	7	2826	1476	1345	0	1	1	3
인천광역시	계양구	효성2동	효성2동제6투	4608	3624	984	6	3618	1738	1861	0	7	9	3
인천광역시	계양구	계산1동	소계	19234	13042	6192	33	13009	6263	6695	4	12	17	18
인천광역시	계양구	계산1동	계산1동제1투	4173	2815	1358	10	2805	1367	1429	0	2	3	4
인천광역시	계양구	계산1동	계산1동제2투	4329	2902	1427	8	2894	1368	1515	1	4	3	3
인천광역시	계양구	계산1동	계산1동제3투	3392	2313	1079	6	2307	1125	1170	2	5	2	3
인천광역시	계양구	계산1동	계산1동제4투	4224	2861	1363	3	2858	1365	1482	1	0	5	5
인천광역시	계양구	계산1동	계산1동제5투	3116	2151	965	6	2145	1038	1099	0	1	4	3
인천광역시	계양구	계산2동	소계	15405	10874	4531	24	10850	5174	5632	2	8	25	9
인천광역시	계양구	계산2동	계산2동제1투	3851	2587	1264	5	2582	1219	1356	0	1	5	1
인천광역시	계양구	계산2동	계산2동제2투	3860	2712	1148	10	2702	1272	1418	1	2	7	2
인천광역시	계양구	계산2동	계산2동제3투	4077	3136	941	3	3133	1469	1647	1	3	9	4
인천광역시	계양구	계산2동	계산2동제4투	3617	2439	1178	6	2433	1214	1211	0	2	4	2
인천광역시	계양구	계산3동	소계	18344	13658	4686	31	13627	6251	7321	6	7	28	14
인천광역시	계양구	계산3동	계산3동제1투	4385	3383	1002	6	3377	1634	1728	2	0	9	4
인천광역시	계양구	계산3동	계산3동제2투	3387	2540	847	2	2538	1098	1429	1	1	7	2
인천광역시	계양구	계산3동	계산3동제3투	3154	2365	789	2	2363	1018	1339	1	1	3	1
인천광역시	계양구	계산3동	계산3동제4투	3754	2744	1010	10	2734	1321	1404	1	1	3	4
인천광역시	계양구	계산3동	계산3동제5투	3664	2626	1038	11	2615	1180	1421	1	4	6	3
인천광역시	계양구	계산4동	소계	17401	13542	3859	22	13520	6334	7133	2	11	33	7
인천광역시	계양구	계산4동	계산4동제1투	4097	2958	1139	5	2953	1298	1643	1	5	5	1
인천광역시	계양구	계산4동	계산4동제2투	5020	4120	900	8	4112	1991	2105	0	2	11	3
인천광역시	계양구	계산4동	계산4동제3투	3971	3038	933	3	3035	1501	1519	0	3	10	2
인천광역시	계양구	계산4동	계산4동제4투	4313	3426	887	6	3420	1544	1866	1	1	7	1
인천광역시	계양구	작전1동	소계	24767	18571	6196	45	18526	8598	9853	3	8	44	20
인천광역시	계양구	작전1동	작전1동제1투	5022	3840	1182	6	3834	1799	2018	0	2	10	5
인천광역시	계양구	작전1동	작전1동제2투	4384	3161	1223	11	3150	1401	1735	0	0	11	3
인천광역시	계양구	작전1동	작전1동제3투	4631	3630	1001	5	3625	1741	1867	2	1	8	6
인천광역시	계양구	작전1동	작전1동제4투	3504	2521	983	10	2511	1159	1341	1	2	5	3
인천광역시	계양구	작전1동	작전1동제5투	3260	2253	1007	8	2245	994	1244	0	2	4	1
인천광역시	계양구	작전1동	작전1동제6투	3966	3166	800	5	3161	1504	1648	0	1	6	2
인천광역시	계양구	작전2동	소계	22834	16354	6480	36	16318	7943	8322	2	10	27	14
인천광역시	계양구	작전2동	작전2동제1투	3845	2627	1218	6	2621	1278	1332	0	3	7	1
인천광역시	계양구	작전2동	작전2동제2투	3472	2619	853	5	2614	1255	1350	0	3	2	4
인천광역시	계양구	작전2동	작전2동제3투	3714	2759	955	5	2754	1251	1496	0	3	2	2
인천광역시	계양구	작전2동	작전2동제4투	2928	2215	713	5	2210	1071	1136	1	0	1	1
인천광역시	계양구	작전2동	작전2동제5투	3105	2147	958	4	2143	1070	1064	1	0	5	3
인천광역시	계양구	작전2동	작전2동제6투	3121	2103	1018	5	2098	1060	1030	0	1	5	2
인천광역시	계양구	작전2동	작전2동제7투	2649	1884	765	6	1878	958	914	0	0	5	1
인천광역시	계양구	작전서운동	소계	26066	19602	6464	52	19550	8663	10801	7	10	44	25
인천광역시	계양구	작전서운동	작전서운동제1투	3586	2258	1328	21	2237	934	1282	2	2	12	5
인천광역시	계양구	작전서운동	작전서운동제2투	4076	3243	833	4	3239	1403	1825	2	1	4	4
인천광역시	계양구	작전서운동	작전서운동제3투	3893	3093	800	3	3090	1534	1541	0	1	11	3
인천광역시	계양구	작전서운동	작전서운동제4투	4510	3362	1148	9	3353	1642	1702	1	0	6	2
인천광역시	계양구	작전서운동	작전서운동제5투	3870	3007	863	4	3003	1194	1800	0	2	4	3
인천광역시	계양구	작전서운동	작전서운동제6투	3769	2942	827	7	2935	1155	1770	1	0	4	5
인천광역시	계양구	작전서운동	작전서운동제7투	2362	1697	665	4	1693	801	881	1	4	3	3
인천광역시	계양구	계양1동	소계	32855	24330	8525	52	24278	11362	12846	5	12	36	17
인천광역시	계양구	계양1동	계양1동제1투	4478	3246	1232	12	3234	1749	1470	1	7	6	1
인천광역시	계양구	계양1동	계양1동제2투	5054	3568	1486	0	3568	1900	1668	0	0	0	0
인천광역시	계양구	계양1동	계양1동제3투	6084	4225	1859	10	4215	1814	2392	0	1	7	1
인천광역시	계양구	계양1동	계양1동제4투	4112	3294	818	9	3285	1455	1817	1	1	8	3
인천광역시	계양구	계양1동	계양1동제5투	411	324	87	1	323	227	96	0	0	0	0
인천광역시	계양구	계양1동	계양1동제6투	3719	3008	711	5	3003	1423	1568	2	1	4	5
인천광역시	계양구	계양1동	계양1동제7투	3498	2669	829	7	2662	1124	1527	1	1	4	5
인천광역시	계양구	계양1동	계양1동제8투	5499	3996	1503	8	3988	1670	2308	0	1	7	2
인천광역시	계양구	계양2동	소계	31363	22239	9124	45	22194	10254	11856	6	16	39	23
인천광역시	계양구	계양2동	계양2동제1투	4700	3008	1692	2	3006	1455	1538	2	3	6	2
인천광역시	계양구	계양2동	계양2동제2투	3760	2605	1155	9	2596	1221	1362	1	3	4	5
인천광역시	계양구	계양2동	계양2동제3투	2862	2052	810	6	2046	978	1063	1	1	3	0
인천광역시	계양구	계양2동	계양2동제4투	3133	2102	1031	7	2095	1077	1011	0	0	2	5
인천광역시	계양구	계양2동	계양2동제5투	3711	2688	1023	8	2680	1335	1335	0	3	5	2
인천광역시	계양구	계양2동	계양2동제6투	4670	3223	1447	6	3217	1537	1665	2	1	8	4
인천광역시	계양구	계양2동	계양2동제7투	4450	3489	961	5	3484	1406	2065	0	1	9	3
인천광역시	계양구	계양2동	계양2동제8투	4077	3072	1005	2	3070	1245	1817	0	4	2	2
인천광역시	서구	계	계	353650	262508	91142	709	261799	131340	129603	74	152	350	280
인천광역시	서구	재외투표	재외투표	1387	963	424	6	957	364	589	0	1	2	1
인천광역시	서구	국내부재자투표	국내부재자투표	8032	7558	474	150	7408	3621	3709	8	15	23	32
인천광역시	서구	검암경서동	소계	27336	20296	7040	32	20264	9133	11072	4	15	26	14
인천광역시	서구	검암경서동	검암경서동제1투	3916	3029	887	3	3026	1303	1717	1	3	1	1
인천광역시	서구	검암경서동	검암경서동제2투	770	552	218	2	550	383	162	0	1	2	2
인천광역시	서구	검암경서동	검암경서동제3투	5968	4328	1640	7	4321	2122	2191	0	1	6	1
인천광역시	서구	검암경서동	검암경서동제4투	3307	2599	708	3	2596	1096	1493	0	1	4	2
인천광역시	서구	검암경서동	검암경서동제5투	3146	2427	719	5	2422	1145	1272	0	2	2	1
인천광역시	서구	검암경서동	검암경서동제6투	5583	4149	1434	4	4145	1769	2369	2	1	3	1
인천광역시	서구	검암경서동	검암경서동제7투	4646	3212	1434	8	3204	1315	1868	1	6	8	6
인천광역시	서구	연희동	소계	34744	24069	10675	68	24001	12495	11421	7	10	33	35
인천광역시	서구	연희동	연희동제1투	4098	2598	1500	11	2587	1353	1228	1	1	1	3
인천광역시	서구	연희동	연희동제2투	4152	2985	1167	5	2980	1550	1417	2	1	5	5
인천광역시	서구	연희동	연희동제3투	3877	2453	1424	16	2437	1312	1106	2	3	7	7
인천광역시	서구	연희동	연희동제4투	3914	2904	1010	5	2899	1565	1328	0	0	3	3
인천광역시	서구	연희동	연희동제5투	3993	2915	1078	7	2908	1566	1332	1	1	5	3
인천광역시	서구	연희동	연희동제6투	3496	2473	1023	6	2467	1276	1184	0	0	3	4
인천광역시	서구	연희동	연희동제7투	3888	2579	1309	3	2576	1293	1274	0	1	3	5
인천광역시	서구	연희동	연희동제8투	3438	2540	898	4	2536	1218	1311	0	1	3	3
인천광역시	서구	연희동	연희동제9투	3888	2622	1266	11	2611	1362	1241	1	2	3	2
인천광역시	서구	청라1동	소계	15381	12461	2920	22	12439	5331	7083	1	4	12	8
인천광역시	서구	청라1동	청라1동제1투	4523	3716	807	8	3708	1551	2151	1	1	3	1
인천광역시	서구	청라1동	청라1동제2투	3385	2737	648	4	2733	1230	1498	0	0	1	4
인천광역시	서구	청라1동	청라1동제3투	4172	3427	745	5	3422	1538	1877	0	1	4	2
인천광역시	서구	청라1동	청라1동제4투	3301	2581	720	5	2576	1012	1557	0	2	4	1
인천광역시	서구	청라2동	소계	20465	16469	3996	33	16436	7804	8595	0	4	24	9
인천광역시	서구	청라2동	청라2동제1투	3745	3020	725	5	3015	1560	1447	0	1	4	3
인천광역시	서구	청라2동	청라2동제2투	3087	2551	536	3	2548	1263	1278	0	0	6	1
인천광역시	서구	청라2동	청라2동제3투	4232	3317	915	8	3309	1508	1797	0	1	3	0
인천광역시	서구	청라2동	청라2동제4투	3458	2777	681	7	2770	1177	1589	0	1	3	0
인천광역시	서구	청라2동	청라2동제5투	2668	2137	531	2	2135	1021	1106	0	1	5	2
인천광역시	서구	청라2동	청라2동제6투	3275	2667	608	8	2659	1275	1378	0	0	3	3
인천광역시	서구	가정1동	소계	8801	5886	2915	14	5872	3334	2518	2	2	8	8
인천광역시	서구	가정1동	가정1동제1투	1498	890	608	2	888	518	363	1	1	2	3
인천광역시	서구	가정1동	가정1동제2투	3298	2265	1033	6	2259	1330	922	0	1	3	3
인천광역시	서구	가정1동	가정1동제3투	4005	2731	1274	6	2725	1486	1233	1	0	3	2
인천광역시	서구	가정2동	소계	6378	4453	1925	8	4445	2274	2150	1	8	3	9
인천광역시	서구	가정2동	가정2동제1투	3206	2233	973	5	2228	1218	999	1	3	2	5
인천광역시	서구	가정2동	가정2동제2투	3172	2220	952	3	2217	1056	1151	0	5	1	4
인천광역시	서구	가정3동	소계	9284	6853	2431	13	6840	3655	3161	2	1	11	10
인천광역시	서구	가정3동	가정3동제1투	4057	3036	1021	6	3030	1638	1384	0	0	3	5
인천광역시	서구	가정3동	가정3동제2투	2877	1968	909	4	1964	1058	898	1	1	3	3
인천광역시	서구	가정3동	가정3동제3투	2350	1849	501	3	1846	959	879	1	0	5	2
인천광역시	서구	신현원창동	소계	21865	16111	5754	37	16074	8782	7239	5	8	21	19
인천광역시	서구	신현원창동	신현원창동제1투	3769	2554	1215	12	2542	1444	1088	1	1	5	3
인천광역시	서구	신현원창동	신현원창동제2투	3723	2627	1096	5	2622	1439	1168	2	2	6	5
인천광역시	서구	신현원창동	신현원창동제3투	3272	2243	1029	5	2238	1204	1025	0	2	5	2
인천광역시	서구	신현원창동	신현원창동제4투	2851	2035	816	2	2033	1130	898	0	0	1	4
인천광역시	서구	신현원창동	신현원창동제5투	32	28	4	0	28	22	6	0	0	0	0
인천광역시	서구	신현원창동	신현원창동제6투	4560	3633	927	9	3624	1974	1642	1	1	3	3
인천광역시	서구	신현원창동	신현원창동제7투	3658	2991	667	4	2987	1569	1412	1	2	1	2
인천광역시	서구	석남1동	소계	19492	13659	5833	35	13624	7388	6189	9	10	14	14
인천광역시	서구	석남1동	석남1동제1투	4168	2914	1254	5	2909	1596	1305	1	3	3	1
인천광역시	서구	석남1동	석남1동제2투	4136	3077	1059	4	3073	1598	1465	5	2	2	1
인천광역시	서구	석남1동	석남1동제3투	4139	2846	1293	12	2834	1513	1313	2	2	2	2
인천광역시	서구	석남1동	석남1동제4투	3603	2499	1104	6	2493	1373	1109	1	2	2	6
인천광역시	서구	석남1동	석남1동제5투	3446	2323	1123	8	2315	1308	997	0	1	5	4
인천광역시	서구	석남2동	소계	13532	9836	3696	24	9812	5299	4481	1	5	15	11
인천광역시	서구	석남2동	석남2동제1투	2262	1635	627	8	1627	959	664	1	0	3	0
인천광역시	서구	석남2동	석남2동제2투	3834	2984	850	6	2978	1527	1442	0	2	2	5
인천광역시	서구	석남2동	석남2동제3투	4348	3176	1172	8	3168	1689	1471	0	2	5	1
인천광역시	서구	석남2동	석남2동제4투	3088	2041	1047	2	2039	1124	904	0	1	5	5
인천광역시	서구	석남3동	소계	14058	9662	4396	32	9630	5125	4476	2	6	10	11
인천광역시	서구	석남3동	석남3동제1투	4729	3236	1493	12	3224	1676	1538	0	3	2	5
인천광역시	서구	석남3동	석남3동제2투	4483	3225	1258	12	3213	1678	1524	1	2	4	4
인천광역시	서구	석남3동	석남3동제3투	4846	3201	1645	8	3193	1771	1414	1	1	4	2
인천광역시	서구	가좌1동	소계	10936	7532	3404	16	7516	4171	3311	3	7	13	11
인천광역시	서구	가좌1동	가좌1동제1투	3890	2567	1323	5	2562	1431	1124	0	0	5	2
인천광역시	서구	가좌1동	가좌1동제2투	3262	2369	893	6	2363	1339	1007	1	6	4	6
인천광역시	서구	가좌1동	가좌1동제3투	3784	2596	1188	5	2591	1401	1180	2	1	4	3
인천광역시	서구	가좌2동	소계	17795	14019	3776	31	13988	7152	6802	0	7	15	12
인천광역시	서구	가좌2동	가좌2동제1투	4143	3165	978	9	3156	1604	1543	0	3	3	3
인천광역시	서구	가좌2동	가좌2동제2투	4098	3147	951	8	3139	1616	1515	0	1	3	4
인천광역시	서구	가좌2동	가좌2동제3투	3965	3093	872	7	3086	1677	1405	0	1	3	0
인천광역시	서구	가좌2동	가좌2동제4투	5589	4614	975	7	4607	2255	2339	0	2	6	5
인천광역시	서구	가좌3동	소계	16119	11852	4267	34	11818	6503	5276	5	7	17	10
인천광역시	서구	가좌3동	가좌3동제1투	3377	2467	910	5	2462	1529	923	4	2	3	1
인천광역시	서구	가좌3동	가좌3동제2투	4321	3162	1159	8	3154	1669	1473	0	3	4	5
인천광역시	서구	가좌3동	가좌3동제3투	4199	3081	1118	12	3069	1611	1449	0	0	7	2
인천광역시	서구	가좌3동	가좌3동제4투	4222	3142	1080	9	3133	1694	1431	1	2	3	2
인천광역시	서구	가좌4동	소계	9766	7003	2763	13	6990	3735	3221	1	8	11	14
인천광역시	서구	가좌4동	가좌4동제1투	3325	2374	951	4	2370	1269	1090	0	2	3	6
인천광역시	서구	가좌4동	가좌4동제2투	3288	2361	927	5	2356	1192	1156	0	0	3	5
인천광역시	서구	가좌4동	가좌4동제3투	3153	2268	885	4	2264	1274	975	1	6	5	3
인천광역시	서구	검단1동	소계	35818	26155	9663	58	26097	13263	12762	8	12	32	20
인천광역시	서구	검단1동	검단1동제1투	4234	3090	1144	5	3085	1527	1547	1	1	5	4
인천광역시	서구	검단1동	검단1동제2투	6041	4193	1848	13	4180	2186	1973	6	5	7	3
인천광역시	서구	검단1동	검단1동제3투	3536	2594	942	8	2586	1289	1293	0	0	1	3
인천광역시	서구	검단1동	검단1동제4투	2869	2036	833	3	2033	1147	886	0	0	0	0
인천광역시	서구	검단1동	검단1동제5투	3680	2596	1084	3	2593	1308	1279	0	1	3	2
인천광역시	서구	검단1동	검단1동제6투	3611	2722	889	5	2717	1381	1329	0	2	3	2
인천광역시	서구	검단1동	검단1동제7투	3455	2589	866	6	2583	1166	1412	0	3	2	0
인천광역시	서구	검단1동	검단1동제8투	4086	3101	985	11	3090	1670	1414	0	0	4	2
인천광역시	서구	검단1동	검단1동제9투	4306	3234	1072	4	3230	1589	1629	1	0	7	4
인천광역시	서구	검단2동	소계	16855	12702	4153	21	12681	6125	6521	4	4	17	10
인천광역시	서구	검단2동	검단2동제1투	3391	2603	788	2	2601	1260	1333	1	0	5	2
인천광역시	서구	검단2동	검단2동제2투	4052	3084	968	5	3079	1444	1627	0	1	3	4
인천광역시	서구	검단2동	검단2동제3투	5047	3872	1175	6	3866	1822	2036	1	1	5	1
인천광역시	서구	검단2동	검단2동제4투	4365	3143	1222	8	3135	1599	1525	2	2	4	3
인천광역시	서구	검단3동	소계	16766	12742	4024	29	12713	5426	7250	4	6	16	11
인천광역시	서구	검단3동	검단3동제1투	5876	4383	1493	6	4377	1795	2570	0	1	6	5
인천광역시	서구	검단3동	검단3동제2투	6169	4558	1611	15	4543	2137	2387	4	4	7	4
인천광역시	서구	검단3동	검단3동제3투	4721	3801	920	8	3793	1494	2293	0	1	3	2
인천광역시	서구	검단4동	소계	28840	22227	6613	33	22194	10360	11777	7	12	27	11
인천광역시	서구	검단4동	검단4동제1투	4448	3443	1005	7	3436	1703	1723	0	1	6	3
인천광역시	서구	검단4동	검단4동제2투	3986	3149	837	4	3145	1501	1633	0	5	4	2
인천광역시	서구	검단4동	검단4동제3투	4161	3357	804	5	3352	1492	1853	1	0	5	1
인천광역시	서구	검단4동	검단4동제4투	4260	3425	835	7	3418	1624	1785	1	3	4	1
인천광역시	서구	검단4동	검단4동제5투	4916	3632	1284	3	3629	1615	2006	1	2	2	3
인천광역시	서구	검단4동	검단4동제6투	4741	3586	1155	4	3582	1686	1887	2	1	5	1
인천광역시	서구	검단4동	검단4동제7투	2328	1635	693	3	1632	739	890	2	0	1	0
인천광역시	강화군	계	계	57270	42705	14565	241	42464	29666	12534	26	29	84	125
인천광역시	강화군	재외투표	재외투표	237	165	72	0	165	61	104	0	0	0	0
인천광역시	강화군	국내부재자투표	국내부재자투표	1864	1726	138	50	1676	867	780	9	7	7	6
인천광역시	강화군	강화읍	소계	17560	12824	4736	52	12772	8568	4139	5	7	33	20
인천광역시	강화군	강화읍	강화읍제1투	2090	1522	568	5	1517	1086	420	0	2	4	5
인천광역시	강화군	강화읍	강화읍제2투	3472	2497	975	14	2483	1670	803	1	2	5	2
인천광역시	강화군	강화읍	강화읍제3투	1910	1369	541	12	1357	955	395	0	0	3	4
인천광역시	강화군	강화읍	강화읍제4투	2135	1570	565	2	1568	1079	481	0	1	5	2
인천광역시	강화군	강화읍	강화읍제5투	3336	2532	804	7	2525	1571	937	1	0	10	6
인천광역시	강화군	강화읍	강화읍제6투	2304	1655	649	6	1649	1133	511	2	0	2	1
인천광역시	강화군	강화읍	강화읍제7투	2313	1679	634	6	1673	1074	592	1	2	4	0
인천광역시	강화군	선원면	소계	5513	4130	1383	8	4122	2746	1363	1	1	6	5
인천광역시	강화군	선원면	선원면제1투	2293	1690	603	6	1684	1251	426	0	1	2	4
인천광역시	강화군	선원면	선원면제2투	3220	2440	780	2	2438	1495	937	1	0	4	1
인천광역시	강화군	불은면	소계	3840	2864	976	14	2850	2006	833	2	0	2	7
인천광역시	강화군	불은면	불은면제1투	2439	1804	635	8	1796	1264	527	0	0	2	3
인천광역시	강화군	불은면	불은면제2투	1401	1060	341	6	1054	742	306	2	0	0	4
인천광역시	강화군	길상면	소계	5378	3969	1409	32	3937	2909	1000	5	2	8	13
인천광역시	강화군	길상면	길상면제1투	2109	1576	533	25	1551	1112	418	4	2	6	9
인천광역시	강화군	길상면	길상면제2투	1461	1071	390	6	1065	794	270	0	0	1	0
인천광역시	강화군	길상면	길상면제3투	1120	812	308	0	812	617	191	1	0	1	2
인천광역시	강화군	길상면	길상면제4투	688	510	178	1	509	386	121	0	0	0	2
인천광역시	강화군	화도면	소계	3775	2794	981	16	2778	2053	713	0	1	7	4
인천광역시	강화군	화도면	화도면제1투	1523	1121	402	6	1115	829	281	0	1	2	2
인천광역시	강화군	화도면	화도면제2투	937	684	253	0	684	492	190	0	0	2	0
인천광역시	강화군	화도면	화도면제3투	764	581	183	7	574	435	136	0	0	1	2
인천광역시	강화군	화도면	화도면제4투	551	408	143	3	405	297	106	0	0	2	0
인천광역시	강화군	양도면	소계	3164	2368	796	9	2359	1677	667	0	1	3	11
인천광역시	강화군	양도면	양도면제1투	1717	1256	461	4	1252	856	390	0	0	1	5
인천광역시	강화군	양도면	양도면제2투	1447	1112	335	5	1107	821	277	0	1	2	6
인천광역시	강화군	내가면	소계	2737	2094	643	12	2082	1549	523	0	2	1	7
인천광역시	강화군	내가면	내가면제1투	1453	1106	347	5	1101	785	310	0	1	1	4
인천광역시	강화군	내가면	내가면제2투	650	503	147	6	497	378	116	0	1	0	2
인천광역시	강화군	내가면	내가면제3투	634	485	149	1	484	386	97	0	0	0	1
인천광역시	강화군	하점면	소계	3529	2642	887	10	2632	1961	650	2	2	3	14
인천광역시	강화군	하점면	하점면제1투	1615	1202	413	5	1197	876	312	0	1	3	5
인천광역시	강화군	하점면	하점면제2투	924	687	237	2	685	521	160	1	0	0	3
인천광역시	강화군	하점면	하점면제3투	990	753	237	3	750	564	178	1	1	0	6
인천광역시	강화군	양사면	소계	1635	1265	370	4	1261	921	328	0	1	0	11
인천광역시	강화군	양사면	양사면제1투	576	435	141	1	434	299	127	0	1	0	7
인천광역시	강화군	양사면	양사면제2투	679	529	150	1	528	380	145	0	0	0	3
인천광역시	강화군	양사면	양사면제3투	380	301	79	2	299	242	56	0	0	0	1
인천광역시	강화군	송해면	소계	2744	2031	713	12	2019	1529	481	0	1	4	4
인천광역시	강화군	송해면	송해면투표소	2744	2031	713	12	2019	1529	481	0	1	4	4
인천광역시	강화군	교동면	소계	2684	1888	796	8	1880	1361	504	1	0	3	11
인천광역시	강화군	교동면	교동면제1투	1259	892	367	6	886	621	256	0	0	1	8
인천광역시	강화군	교동면	교동면제2투	748	506	242	1	505	376	127	0	0	2	0
인천광역시	강화군	교동면	교동면제3투	677	490	187	1	489	364	121	1	0	0	3
인천광역시	강화군	삼산면	소계	2037	1489	548	10	1479	1088	372	1	3	4	11
인천광역시	강화군	삼산면	삼산면제1투	691	488	203	6	482	330	148	0	1	0	3
인천광역시	강화군	삼산면	삼산면제2투	321	248	73	1	247	187	54	1	0	1	4
인천광역시	강화군	삼산면	삼산면제3투	953	704	249	3	701	532	161	0	2	3	3
인천광역시	강화군	삼산면	삼산면제4투	72	49	23	0	49	39	9	0	0	0	1
인천광역시	강화군	서도면	소계	573	456	117	4	452	370	77	0	1	3	1
인천광역시	강화군	서도면	서도면제1투	334	271	63	2	269	216	48	0	1	3	1
인천광역시	강화군	서도면	서도면제2투	239	185	54	2	183	154	29	0	0	0	0
인천광역시	옹진군	계	계	17311	12903	4408	115	12788	9197	3470	11	14	37	59
인천광역시	옹진군	재외투표	재외투표	53	35	18	0	35	18	17	0	0	0	0
인천광역시	옹진군	국내부재자투표	국내부재자투표	1099	1015	84	32	983	596	373	0	1	5	8
인천광역시	옹진군	북도면	소계	1865	1418	447	29	1389	1025	339	7	3	3	12
인천광역시	옹진군	북도면	북도면제1투	562	413	149	0	413	282	128	0	0	1	2
인천광역시	옹진군	북도면	북도면제2투	415	316	99	2	314	252	61	0	0	0	1
인천광역시	옹진군	북도면	북도면제3투	888	689	199	27	662	491	150	7	3	2	9
인천광역시	옹진군	연평면	소계	1647	1184	463	5	1179	874	301	0	0	1	3
인천광역시	옹진군	연평면	연평면제1투	1527	1122	405	5	1117	828	285	0	0	1	3
인천광역시	옹진군	연평면	연평면제2투	120	62	58	0	62	46	16	0	0	0	0
인천광역시	옹진군	백령면	소계	4379	3104	1275	19	3085	2274	782	1	4	11	13
인천광역시	옹진군	백령면	백령면제1투	1764	1219	545	9	1210	859	341	0	2	4	4
인천광역시	옹진군	백령면	백령면제2투	1722	1248	474	9	1239	879	349	1	2	6	2
인천광역시	옹진군	백령면	백령면제3투	472	352	120	1	351	298	45	0	0	1	7
인천광역시	옹진군	백령면	백령면제4투	421	285	136	0	285	238	47	0	0	0	0
인천광역시	옹진군	대청면	소계	1158	907	251	6	901	772	127	0	1	1	0
인천광역시	옹진군	대청면	대청면제1투	495	382	113	1	381	329	52	0	0	0	0
인천광역시	옹진군	대청면	대청면제2투	451	347	104	1	346	287	58	0	0	1	0
인천광역시	옹진군	대청면	대청면제3투	212	178	34	4	174	156	17	0	1	0	0
인천광역시	옹진군	덕적면	소계	1571	1153	418	9	1144	853	280	0	0	1	10
인천광역시	옹진군	덕적면	덕적면제1투	724	529	195	2	527	365	156	0	0	1	5
인천광역시	옹진군	덕적면	덕적면제2투	389	280	109	5	275	200	74	0	0	0	1
인천광역시	옹진군	덕적면	덕적면제3투	226	175	51	2	173	145	24	0	0	0	4
인천광역시	옹진군	덕적면	덕적면제4투	96	79	17	0	79	69	10	0	0	0	0
인천광역시	옹진군	덕적면	덕적면제5투	75	46	29	0	46	41	5	0	0	0	0
인천광역시	옹진군	덕적면	덕적면제6투	61	44	17	0	44	33	11	0	0	0	0
인천광역시	옹진군	자월면	소계	1024	796	228	3	793	614	170	0	0	4	5
인천광역시	옹진군	자월면	자월면제1투	526	404	122	2	402	298	100	0	0	2	2
인천광역시	옹진군	자월면	자월면제2투	181	150	31	1	149	126	21	0	0	0	2
인천광역시	옹진군	자월면	자월면제3투	235	177	58	0	177	138	39	0	0	0	0
인천광역시	옹진군	자월면	자월면제4투	82	65	17	0	65	52	10	0	0	2	1
인천광역시	옹진군	영흥면	소계	4515	3291	1224	12	3279	2171	1081	3	5	11	8
인천광역시	옹진군	영흥면	영흥면제1투	2021	1429	592	5	1424	885	528	2	0	6	3
인천광역시	옹진군	영흥면	영흥면제2투	1586	1183	403	6	1177	793	372	1	3	5	3
인천광역시	옹진군	영흥면	영흥면제3투	908	679	229	1	678	493	181	0	2	0	2
광주광역시	동구	계	계	88752	68402	20350	383	68019	6693	61023	105	39	112	47
광주광역시	동구	재외투표	재외투표	374	275	99	1	274	39	235	0	0	0	0
광주광역시	동구	국내부재자투표	국내부재자투표	2612	2406	206	38	2368	351	1996	9	0	5	7
광주광역시	동구	충장동	소계	4242	2904	1338	9	2895	319	2570	1	0	4	1
광주광역시	동구	충장동	충장동제1투	2499	1643	856	4	1639	210	1424	1	0	3	1
광주광역시	동구	충장동	충장동제2투	1743	1261	482	5	1256	109	1146	0	0	1	0
광주광역시	동구	동명동	소계	4457	3301	1156	12	3289	341	2934	4	1	4	5
광주광역시	동구	동명동	동명동제1투	2186	1572	614	5	1567	173	1389	1	1	1	2
광주광역시	동구	동명동	동명동제2투	2271	1729	542	7	1722	168	1545	3	0	3	3
광주광역시	동구	계림1동	소계	7360	5170	2190	22	5148	476	4656	9	3	2	2
광주광역시	동구	계림1동	계림1동제1투	2639	1836	803	8	1828	166	1657	3	1	0	1
광주광역시	동구	계림1동	계림1동제2투	2583	1815	768	9	1806	168	1635	1	0	1	1
광주광역시	동구	계림1동	계림1동제3투	2138	1519	619	5	1514	142	1364	5	2	1	0
광주광역시	동구	계림2동	소계	8823	7004	1819	26	6978	597	6355	9	0	15	2
광주광역시	동구	계림2동	계림2동제1투	4124	3247	877	14	3233	266	2956	5	0	4	2
광주광역시	동구	계림2동	계림2동제2투	1494	1082	412	7	1075	101	968	2	0	4	0
광주광역시	동구	계림2동	계림2동제3투	3205	2675	530	5	2670	230	2431	2	0	7	0
광주광역시	동구	산수1동	소계	7202	5359	1843	19	5340	411	4906	10	3	9	1
광주광역시	동구	산수1동	산수1동제1투	2425	1823	602	4	1819	150	1660	6	1	1	1
광주광역시	동구	산수1동	산수1동제2투	2805	2063	742	7	2056	152	1898	4	0	2	0
광주광역시	동구	산수1동	산수1동제3투	1972	1473	499	8	1465	109	1348	0	2	6	0
광주광역시	동구	산수2동	소계	9112	7359	1753	23	7336	694	6610	8	0	18	6
광주광역시	동구	산수2동	산수2동제1투	2726	2054	672	12	2042	164	1865	4	0	7	2
광주광역시	동구	산수2동	산수2동제2투	1698	1376	322	3	1373	123	1248	0	0	2	0
광주광역시	동구	산수2동	산수2동제3투	2580	2099	481	2	2097	138	1948	4	0	4	3
광주광역시	동구	산수2동	산수2동제4투	2108	1830	278	6	1824	269	1549	0	0	5	1
광주광역시	동구	지산1동	소계	4363	3332	1031	20	3312	273	3032	2	3	2	0
광주광역시	동구	지산1동	지산1동제1투	2862	2274	588	13	2261	171	2086	1	2	1	0
광주광역시	동구	지산1동	지산1동제2투	1501	1058	443	7	1051	102	946	1	1	1	0
광주광역시	동구	지산2동	소계	4937	3820	1117	24	3796	405	3375	2	7	6	1
광주광역시	동구	지산2동	지산2동제1투	3362	2597	765	12	2585	278	2297	2	4	4	0
광주광역시	동구	지산2동	지산2동제2투	1575	1223	352	12	1211	127	1078	0	3	2	1
광주광역시	동구	서남동	소계	3652	2431	1221	12	2419	235	2179	3	2	0	0
광주광역시	동구	서남동	서남동제1투	1923	1330	593	5	1325	131	1190	3	1	0	0
광주광역시	동구	서남동	서남동제2투	1729	1101	628	7	1094	104	989	0	1	0	0
광주광역시	동구	학동	소계	7258	5605	1653	40	5565	463	5074	14	4	7	3
광주광역시	동구	학동	학동제1투	2041	1517	524	14	1503	110	1380	6	2	4	1
광주광역시	동구	학동	학동제2투	2328	1699	629	8	1691	162	1524	3	0	1	1
광주광역시	동구	학동	학동제3투	2889	2389	500	18	2371	191	2170	5	2	2	1
광주광역시	동구	학운동	소계	10622	8682	1940	43	8639	1207	7393	9	7	21	2
광주광역시	동구	학운동	학운동제1투	2703	2030	673	16	2014	224	1782	2	1	5	0
광주광역시	동구	학운동	학운동제2투	3211	2741	470	9	2732	409	2311	3	0	9	0
광주광역시	동구	학운동	학운동제3투	2098	1749	349	9	1740	267	1466	1	0	5	1
광주광역시	동구	학운동	학운동제4투	2610	2162	448	9	2153	307	1834	3	6	2	1
광주광역시	동구	지원1동	소계	7363	5846	1517	28	5818	446	5346	8	5	7	6
광주광역시	동구	지원1동	지원1동제1투	3145	2466	679	15	2451	167	2273	4	3	3	1
광주광역시	동구	지원1동	지원1동제2투	2966	2413	553	11	2402	201	2194	1	2	2	2
광주광역시	동구	지원1동	지원1동제3투	1252	967	285	2	965	78	879	3	0	2	3
광주광역시	동구	지원2동	소계	6375	4906	1469	66	4840	436	4360	17	4	12	11
광주광역시	동구	지원2동	지원2동제1투	915	694	221	11	683	62	608	5	3	3	2
광주광역시	동구	지원2동	지원2동제2투	2816	2093	723	36	2057	196	1845	5	1	4	6
광주광역시	동구	지원2동	지원2동제3투	2644	2119	525	19	2100	178	1907	7	0	5	3
광주광역시	동구	잘못 투입·구분된 투표지	잘못 투입·구분된 투표지	0	2	-2	0	2	0	2	0	0	0	0
광주광역시	서구	계	계	239898	194600	45298	497	194103	15648	178033	40	56	210	116
광주광역시	서구	재외투표	재외투표	731	530	201	2	528	43	482	0	0	2	1
광주광역시	서구	국내부재자투표	국내부재자투표	8211	7523	688	111	7412	960	6394	11	9	18	20
광주광역시	서구	양동	소계	4594	3452	1142	14	3438	354	3079	1	0	4	0
광주광역시	서구	양동	양동제1투	2211	1738	473	3	1735	172	1561	1	0	1	0
광주광역시	서구	양동	양동제2투	2383	1714	669	11	1703	182	1518	0	0	3	0
광주광역시	서구	양3동	소계	4524	3594	930	8	3586	211	3365	2	0	5	3
광주광역시	서구	양3동	양3동제1투	3295	2619	676	7	2612	160	2444	2	0	3	3
광주광역시	서구	양3동	양3동제2투	1229	975	254	1	974	51	921	0	0	2	0
광주광역시	서구	농성1동	소계	7296	5527	1769	17	5510	461	5035	0	4	6	4
광주광역시	서구	농성1동	농성1동제1투	2050	1545	505	2	1543	130	1409	0	0	3	1
광주광역시	서구	농성1동	농성1동제2투	2571	1916	655	7	1909	130	1772	0	2	3	2
광주광역시	서구	농성1동	농성1동제3투	2675	2066	609	8	2058	201	1854	0	2	0	1
광주광역시	서구	농성2동	소계	4965	3714	1251	11	3703	345	3346	0	0	5	7
광주광역시	서구	농성2동	농성2동제1투	2410	1739	671	3	1736	184	1544	0	0	5	3
광주광역시	서구	농성2동	농성2동제2투	2555	1975	580	8	1967	161	1802	0	0	0	4
광주광역시	서구	광천동	소계	8769	6718	2051	22	6696	586	6096	2	3	4	5
광주광역시	서구	광천동	광천동제1투	2620	1844	776	10	1834	129	1700	1	0	1	3
광주광역시	서구	광천동	광천동제2투	4505	3658	847	8	3650	345	3300	1	1	1	2
광주광역시	서구	광천동	광천동제3투	1644	1216	428	4	1212	112	1096	0	2	2	0
광주광역시	서구	유덕동	소계	8398	6964	1434	13	6951	481	6457	1	3	6	3
광주광역시	서구	유덕동	유덕동제1투	1213	877	336	3	874	73	798	0	0	3	0
광주광역시	서구	유덕동	유덕동제2투	3741	3175	566	7	3168	210	2954	1	1	1	1
광주광역시	서구	유덕동	유덕동제3투	3444	2912	532	3	2909	198	2705	0	2	2	2
광주광역시	서구	치평동	소계	21685	18125	3560	34	18091	1508	16552	0	8	16	7
광주광역시	서구	치평동	치평동제1투	4212	3500	712	7	3493	251	3236	0	2	4	0
광주광역시	서구	치평동	치평동제2투	3657	3119	538	3	3116	228	2880	0	2	4	2
광주광역시	서구	치평동	치평동제3투	2744	2350	394	4	2346	285	2058	0	1	2	0
광주광역시	서구	치평동	치평동제4투	3816	3268	548	7	3261	299	2956	0	0	3	3
광주광역시	서구	치평동	치평동제5투	2833	2417	416	4	2413	181	2229	0	2	0	1
광주광역시	서구	치평동	치평동제6투	4423	3471	952	9	3462	264	3193	0	1	3	1
광주광역시	서구	상무1동	소계	18999	14654	4345	11	14643	1152	13466	1	0	17	7
광주광역시	서구	상무1동	상무1동제1투	3205	2378	827	2	2376	190	2185	0	0	1	0
광주광역시	서구	상무1동	상무1동제2투	3721	3062	659	1	3061	262	2793	0	0	3	3
광주광역시	서구	상무1동	상무1동제3투	4206	3403	803	3	3400	309	3085	1	0	5	0
광주광역시	서구	상무1동	상무1동제4투	3274	1974	1300	2	1972	131	1838	0	0	3	0
광주광역시	서구	상무1동	상무1동제5투	4593	3837	756	3	3834	260	3565	0	0	5	4
광주광역시	서구	상무2동	소계	20825	15896	4929	43	15853	1278	14537	3	4	18	13
광주광역시	서구	상무2동	상무2동제1투	4389	3631	758	9	3622	276	3340	1	1	3	1
광주광역시	서구	상무2동	상무2동제2투	4139	3248	891	17	3231	281	2932	0	2	7	9
광주광역시	서구	상무2동	상무2동제3투	3562	2807	755	6	2801	252	2544	0	0	4	1
광주광역시	서구	상무2동	상무2동제4투	4102	2911	1191	6	2905	198	2704	1	0	1	1
광주광역시	서구	상무2동	상무2동제5투	4633	3299	1334	5	3294	271	3017	1	1	3	1
광주광역시	서구	화정1동	소계	12790	10019	2771	21	9998	805	9171	0	4	14	4
광주광역시	서구	화정1동	화정1동제1투	4187	3481	706	6	3475	236	3235	0	1	3	0
광주광역시	서구	화정1동	화정1동제2투	4098	3169	929	6	3163	275	2881	0	1	5	1
광주광역시	서구	화정1동	화정1동제3투	4505	3369	1136	9	3360	294	3055	0	2	6	3
광주광역시	서구	화정2동	소계	9401	7582	1819	17	7565	555	6994	1	1	8	6
광주광역시	서구	화정2동	화정2동제1투	3014	2286	728	7	2279	164	2107	0	0	3	5
광주광역시	서구	화정2동	화정2동제2투	1911	1527	384	3	1524	108	1414	0	0	2	0
광주광역시	서구	화정2동	화정2동제3투	4476	3769	707	7	3762	283	3473	1	1	3	1
광주광역시	서구	화정3동	소계	9624	7707	1917	18	7689	684	6993	2	2	3	5
광주광역시	서구	화정3동	화정3동제1투	2131	1691	440	2	1689	134	1552	1	0	1	1
광주광역시	서구	화정3동	화정3동제2투	3140	2467	673	7	2460	203	2253	1	0	2	1
광주광역시	서구	화정3동	화정3동제3투	4353	3549	804	9	3540	347	3188	0	2	0	3
광주광역시	서구	화정4동	소계	15864	13111	2753	26	13085	1027	12036	3	2	12	5
광주광역시	서구	화정4동	화정4동제1투	4501	3509	992	10	3499	289	3202	0	1	5	2
광주광역시	서구	화정4동	화정4동제2투	2950	2581	369	5	2576	261	2310	1	0	4	0
광주광역시	서구	화정4동	화정4동제3투	2305	1920	385	2	1918	128	1789	0	0	0	1
광주광역시	서구	화정4동	화정4동제4투	3284	2848	436	4	2844	190	2648	2	0	3	1
광주광역시	서구	화정4동	화정4동제5투	2824	2253	571	5	2248	159	2087	0	1	0	1
광주광역시	서구	서창동	소계	5050	3928	1122	19	3909	375	3513	2	2	13	4
광주광역시	서구	서창동	서창동제1투	1703	1212	491	10	1202	104	1088	0	1	7	2
광주광역시	서구	서창동	서창동제2투	1347	1095	252	3	1092	93	993	2	0	2	2
광주광역시	서구	서창동	서창동제3투	2000	1621	379	6	1615	178	1432	0	1	4	0
광주광역시	서구	금호1동	소계	18399	15225	3174	31	15194	1103	14071	1	2	10	7
광주광역시	서구	금호1동	금호1동제1투	3859	3265	594	5	3260	274	2984	0	0	2	0
광주광역시	서구	금호1동	금호1동제2투	4362	3647	715	7	3640	283	3350	1	0	4	2
광주광역시	서구	금호1동	금호1동제3투	3516	2725	791	12	2713	205	2505	0	0	1	2
광주광역시	서구	금호1동	금호1동제4투	4339	3724	615	6	3718	197	3516	0	2	1	2
광주광역시	서구	금호1동	금호1동제5투	2323	1864	459	1	1863	144	1716	0	0	2	1
광주광역시	서구	금호2동	소계	19308	16579	2729	25	16554	1113	15420	2	3	11	5
광주광역시	서구	금호2동	금호2동제1투	3310	2610	700	6	2604	200	2400	0	1	2	1
광주광역시	서구	금호2동	금호2동제2투	4388	3785	603	4	3781	220	3557	0	0	1	3
광주광역시	서구	금호2동	금호2동제3투	4113	3602	511	6	3596	259	3334	0	1	1	1
광주광역시	서구	금호2동	금호2동제4투	4466	3919	547	5	3914	224	3683	1	1	5	0
광주광역시	서구	금호2동	금호2동제5투	3031	2663	368	4	2659	210	2446	1	0	2	0
광주광역시	서구	풍암동	소계	28207	23355	4852	36	23319	1926	21346	4	9	27	7
광주광역시	서구	풍암동	풍암동제1투	3779	3246	533	5	3241	283	2956	0	0	2	0
광주광역시	서구	풍암동	풍암동제2투	3082	2616	466	1	2615	139	2474	0	0	2	0
광주광역시	서구	풍암동	풍암동제3투	3569	3103	466	3	3100	230	2865	0	0	4	1
광주광역시	서구	풍암동	풍암동제4투	3724	3263	461	2	3261	392	2859	1	3	6	0
광주광역시	서구	풍암동	풍암동제5투	3096	2621	475	1	2620	191	2423	1	1	2	2
광주광역시	서구	풍암동	풍암동제6투	4370	3400	970	5	3395	231	3159	0	0	3	2
광주광역시	서구	풍암동	풍암동제7투	3991	2841	1150	10	2831	196	2624	2	3	4	2
광주광역시	서구	풍암동	풍암동제8투	2596	2265	331	9	2256	264	1986	0	2	4	0
광주광역시	서구	동천동	소계	12258	10397	1861	18	10379	681	9680	4	0	11	3
광주광역시	서구	동천동	동천동제1투	2570	2082	488	4	2078	123	1949	3	0	3	0
광주광역시	서구	동천동	동천동제2투	3208	2844	364	9	2835	131	2698	0	0	4	2
광주광역시	서구	동천동	동천동제3투	3651	3260	391	3	3257	296	2955	1	0	4	1
광주광역시	서구	동천동	동천동제4투	2829	2211	618	2	2209	131	2078	0	0	0	0
광주광역시	남구	계	계	171637	137610	34027	515	137095	11307	125439	27	48	191	83
광주광역시	남구	재외투표	재외투표	606	449	157	1	448	50	396	0	1	0	1
광주광역시	남구	국내부재자투표	국내부재자투표	5988	5507	481	89	5418	732	4644	6	10	13	13
광주광역시	남구	양림동	소계	7261	5767	1494	19	5748	461	5272	1	1	9	4
광주광역시	남구	양림동	양림동제1투	4338	3514	824	6	3508	259	3243	0	0	4	2
광주광역시	남구	양림동	양림동제2투	2923	2253	670	13	2240	202	2029	1	1	5	2
광주광역시	남구	방림1동	소계	6679	5349	1330	27	5322	424	4883	1	0	10	4
광주광역시	남구	방림1동	방림1동제1투	3942	3197	745	18	3179	236	2934	1	0	5	3
광주광역시	남구	방림1동	방림1동제2투	2737	2152	585	9	2143	188	1949	0	0	5	1
광주광역시	남구	방림2동	소계	8701	6964	1737	28	6936	527	6394	1	0	12	2
광주광역시	남구	방림2동	방림2동제1투	3264	2440	824	15	2425	190	2229	1	0	4	1
광주광역시	남구	방림2동	방림2동제2투	3386	2791	595	10	2781	199	2578	0	0	4	0
광주광역시	남구	방림2동	방림2동제3투	2051	1733	318	3	1730	138	1587	0	0	4	1
광주광역시	남구	봉선1동	소계	12974	10011	2963	27	9984	776	9195	1	3	5	4
광주광역시	남구	봉선1동	봉선1동제1투	3160	2557	603	7	2550	178	2372	0	0	0	0
광주광역시	남구	봉선1동	봉선1동제2투	2831	2181	650	3	2178	170	2005	0	1	2	0
광주광역시	남구	봉선1동	봉선1동제3투	3745	2886	859	13	2873	243	2624	1	2	1	2
광주광역시	남구	봉선1동	봉선1동제4투	3238	2387	851	4	2383	185	2194	0	0	2	2
광주광역시	남구	봉선2동	소계	19802	16804	2998	85	16719	1905	14770	3	8	19	14
광주광역시	남구	봉선2동	봉선2동제1투	3960	3316	644	6	3310	374	2928	1	0	4	3
광주광역시	남구	봉선2동	봉선2동제2투	3702	3021	681	57	2964	280	2667	2	3	5	7
광주광역시	남구	봉선2동	봉선2동제3투	3340	2882	458	9	2873	240	2626	0	3	3	1
광주광역시	남구	봉선2동	봉선2동제4투	4466	3890	576	8	3882	357	3519	0	1	4	1
광주광역시	남구	봉선2동	봉선2동제5투	4334	3695	639	5	3690	654	3030	0	1	3	2
광주광역시	남구	사직동	소계	5087	3547	1540	15	3532	312	3206	2	1	8	3
광주광역시	남구	사직동	사직동제1투	2331	1577	754	10	1567	141	1419	2	0	4	1
광주광역시	남구	사직동	사직동제2투	2756	1970	786	5	1965	171	1787	0	1	4	2
광주광역시	남구	월산동	소계	8561	6276	2285	24	6252	494	5736	2	5	12	3
광주광역시	남구	월산동	월산동제1투	1472	1075	397	3	1072	84	985	0	0	2	1
광주광역시	남구	월산동	월산동제2투	2279	1725	554	5	1720	145	1566	1	2	5	1
광주광역시	남구	월산동	월산동제3투	2263	1495	768	4	1491	110	1375	1	3	1	1
광주광역시	남구	월산동	월산동제4투	2547	1981	566	12	1969	155	1810	0	0	4	0
광주광역시	남구	월산4동	소계	8909	6704	2205	22	6682	469	6198	3	0	9	3
광주광역시	남구	월산4동	월산4동제1투	3195	2332	863	8	2324	179	2138	1	0	5	1
광주광역시	남구	월산4동	월산4동제2투	2920	2292	628	7	2285	157	2124	1	0	1	2
광주광역시	남구	월산4동	월산4동제3투	2794	2080	714	7	2073	133	1936	1	0	3	0
광주광역시	남구	월산5동	소계	6771	5141	1630	17	5124	359	4753	1	2	8	1
광주광역시	남구	월산5동	월산5동제1투	3732	2796	936	12	2784	201	2575	1	2	5	0
광주광역시	남구	월산5동	월산5동제2투	3039	2345	694	5	2340	158	2178	0	0	3	1
광주광역시	남구	백운1동	소계	10463	8483	1980	26	8457	651	7783	1	3	13	6
광주광역시	남구	백운1동	백운1동제1투	3408	2651	757	14	2637	228	2402	0	0	5	2
광주광역시	남구	백운1동	백운1동제2투	3616	3002	614	5	2997	228	2759	1	2	5	2
광주광역시	남구	백운1동	백운1동제3투	3439	2830	609	7	2823	195	2622	0	1	3	2
광주광역시	남구	백운2동	소계	4930	3706	1224	7	3699	347	3343	0	1	3	5
광주광역시	남구	백운2동	백운2동제1투	3653	2750	903	7	2743	253	2482	0	1	3	4
광주광역시	남구	백운2동	백운2동제2투	1277	956	321	0	956	94	861	0	0	0	1
광주광역시	남구	주월1동	소계	14971	11852	3119	28	11824	801	11006	1	2	9	5
광주광역시	남구	주월1동	주월1동제1투	4240	3363	877	8	3355	237	3111	1	1	4	1
광주광역시	남구	주월1동	주월1동제2투	4237	3320	917	5	3315	226	3084	0	1	3	1
광주광역시	남구	주월1동	주월1동제3투	4092	3201	891	10	3191	207	2980	0	0	2	2
광주광역시	남구	주월1동	주월1동제4투	2402	1968	434	5	1963	131	1831	0	0	0	1
광주광역시	남구	주월2동	소계	8356	6574	1782	24	6550	410	6123	1	1	12	3
광주광역시	남구	주월2동	주월2동제1투	2317	1767	550	5	1762	120	1636	0	0	6	0
광주광역시	남구	주월2동	주월2동제2투	3002	2423	579	11	2412	122	2286	0	0	2	2
광주광역시	남구	주월2동	주월2동제3투	3037	2384	653	8	2376	168	2201	1	1	4	1
광주광역시	남구	효덕동	소계	31365	26332	5033	36	26296	2018	24232	1	7	32	6
광주광역시	남구	효덕동	효덕동제1투	4623	3857	766	7	3850	217	3628	0	1	4	0
광주광역시	남구	효덕동	효덕동제2투	4500	3793	707	3	3790	248	3539	0	0	3	0
광주광역시	남구	효덕동	효덕동제3투	3548	3031	517	3	3028	357	2663	0	1	7	0
광주광역시	남구	효덕동	효덕동제4투	3890	3239	651	2	3237	303	2926	0	1	5	2
광주광역시	남구	효덕동	효덕동제5투	4031	3373	658	6	3367	237	3124	0	2	3	1
광주광역시	남구	효덕동	효덕동제6투	2841	2370	471	5	2365	161	2202	0	0	1	1
광주광역시	남구	효덕동	효덕동제7투	3877	3206	671	3	3203	177	3017	1	2	4	2
광주광역시	남구	효덕동	효덕동제8투	4055	3463	592	7	3456	318	3133	0	0	5	0
광주광역시	남구	송암동	소계	4911	3935	976	12	3923	256	3660	0	2	4	1
광주광역시	남구	송암동	송암동제1투	2117	1565	552	9	1556	94	1460	0	1	1	0
광주광역시	남구	송암동	송암동제2투	2794	2370	424	3	2367	162	2200	0	1	3	1
광주광역시	남구	대촌동	소계	5302	4209	1093	28	4181	315	3845	2	1	13	5
광주광역시	남구	대촌동	대촌동제1투	2613	2115	498	12	2103	164	1930	1	0	5	3
광주광역시	남구	대촌동	대촌동제2투	952	708	244	4	704	62	640	1	0	1	0
광주광역시	남구	대촌동	대촌동제3투	1737	1386	351	12	1374	89	1275	0	1	7	2
광주광역시	북구	계	계	344569	276928	67641	714	276214	20378	255181	44	114	344	153
광주광역시	북구	재외투표	재외투표	1030	712	318	3	709	79	628	0	0	1	1
광주광역시	북구	국내부재자투표	국내부재자투표	11468	10556	912	138	10418	1380	8966	10	18	18	26
광주광역시	북구	중흥1동	소계	3220	2273	947	8	2265	206	2048	1	0	6	4
광주광역시	북구	중흥1동	중흥1동제1투	1596	1123	473	5	1118	112	997	1	0	5	3
광주광역시	북구	중흥1동	중흥1동제2투	1624	1150	474	3	1147	94	1051	0	0	1	1
광주광역시	북구	중흥2동	소계	7527	5880	1647	12	5868	501	5352	1	3	7	4
광주광역시	북구	중흥2동	중흥2동제1투	2376	1956	420	4	1952	233	1715	1	1	2	0
광주광역시	북구	중흥2동	중흥2동제2투	2453	1859	594	3	1856	129	1723	0	0	1	3
광주광역시	북구	중흥2동	중흥2동제3투	2698	2065	633	5	2060	139	1914	0	2	4	1
광주광역시	북구	중흥3동	소계	5052	3843	1209	9	3834	324	3498	1	2	5	4
광주광역시	북구	중흥3동	중흥3동제1투	2592	1967	625	2	1965	163	1798	1	1	1	1
광주광역시	북구	중흥3동	중흥3동제2투	2460	1876	584	7	1869	161	1700	0	1	4	3
광주광역시	북구	중앙동	소계	3576	2525	1051	9	2516	222	2285	0	3	5	1
광주광역시	북구	중앙동	중앙동투표소	3576	2525	1051	9	2516	222	2285	0	3	5	1
광주광역시	북구	임동	소계	8326	6508	1818	16	6492	504	5974	1	5	6	2
광주광역시	북구	임동	임동제1투	4730	3797	933	8	3789	255	3526	1	2	4	1
광주광역시	북구	임동	임동제2투	3596	2711	885	8	2703	249	2448	0	3	2	1
광주광역시	북구	신안동	소계	10090	7456	2634	17	7439	547	6876	0	2	9	5
광주광역시	북구	신안동	신안동제1투	3642	2473	1169	5	2468	196	2268	0	0	3	1
광주광역시	북구	신안동	신안동제2투	2905	2228	677	6	2222	140	2079	0	0	2	1
광주광역시	북구	신안동	신안동제3투	3543	2755	788	6	2749	211	2529	0	2	4	3
광주광역시	북구	용봉동	소계	29968	24345	5623	36	24309	1790	22488	1	4	20	6
광주광역시	북구	용봉동	용봉동제1투	3731	2802	929	5	2797	181	2614	0	1	0	1
광주광역시	북구	용봉동	용봉동제2투	4129	3400	729	4	3396	262	3130	0	1	3	0
광주광역시	북구	용봉동	용봉동제3투	3835	3114	721	4	3110	185	2920	0	0	4	1
광주광역시	북구	용봉동	용봉동제4투	3279	2472	807	5	2467	201	2261	0	0	3	2
광주광역시	북구	용봉동	용봉동제5투	5307	4494	813	11	4483	314	4165	0	0	3	1
광주광역시	북구	용봉동	용봉동제6투	4569	3709	860	2	3707	324	3377	0	2	3	1
광주광역시	북구	용봉동	용봉동제7투	5118	4354	764	5	4349	323	4021	1	0	4	0
광주광역시	북구	운암1동	소계	15789	13367	2422	15	13352	1083	12237	1	7	22	2
광주광역시	북구	운암1동	운암1동제1투	4407	3650	757	0	3650	325	3318	0	3	4	0
광주광역시	북구	운암1동	운암1동제2투	4266	3530	736	7	3523	314	3193	0	3	12	1
광주광역시	북구	운암1동	운암1동제3투	2691	2381	310	2	2379	183	2192	0	0	4	0
광주광역시	북구	운암1동	운암1동제4투	4425	3806	619	6	3800	261	3534	1	1	2	1
광주광역시	북구	운암2동	소계	12194	9337	2857	18	9319	685	8613	0	4	10	7
광주광역시	북구	운암2동	운암2동제1투	2779	2028	751	4	2024	137	1882	0	2	2	1
광주광역시	북구	운암2동	운암2동제2투	2388	1688	700	2	1686	117	1567	0	0	0	2
광주광역시	북구	운암2동	운암2동제3투	3383	2776	607	3	2773	224	2541	0	1	4	3
광주광역시	북구	운암2동	운암2동제4투	3644	2845	799	9	2836	207	2623	0	1	4	1
광주광역시	북구	운암3동	소계	14062	11686	2376	22	11664	810	10832	2	1	12	7
광주광역시	북구	운암3동	운암3동제1투	3109	2603	506	3	2600	209	2382	1	0	4	4
광주광역시	북구	운암3동	운암3동제2투	3722	3125	597	8	3117	204	2906	1	0	5	1
광주광역시	북구	운암3동	운암3동제3투	2822	2273	549	5	2268	133	2134	0	0	1	0
광주광역시	북구	운암3동	운암3동제4투	4409	3685	724	6	3679	264	3410	0	1	2	2
광주광역시	북구	동림동	소계	16294	13528	2766	29	13499	750	12732	1	2	7	7
광주광역시	북구	동림동	동림동제1투	3803	3049	754	9	3040	150	2886	0	1	2	1
광주광역시	북구	동림동	동림동제2투	3427	2843	584	3	2840	174	2663	0	0	3	0
광주광역시	북구	동림동	동림동제3투	3519	3042	477	7	3035	180	2851	0	0	1	3
광주광역시	북구	동림동	동림동제4투	3221	2754	467	7	2747	160	2583	1	0	0	3
광주광역시	북구	동림동	동림동제5투	2324	1840	484	3	1837	86	1749	0	1	1	0
광주광역시	북구	우산동	소계	12530	9455	3075	23	9432	791	8620	4	4	8	5
광주광역시	북구	우산동	우산동제1투	2597	1718	879	4	1714	109	1601	1	1	2	0
광주광역시	북구	우산동	우산동제2투	2851	2158	693	6	2152	156	1993	0	0	2	1
광주광역시	북구	우산동	우산동제3투	2132	1687	445	3	1684	139	1542	0	1	1	1
광주광역시	북구	우산동	우산동제4투	2385	1798	587	9	1789	132	1648	3	1	3	2
광주광역시	북구	우산동	우산동제5투	2565	2094	471	1	2093	255	1836	0	1	0	1
광주광역시	북구	풍향동	소계	4767	3531	1236	11	3520	303	3212	1	0	2	2
광주광역시	북구	풍향동	풍향동제1투	2575	1925	650	7	1918	163	1752	1	0	1	1
광주광역시	북구	풍향동	풍향동제2투	2192	1606	586	4	1602	140	1460	0	0	1	1
광주광역시	북구	문화동	소계	12344	9729	2615	31	9698	765	8901	1	5	19	7
광주광역시	북구	문화동	문화동제1투	4178	3140	1038	13	3127	276	2833	1	2	9	6
광주광역시	북구	문화동	문화동제2투	3466	2831	635	6	2825	230	2592	0	0	3	0
광주광역시	북구	문화동	문화동제3투	2923	2390	533	6	2384	164	2212	0	2	6	0
광주광역시	북구	문화동	문화동제4투	1777	1368	409	6	1362	95	1264	0	1	1	1
광주광역시	북구	문흥1동	소계	14103	11838	2265	18	11820	833	10969	0	1	12	5
광주광역시	북구	문흥1동	문흥1동제1투	2900	2385	515	2	2383	155	2227	0	0	0	1
광주광역시	북구	문흥1동	문흥1동제2투	2703	2207	496	3	2204	216	1984	0	1	2	1
광주광역시	북구	문흥1동	문흥1동제3투	3122	2712	410	4	2708	215	2489	0	0	4	0
광주광역시	북구	문흥1동	문흥1동제4투	3039	2648	391	4	2644	151	2488	0	0	4	1
광주광역시	북구	문흥1동	문흥1동제5투	2339	1886	453	5	1881	96	1781	0	0	2	2
광주광역시	북구	문흥2동	소계	14142	11671	2471	27	11644	652	10974	0	3	13	2
광주광역시	북구	문흥2동	문흥2동제1투	2893	2466	427	5	2461	108	2347	0	0	5	1
광주광역시	북구	문흥2동	문흥2동제2투	2388	2001	387	2	1999	89	1909	0	1	0	0
광주광역시	북구	문흥2동	문흥2동제3투	3328	2775	553	3	2772	139	2631	0	1	0	1
광주광역시	북구	문흥2동	문흥2동제4투	2850	2288	562	11	2277	177	2096	0	0	4	0
광주광역시	북구	문흥2동	문흥2동제5투	2683	2141	542	6	2135	139	1991	0	1	4	0
광주광역시	북구	두암1동	소계	7427	5818	1609	16	5802	477	5314	0	0	10	1
광주광역시	북구	두암1동	두암1동제1투	2515	2009	506	6	2003	184	1815	0	0	4	0
광주광역시	북구	두암1동	두암1동제2투	2586	1981	605	5	1976	142	1829	0	0	5	0
광주광역시	북구	두암1동	두암1동제3투	2326	1828	498	5	1823	151	1670	0	0	1	1
광주광역시	북구	두암2동	소계	15376	12089	3287	31	12058	860	11158	3	8	22	7
광주광역시	북구	두암2동	두암2동제1투	2949	2195	754	7	2188	171	2012	0	2	3	0
광주광역시	북구	두암2동	두암2동제2투	2547	1947	600	7	1940	154	1784	0	1	1	0
광주광역시	북구	두암2동	두암2동제3투	2729	2057	672	4	2053	136	1910	1	0	4	2
광주광역시	북구	두암2동	두암2동제4투	3451	2816	635	4	2812	198	2602	2	2	6	2
광주광역시	북구	두암2동	두암2동제5투	3700	3074	626	9	3065	201	2850	0	3	8	3
광주광역시	북구	두암3동	소계	13921	10760	3161	46	10714	920	9760	2	2	22	8
광주광역시	북구	두암3동	두암3동제1투	2361	1655	706	9	1646	152	1486	0	0	6	2
광주광역시	북구	두암3동	두암3동제2투	2800	2326	474	6	2320	204	2111	0	2	2	1
광주광역시	북구	두암3동	두암3동제3투	2938	2249	689	4	2245	150	2092	0	0	1	2
광주광역시	북구	두암3동	두암3동제4투	2793	2081	712	19	2062	199	1852	0	0	9	2
광주광역시	북구	두암3동	두암3동제5투	3029	2449	580	8	2441	215	2219	2	0	4	1
광주광역시	북구	삼각동	소계	9670	7814	1856	16	7798	482	7303	0	2	9	2
광주광역시	북구	삼각동	삼각동제1투	3419	2498	921	7	2491	197	2291	0	1	1	1
광주광역시	북구	삼각동	삼각동제2투	2942	2529	413	5	2524	149	2370	0	0	4	1
광주광역시	북구	삼각동	삼각동제3투	3309	2787	522	4	2783	136	2642	0	1	4	0
광주광역시	북구	일곡동	소계	22342	18926	3416	25	18901	1184	17683	5	4	19	6
광주광역시	북구	일곡동	일곡동제1투	3823	3141	682	7	3134	159	2967	0	1	4	3
광주광역시	북구	일곡동	일곡동제2투	4155	3318	837	4	3314	179	3131	2	0	1	1
광주광역시	북구	일곡동	일곡동제3투	2542	2213	329	3	2210	118	2091	0	0	1	0
광주광역시	북구	일곡동	일곡동제4투	3710	3184	526	4	3180	190	2986	2	0	2	0
광주광역시	북구	일곡동	일곡동제5투	3943	3479	464	5	3474	249	3221	0	1	3	0
광주광역시	북구	일곡동	일곡동제6투	4169	3591	578	2	3589	289	3287	1	2	8	2
광주광역시	북구	매곡동	소계	10824	9112	1712	10	9102	616	8467	1	4	10	4
광주광역시	북구	매곡동	매곡동제1투	3015	2522	493	5	2517	156	2354	0	0	6	1
광주광역시	북구	매곡동	매곡동제2투	4462	3763	699	3	3760	266	3488	1	0	2	3
광주광역시	북구	매곡동	매곡동제3투	3347	2827	520	2	2825	194	2625	0	4	2	0
광주광역시	북구	오치1동	소계	10123	7779	2344	18	7761	545	7197	3	4	8	4
광주광역시	북구	오치1동	오치1동제1투	3325	2509	816	6	2503	190	2309	2	0	2	0
광주광역시	북구	오치1동	오치1동제2투	3338	2596	742	5	2591	181	2405	0	1	2	2
광주광역시	북구	오치1동	오치1동제3투	3460	2674	786	7	2667	174	2483	1	3	4	2
광주광역시	북구	오치2동	소계	11974	9263	2711	22	9241	630	8584	2	8	13	4
광주광역시	북구	오치2동	오치2동제1투	2362	1897	465	5	1892	126	1764	0	0	2	0
광주광역시	북구	오치2동	오치2동제2투	3153	2342	811	12	2330	181	2138	0	4	7	0
광주광역시	북구	오치2동	오치2동제3투	3026	2316	710	2	2314	167	2136	2	4	4	1
광주광역시	북구	오치2동	오치2동제4투	3433	2708	725	3	2705	156	2546	0	0	0	3
광주광역시	북구	석곡동	소계	2487	1927	560	13	1914	159	1741	1	1	11	1
광주광역시	북구	석곡동	석곡동제1투	1909	1479	430	9	1470	113	1347	0	0	9	1
광주광역시	북구	석곡동	석곡동제2투	578	448	130	4	444	46	394	1	1	2	0
광주광역시	북구	건국동	소계	43943	35200	8743	75	35125	2280	32769	2	17	38	19
광주광역시	북구	건국동	건국동제1투	4670	3784	886	3	3781	278	3499	1	2	0	1
광주광역시	북구	건국동	건국동제2투	3762	3052	710	7	3045	152	2889	0	3	0	1
광주광역시	북구	건국동	건국동제3투	4923	3935	988	9	3926	250	3673	0	1	2	0
광주광역시	북구	건국동	건국동제4투	3879	3180	699	6	3174	190	2978	0	0	6	0
광주광역시	북구	건국동	건국동제5투	4258	3475	783	5	3470	251	3211	0	2	5	1
광주광역시	북구	건국동	건국동제6투	3511	2805	706	5	2800	178	2611	0	0	6	5
광주광역시	북구	건국동	건국동제7투	4114	3222	892	10	3212	213	2990	0	4	3	2
광주광역시	북구	건국동	건국동제8투	5543	4591	952	6	4585	284	4290	0	2	7	2
광주광역시	북구	건국동	건국동제9투	2612	1940	672	6	1934	167	1758	0	1	4	4
광주광역시	북구	건국동	건국동제10투	3766	2994	772	10	2984	182	2793	1	2	5	1
광주광역시	북구	건국동	건국동제11투	2905	2222	683	8	2214	135	2077	0	0	0	2
광주광역시	광산구	계	계	272925	220876	52049	721	220155	15548	204061	52	76	256	162
광주광역시	광산구	재외투표	재외투표	619	430	189	3	427	47	378	0	1	0	1
광주광역시	광산구	국내부재자투표	국내부재자투표	8351	7589	762	101	7488	1154	6269	13	7	18	27
광주광역시	광산구	송정1동	소계	8797	6916	1881	17	6899	514	6373	0	4	5	3
광주광역시	광산구	송정1동	송정1동제1투	3363	2581	782	5	2576	223	2347	0	2	3	1
광주광역시	광산구	송정1동	송정1동제2투	2504	1879	625	10	1869	142	1723	0	1	2	1
광주광역시	광산구	송정1동	송정1동제3투	2930	2456	474	2	2454	149	2303	0	1	0	1
광주광역시	광산구	송정2동	소계	5582	4288	1294	21	4267	397	3858	1	2	5	4
광주광역시	광산구	송정2동	송정2동제1투	2049	1462	587	5	1457	101	1353	0	1	1	1
광주광역시	광산구	송정2동	송정2동제2투	1909	1520	389	7	1513	180	1328	0	1	3	1
광주광역시	광산구	송정2동	송정2동제3투	1624	1306	318	9	1297	116	1177	1	0	1	2
광주광역시	광산구	도산동	소계	10739	8436	2303	20	8416	706	7689	0	1	10	10
광주광역시	광산구	도산동	도산동제1투	3571	2789	782	8	2781	207	2569	0	0	3	2
광주광역시	광산구	도산동	도산동제2투	3350	2572	778	10	2562	281	2272	0	1	3	5
광주광역시	광산구	도산동	도산동제3투	3818	3075	743	2	3073	218	2848	0	0	4	3
광주광역시	광산구	신흥동	소계	4136	3175	961	12	3163	252	2903	2	1	3	2
광주광역시	광산구	신흥동	신흥동제1투	1730	1274	456	5	1269	117	1147	2	0	1	2
광주광역시	광산구	신흥동	신흥동제2투	2406	1901	505	7	1894	135	1756	0	1	2	0
광주광역시	광산구	어룡동	소계	16864	13450	3414	39	13411	871	12513	1	3	15	8
광주광역시	광산구	어룡동	어룡동제1투	2123	1578	545	5	1573	105	1464	0	0	4	0
광주광역시	광산구	어룡동	어룡동제2투	2965	2339	626	7	2332	164	2166	0	0	0	2
광주광역시	광산구	어룡동	어룡동제3투	2470	1970	500	8	1962	128	1829	0	1	4	0
광주광역시	광산구	어룡동	어룡동제4투	3025	2329	696	10	2319	163	2151	0	1	2	2
광주광역시	광산구	어룡동	어룡동제5투	2988	2496	492	4	2492	112	2374	0	0	3	3
광주광역시	광산구	어룡동	어룡동제6투	3293	2738	555	5	2733	199	2529	1	1	2	1
광주광역시	광산구	우산동	소계	18653	13882	4771	52	13830	1032	12748	4	4	26	16
광주광역시	광산구	우산동	우산동제1투	3778	2831	947	6	2825	199	2618	0	0	6	2
광주광역시	광산구	우산동	우산동제2투	2318	1722	596	5	1717	106	1602	1	3	3	2
광주광역시	광산구	우산동	우산동제3투	2742	1968	774	18	1950	194	1737	2	0	11	6
광주광역시	광산구	우산동	우산동제4투	1983	1455	528	3	1452	90	1361	1	0	0	0
광주광역시	광산구	우산동	우산동제5투	3627	2877	750	7	2870	161	2707	0	0	2	0
광주광역시	광산구	우산동	우산동제6투	1959	1445	514	4	1441	116	1321	0	0	1	3
광주광역시	광산구	우산동	우산동제7투	2246	1584	662	9	1575	166	1402	0	1	3	3
광주광역시	광산구	월곡1동	소계	10790	8394	2396	27	8367	571	7773	2	4	15	2
광주광역시	광산구	월곡1동	월곡1동제1투	2663	1896	767	7	1889	150	1736	1	0	2	0
광주광역시	광산구	월곡1동	월곡1동제2투	1887	1391	496	5	1386	97	1283	0	1	5	0
광주광역시	광산구	월곡1동	월곡1동제3투	3328	2852	476	6	2846	175	2661	1	3	5	1
광주광역시	광산구	월곡1동	월곡1동제4투	2912	2255	657	9	2246	149	2093	0	0	3	1
광주광역시	광산구	월곡2동	소계	14499	11703	2796	28	11675	748	10905	0	3	10	9
광주광역시	광산구	월곡2동	월곡2동제1투	3115	2202	913	7	2195	141	2049	0	1	1	3
광주광역시	광산구	월곡2동	월곡2동제2투	2668	2029	639	4	2025	144	1873	0	0	5	3
광주광역시	광산구	월곡2동	월곡2동제3투	3335	2761	574	7	2754	205	2544	0	0	2	3
광주광역시	광산구	월곡2동	월곡2동제4투	2785	2445	340	4	2441	138	2300	0	2	1	0
광주광역시	광산구	월곡2동	월곡2동제5투	2596	2266	330	6	2260	120	2139	0	0	1	0
광주광역시	광산구	비아동	소계	5442	4101	1341	12	4089	296	3783	1	1	6	2
광주광역시	광산구	비아동	비아동제1투	2004	1514	490	5	1509	107	1399	0	0	3	0
광주광역시	광산구	비아동	비아동제2투	3438	2587	851	7	2580	189	2384	1	1	3	2
광주광역시	광산구	첨단1동	소계	16425	14017	2408	31	13986	1131	12826	1	5	17	6
광주광역시	광산구	첨단1동	첨단1동제1투	4081	3481	600	8	3473	320	3150	1	0	2	0
광주광역시	광산구	첨단1동	첨단1동제2투	4076	3477	599	9	3468	279	3178	0	0	7	4
광주광역시	광산구	첨단1동	첨단1동제3투	4565	3869	696	5	3864	329	3527	0	1	6	1
광주광역시	광산구	첨단1동	첨단1동제4투	3703	3190	513	9	3181	203	2971	0	4	2	1
광주광역시	광산구	첨단2동	소계	28531	23291	5240	47	23244	1490	21707	6	12	21	8
광주광역시	광산구	첨단2동	첨단2동제1투	2312	1680	632	2	1678	102	1571	0	4	1	0
광주광역시	광산구	첨단2동	첨단2동제2투	3643	2934	709	6	2928	185	2729	3	1	6	4
광주광역시	광산구	첨단2동	첨단2동제3투	3322	2652	670	4	2648	181	2463	1	1	1	1
광주광역시	광산구	첨단2동	첨단2동제4투	2959	2435	524	10	2425	141	2283	0	0	1	0
광주광역시	광산구	첨단2동	첨단2동제5투	3671	3198	473	6	3192	191	2997	0	2	1	1
광주광역시	광산구	첨단2동	첨단2동제6투	2863	2461	402	3	2458	155	2299	0	1	3	0
광주광역시	광산구	첨단2동	첨단2동제7투	3725	3224	501	9	3215	201	3008	2	2	2	0
광주광역시	광산구	첨단2동	첨단2동제8투	2887	2039	848	2	2037	151	1882	0	1	2	1
광주광역시	광산구	첨단2동	첨단2동제9투	3149	2668	481	5	2663	183	2475	0	0	4	1
광주광역시	광산구	신가동	소계	16943	13602	3341	41	13561	766	12775	0	7	9	4
광주광역시	광산구	신가동	신가동제1투	3148	2325	823	12	2313	150	2161	0	0	2	0
광주광역시	광산구	신가동	신가동제2투	3368	2860	508	4	2856	113	2741	0	1	1	0
광주광역시	광산구	신가동	신가동제3투	1583	1124	459	8	1116	81	1033	0	0	2	0
광주광역시	광산구	신가동	신가동제4투	3898	3190	708	7	3183	170	3008	0	3	0	2
광주광역시	광산구	신가동	신가동제5투	4946	4103	843	10	4093	252	3832	0	3	4	2
광주광역시	광산구	운남동	소계	22519	18999	3520	42	18957	1055	17867	5	2	14	14
광주광역시	광산구	운남동	운남동제1투	2866	2410	456	5	2405	129	2272	2	0	2	0
광주광역시	광산구	운남동	운남동제2투	2251	1946	305	2	1944	121	1822	0	0	0	1
광주광역시	광산구	운남동	운남동제3투	2446	1940	506	4	1936	104	1826	0	0	2	4
광주광역시	광산구	운남동	운남동제4투	1671	1414	257	4	1410	99	1310	0	0	1	0
광주광역시	광산구	운남동	운남동제5투	2917	2422	495	8	2414	123	2287	0	1	1	2
광주광역시	광산구	운남동	운남동제6투	2586	2241	345	5	2236	138	2092	0	1	5	0
광주광역시	광산구	운남동	운남동제7투	2680	2386	294	5	2381	114	2263	3	0	0	1
광주광역시	광산구	운남동	운남동제8투	2710	2213	497	4	2209	124	2079	0	0	3	3
광주광역시	광산구	운남동	운남동제9투	2392	2027	365	5	2022	103	1916	0	0	0	3
광주광역시	광산구	신창동	소계	21868	17880	3988	38	17842	1126	16687	3	6	13	7
광주광역시	광산구	신창동	신창동제1투	1292	940	352	2	938	62	874	1	0	1	0
광주광역시	광산구	신창동	신창동제2투	3277	2822	455	5	2817	175	2638	1	0	2	1
광주광역시	광산구	신창동	신창동제3투	1545	1341	204	6	1335	81	1252	0	1	1	0
광주광역시	광산구	신창동	신창동제4투	3200	2702	498	7	2695	190	2501	0	2	0	2
광주광역시	광산구	신창동	신창동제5투	5151	3742	1409	5	3737	262	3466	1	2	3	3
광주광역시	광산구	신창동	신창동제6투	3319	2917	402	6	2911	162	2746	0	0	2	1
광주광역시	광산구	신창동	신창동제7투	4084	3416	668	7	3409	194	3210	0	1	4	0
광주광역시	광산구	수완동	소계	39911	33267	6644	54	33213	2163	31015	2	6	15	12
광주광역시	광산구	수완동	수완동제1투	3619	3197	422	5	3192	204	2984	0	1	3	0
광주광역시	광산구	수완동	수완동제2투	5731	4706	1025	9	4697	248	4444	0	1	2	2
광주광역시	광산구	수완동	수완동제3투	4314	3651	663	1	3650	176	3473	0	0	0	1
광주광역시	광산구	수완동	수완동제4투	4657	3816	841	3	3813	231	3578	0	2	2	0
광주광역시	광산구	수완동	수완동제5투	3494	3062	432	12	3050	235	2813	0	0	1	1
광주광역시	광산구	수완동	수완동제6투	3707	3060	647	4	3056	199	2854	0	1	1	1
광주광역시	광산구	수완동	수완동제7투	4147	3036	1111	7	3029	154	2873	0	1	0	1
광주광역시	광산구	수완동	수완동제8투	3328	2919	409	2	2917	204	2708	0	0	4	1
광주광역시	광산구	수완동	수완동제9투	3312	2792	520	2	2790	244	2542	1	0	0	3
광주광역시	광산구	수완동	수완동제10투	3602	3028	574	9	3019	268	2746	1	0	2	2
광주광역시	광산구	하남동	소계	9868	8058	1810	22	8036	515	7505	3	1	8	4
광주광역시	광산구	하남동	하남동제1투	2787	2209	578	9	2200	152	2042	1	1	4	0
광주광역시	광산구	하남동	하남동제2투	585	447	138	2	445	35	407	1	0	1	1
광주광역시	광산구	하남동	하남동제3투	4177	3414	763	5	3409	207	3197	1	0	2	2
광주광역시	광산구	하남동	하남동제4투	2319	1988	331	6	1982	121	1859	0	0	1	1
광주광역시	광산구	임곡동	소계	2146	1612	534	15	1597	122	1461	0	3	8	3
광주광역시	광산구	임곡동	임곡동제1투	1103	839	264	9	830	73	746	0	2	8	1
광주광역시	광산구	임곡동	임곡동제2투	1043	773	270	6	767	49	715	0	1	0	2
광주광역시	광산구	동곡동	소계	1975	1516	459	14	1502	114	1376	1	0	7	4
광주광역시	광산구	동곡동	동곡동투표소	1975	1516	459	14	1502	114	1376	1	0	7	4
광주광역시	광산구	평동	소계	3466	2678	788	14	2664	187	2462	2	0	9	4
광주광역시	광산구	평동	평동제1투	1683	1255	428	7	1248	86	1156	1	0	3	2
광주광역시	광산구	평동	평동제2투	1783	1423	360	7	1416	101	1306	1	0	6	2
광주광역시	광산구	삼도동	소계	2452	1844	608	29	1815	156	1641	0	3	11	4
광주광역시	광산구	삼도동	삼도동제1투	1593	1175	418	14	1161	107	1045	0	2	6	1
광주광역시	광산구	삼도동	삼도동제2투	859	669	190	15	654	49	596	0	1	5	3
광주광역시	광산구	본량동	소계	2349	1748	601	42	1706	135	1547	5	0	11	8
광주광역시	광산구	본량동	본량동제1투	1439	1108	331	17	1091	90	990	1	0	6	4
광주광역시	광산구	본량동	본량동제2투	910	640	270	25	615	45	557	4	0	5	4
대전광역시	동구	계	계	202718	150344	52374	417	149927	77725	71702	43	72	200	185
대전광역시	동구	재외투표	재외투표	606	432	174	3	429	156	270	1	0	1	1
대전광역시	동구	국내부재자투표	국내부재자투표	4750	4334	416	79	4255	1955	2262	4	11	13	10
대전광역시	동구	중앙동	소계	7351	4863	2488	11	4852	3013	1815	0	3	9	12
대전광역시	동구	중앙동	중앙동제1투	2459	1645	814	4	1641	1048	589	0	1	1	2
대전광역시	동구	중앙동	중앙동제2투	1686	1163	523	4	1159	734	418	0	0	3	4
대전광역시	동구	중앙동	중앙동제3투	3206	2055	1151	3	2052	1231	808	0	2	5	6
대전광역시	동구	신인동	소계	11500	8730	2770	20	8710	4530	4153	2	0	8	17
대전광역시	동구	신인동	신인동제1투	2881	2035	846	4	2031	1071	955	1	0	1	3
대전광역시	동구	신인동	신인동제2투	3779	3010	769	2	3008	1540	1453	0	0	5	10
대전광역시	동구	신인동	신인동제3투	2779	2181	598	4	2177	1072	1103	1	0	0	1
대전광역시	동구	신인동	신인동제4투	2061	1504	557	10	1494	847	642	0	0	2	3
대전광역시	동구	효동	소계	19016	14688	4328	23	14665	7087	7532	2	8	22	14
대전광역시	동구	효동	효동제1투	3474	2667	807	5	2662	1500	1153	1	2	3	3
대전광역시	동구	효동	효동제2투	2341	1713	628	5	1708	958	741	0	0	3	6
대전광역시	동구	효동	효동제3투	4589	3447	1142	7	3440	1693	1739	0	2	5	1
대전광역시	동구	효동	효동제4투	4975	3953	1022	5	3948	1678	2258	0	1	8	3
대전광역시	동구	효동	효동제5투	3637	2908	729	1	2907	1258	1641	1	3	3	1
대전광역시	동구	판암1동	소계	8450	6432	2018	12	6420	3450	2943	4	0	13	10
대전광역시	동구	판암1동	판암1동제1투	3112	2313	799	8	2305	1277	1013	3	0	6	6
대전광역시	동구	판암1동	판암1동제2투	2663	2007	656	3	2004	1050	949	0	0	3	2
대전광역시	동구	판암1동	판암1동제3투	2675	2112	563	1	2111	1123	981	1	0	4	2
대전광역시	동구	판암2동	소계	9720	7125	2595	22	7103	3944	3134	5	4	4	12
대전광역시	동구	판암2동	판암2동제1투	2521	1847	674	4	1843	1002	832	0	1	2	6
대전광역시	동구	판암2동	판암2동제2투	2222	1624	598	11	1613	992	612	4	1	1	3
대전광역시	동구	판암2동	판암2동제3투	2402	1707	695	4	1703	973	726	1	0	0	3
대전광역시	동구	판암2동	판암2동제4투	2575	1947	628	3	1944	977	964	0	2	1	0
대전광역시	동구	용운동	소계	16477	12359	4118	28	12331	6064	6227	3	7	19	11
대전광역시	동구	용운동	용운동제1투	2757	2011	746	2	2009	1034	971	0	0	2	2
대전광역시	동구	용운동	용운동제2투	2805	2001	804	6	1995	976	1014	0	3	1	1
대전광역시	동구	용운동	용운동제3투	2824	2068	756	7	2061	1150	907	1	0	1	2
대전광역시	동구	용운동	용운동제4투	4234	3265	969	7	3258	1536	1706	1	2	9	4
대전광역시	동구	용운동	용운동제5투	3857	3014	843	6	3008	1368	1629	1	2	6	2
대전광역시	동구	대동	소계	11187	8148	3039	22	8126	4244	3863	2	4	10	3
대전광역시	동구	대동	대동제1투	4499	3253	1246	11	3242	1570	1665	2	2	2	1
대전광역시	동구	대동	대동제2투	3054	2139	915	8	2131	1238	888	0	1	2	2
대전광역시	동구	대동	대동제3투	3634	2756	878	3	2753	1436	1310	0	1	6	0
대전광역시	동구	자양동	소계	9798	6964	2834	19	6945	3758	3166	1	2	10	8
대전광역시	동구	자양동	자양동제1투	3242	2221	1021	7	2214	1150	1058	0	0	2	4
대전광역시	동구	자양동	자양동제2투	3199	2262	937	5	2257	1176	1076	0	1	3	1
대전광역시	동구	자양동	자양동제3투	3357	2481	876	7	2474	1432	1032	1	1	5	3
대전광역시	동구	가양1동	소계	13229	9630	3599	30	9600	5270	4309	2	4	9	6
대전광역시	동구	가양1동	가양1동제1투	2854	1961	893	6	1955	1086	866	0	1	1	1
대전광역시	동구	가양1동	가양1동제2투	2394	1770	624	8	1762	1072	687	0	1	0	2
대전광역시	동구	가양1동	가양1동제3투	4239	3160	1079	8	3152	1613	1529	2	0	5	3
대전광역시	동구	가양1동	가양1동제4투	3742	2739	1003	8	2731	1499	1227	0	2	3	0
대전광역시	동구	가양2동	소계	17780	12897	4883	28	12869	6699	6129	5	6	17	13
대전광역시	동구	가양2동	가양2동제1투	3940	2987	953	4	2983	1538	1443	0	0	2	0
대전광역시	동구	가양2동	가양2동제2투	3586	2627	959	7	2620	1331	1277	2	1	6	3
대전광역시	동구	가양2동	가양2동제3투	3477	2451	1026	4	2447	1241	1201	0	0	2	3
대전광역시	동구	가양2동	가양2동제4투	3836	2838	998	5	2833	1519	1302	1	4	6	1
대전광역시	동구	가양2동	가양2동제5투	2941	1994	947	8	1986	1070	906	2	1	1	6
대전광역시	동구	용전동	소계	17000	12093	4907	24	12069	5950	6090	2	2	13	12
대전광역시	동구	용전동	용전동제1투	4061	3017	1044	7	3010	1489	1519	0	0	2	0
대전광역시	동구	용전동	용전동제2투	3932	2782	1150	4	2778	1341	1425	2	1	5	4
대전광역시	동구	용전동	용전동제3투	4767	3150	1617	5	3145	1618	1520	0	1	2	4
대전광역시	동구	용전동	용전동제4투	4240	3144	1096	8	3136	1502	1626	0	0	4	4
대전광역시	동구	성남동	소계	11639	8657	2982	18	8639	4409	4201	2	3	14	10
대전광역시	동구	성남동	성남동제1투	4861	3728	1133	10	3718	1812	1890	1	2	8	5
대전광역시	동구	성남동	성남동제2투	2919	2182	737	3	2179	1133	1042	0	0	2	2
대전광역시	동구	성남동	성남동제3투	3859	2747	1112	5	2742	1464	1269	1	1	4	3
대전광역시	동구	홍도동	소계	10573	7723	2850	17	7706	3982	3708	2	3	8	3
대전광역시	동구	홍도동	홍도동제1투	2381	1754	627	6	1748	994	748	2	0	2	2
대전광역시	동구	홍도동	홍도동제2투	4234	3280	954	9	3271	1615	1651	0	1	3	1
대전광역시	동구	홍도동	홍도동제3투	3958	2689	1269	2	2687	1373	1309	0	2	3	0
대전광역시	동구	삼성동	소계	14969	11173	3796	22	11151	5925	5197	3	6	12	8
대전광역시	동구	삼성동	삼성동제1투	2180	1621	559	4	1617	923	691	0	0	2	1
대전광역시	동구	삼성동	삼성동제2투	3143	2288	855	5	2283	1212	1066	1	1	3	0
대전광역시	동구	삼성동	삼성동제3투	4644	3529	1115	4	3525	1841	1672	1	3	2	6
대전광역시	동구	삼성동	삼성동제4투	5002	3735	1267	9	3726	1949	1768	1	2	5	1
대전광역시	동구	대청동	소계	2586	1915	671	6	1909	1189	700	1	1	6	12
대전광역시	동구	대청동	대청동제1투	1221	924	297	5	919	573	335	0	1	5	5
대전광역시	동구	대청동	대청동제2투	1365	991	374	1	990	616	365	1	0	1	7
대전광역시	동구	산내동	소계	16087	12181	3906	33	12148	6100	6003	2	8	12	23
대전광역시	동구	산내동	산내동제1투	4460	3391	1069	12	3379	1552	1818	1	4	1	3
대전광역시	동구	산내동	산내동제2투	1122	760	362	3	757	452	296	0	1	1	7
대전광역시	동구	산내동	산내동제3투	3029	2509	520	3	2506	1170	1327	0	2	3	4
대전광역시	동구	산내동	산내동제4투	2564	2009	555	4	2005	1062	937	0	0	4	2
대전광역시	동구	산내동	산내동제5투	1313	928	385	2	926	585	336	1	0	1	3
대전광역시	동구	산내동	산내동제6투	3599	2584	1015	9	2575	1279	1289	0	1	2	4
대전광역시	중구	계	계	210394	159448	50946	463	158985	85297	73173	42	71	230	172
대전광역시	중구	재외투표	재외투표	877	637	240	5	632	252	379	0	0	0	1
대전광역시	중구	국내부재자투표	국내부재자투표	5345	4916	429	115	4801	2300	2453	7	10	14	17
대전광역시	중구	은행선화동	소계	14688	9848	4840	15	9833	5159	4646	2	3	10	13
대전광역시	중구	은행선화동	은행선화동제1투	2946	1930	1016	5	1925	1044	874	1	1	1	4
대전광역시	중구	은행선화동	은행선화동제2투	4854	3417	1437	5	3412	1754	1650	0	0	4	4
대전광역시	중구	은행선화동	은행선화동제3투	2929	2058	871	0	2058	1040	1011	1	1	2	3
대전광역시	중구	은행선화동	은행선화동제4투	3959	2443	1516	5	2438	1321	1111	0	1	3	2
대전광역시	중구	목동	소계	11449	9080	2369	16	9064	4355	4683	2	5	11	8
대전광역시	중구	목동	목동제1투	3193	2517	676	4	2513	1290	1214	1	1	2	5
대전광역시	중구	목동	목동제2투	4597	3580	1017	8	3572	1559	2005	1	3	3	1
대전광역시	중구	목동	목동제3투	3659	2983	676	4	2979	1506	1464	0	1	6	2
대전광역시	중구	중촌동	소계	12735	9846	2889	27	9819	5009	4780	1	3	15	11
대전광역시	중구	중촌동	중촌동제1투	2268	1658	610	3	1655	977	674	0	1	1	2
대전광역시	중구	중촌동	중촌동제2투	2090	1723	367	4	1719	885	830	1	0	3	0
대전광역시	중구	중촌동	중촌동제3투	3508	2695	813	6	2689	1377	1303	0	1	5	3
대전광역시	중구	중촌동	중촌동제4투	3288	2592	696	3	2589	1110	1471	0	0	5	3
대전광역시	중구	중촌동	중촌동제5투	1581	1178	403	11	1167	660	502	0	1	1	3
대전광역시	중구	대흥동	소계	9269	6556	2713	21	6535	3553	2953	2	4	13	10
대전광역시	중구	대흥동	대흥동제1투	3933	2670	1263	6	2664	1438	1218	1	2	3	2
대전광역시	중구	대흥동	대흥동제2투	2901	2093	808	8	2085	1168	907	1	0	5	4
대전광역시	중구	대흥동	대흥동제3투	2435	1793	642	7	1786	947	828	0	2	5	4
대전광역시	중구	문창동	소계	4700	3410	1290	9	3401	1965	1420	2	3	6	5
대전광역시	중구	문창동	문창동제1투	2162	1541	621	5	1536	877	653	0	0	3	3
대전광역시	중구	문창동	문창동제2투	2538	1869	669	4	1865	1088	767	2	3	3	2
대전광역시	중구	석교동	소계	15433	11304	4129	32	11272	6271	4959	4	6	15	17
대전광역시	중구	석교동	석교동제1투	3010	2091	919	8	2083	1192	884	2	1	2	2
대전광역시	중구	석교동	석교동제2투	3343	2489	854	9	2480	1380	1095	0	0	3	2
대전광역시	중구	석교동	석교동제3투	2888	2126	762	4	2122	1132	984	0	1	2	3
대전광역시	중구	석교동	석교동제4투	3065	2322	743	7	2315	1317	987	2	0	4	5
대전광역시	중구	석교동	석교동제5투	3127	2276	851	4	2272	1250	1009	0	4	4	5
대전광역시	중구	대사동	소계	5631	4002	1629	9	3993	2390	1589	2	1	5	6
대전광역시	중구	대사동	대사동제1투	3458	2410	1048	4	2406	1490	907	1	0	4	4
대전광역시	중구	대사동	대사동제2투	2173	1592	581	5	1587	900	682	1	1	1	2
대전광역시	중구	부사동	소계	6232	4444	1788	12	4432	2558	1860	1	1	3	9
대전광역시	중구	부사동	부사동제1투	2992	2102	890	7	2095	1220	868	1	0	1	5
대전광역시	중구	부사동	부사동제2투	3240	2342	898	5	2337	1338	992	0	1	2	4
대전광역시	중구	용두동	소계	8683	6443	2240	14	6429	3254	3162	1	2	9	1
대전광역시	중구	용두동	용두동제1투	2961	2416	545	7	2409	1146	1257	0	2	3	1
대전광역시	중구	용두동	용두동제2투	2571	1747	824	2	1745	959	784	1	0	1	0
대전광역시	중구	용두동	용두동제3투	3151	2280	871	5	2275	1149	1121	0	0	5	0
대전광역시	중구	오류동	소계	8362	6643	1719	9	6634	3737	2875	0	3	14	5
대전광역시	중구	오류동	오류동제1투	2109	1455	654	2	1453	788	656	0	3	4	2
대전광역시	중구	오류동	오류동제2투	3242	2747	495	2	2745	1564	1176	0	0	4	1
대전광역시	중구	오류동	오류동제3투	3011	2441	570	5	2436	1385	1043	0	0	6	2
대전광역시	중구	태평1동	소계	11279	8888	2391	16	8872	4383	4461	0	7	14	7
대전광역시	중구	태평1동	태평1동제1투	3250	2652	598	3	2649	1246	1392	0	0	7	4
대전광역시	중구	태평1동	태평1동제2투	3069	2174	895	3	2171	1222	945	0	2	1	1
대전광역시	중구	태평1동	태평1동제3투	4960	4062	898	10	4052	1915	2124	0	5	6	2
대전광역시	중구	태평2동	소계	22308	18203	4105	37	18166	10152	7966	5	3	29	11
대전광역시	중구	태평2동	태평2동제1투	2769	2066	703	5	2061	1156	899	1	0	3	2
대전광역시	중구	태평2동	태평2동제2투	2934	2344	590	3	2341	1273	1060	2	1	3	2
대전광역시	중구	태평2동	태평2동제3투	3963	3177	786	3	3174	1778	1383	1	1	8	3
대전광역시	중구	태평2동	태평2동제4투	4322	3629	693	7	3622	1969	1645	1	1	5	1
대전광역시	중구	태평2동	태평2동제5투	3778	3155	623	8	3147	1842	1301	0	0	3	1
대전광역시	중구	태평2동	태평2동제6투	4542	3832	710	11	3821	2134	1678	0	0	7	2
대전광역시	중구	유천1동	소계	6335	4312	2023	13	4299	2455	1828	1	1	9	5
대전광역시	중구	유천1동	유천1동제1투	3411	2331	1080	6	2325	1352	965	1	1	3	3
대전광역시	중구	유천1동	유천1동제2투	2924	1981	943	7	1974	1103	863	0	0	6	2
대전광역시	중구	유천2동	소계	12484	9561	2923	20	9541	5314	4202	1	2	14	8
대전광역시	중구	유천2동	유천2동제1투	1865	1367	498	5	1362	771	584	1	0	1	5
대전광역시	중구	유천2동	유천2동제2투	2967	2137	830	4	2133	1195	935	0	0	3	0
대전광역시	중구	유천2동	유천2동제3투	3344	2483	861	6	2477	1279	1191	0	1	4	2
대전광역시	중구	유천2동	유천2동제4투	4308	3574	734	5	3569	2069	1492	0	1	6	1
대전광역시	중구	문화1동	소계	17836	14341	3495	29	14312	7592	6672	5	5	22	16
대전광역시	중구	문화1동	문화1동제1투	1992	1450	542	3	1447	841	596	2	1	2	5
대전광역시	중구	문화1동	문화1동제2투	3258	2674	584	2	2672	1393	1269	1	3	4	2
대전광역시	중구	문화1동	문화1동제3투	3569	2783	786	8	2775	1476	1290	0	0	6	3
대전광역시	중구	문화1동	문화1동제4투	4668	3879	789	7	3872	2001	1863	1	1	4	2
대전광역시	중구	문화1동	문화1동제5투	4349	3555	794	9	3546	1881	1654	1	0	6	4
대전광역시	중구	문화2동	소계	12272	9237	3035	18	9219	5071	4125	0	4	12	7
대전광역시	중구	문화2동	문화2동제1투	2317	1687	630	5	1682	989	689	0	0	1	3
대전광역시	중구	문화2동	문화2동제2투	3876	2975	901	6	2969	1618	1344	0	1	4	2
대전광역시	중구	문화2동	문화2동제3투	3019	2232	787	3	2229	1296	927	0	2	3	1
대전광역시	중구	문화2동	문화2동제4투	3060	2343	717	4	2339	1168	1165	0	1	4	1
대전광역시	중구	산성동	소계	24476	17777	6699	46	17731	9527	8160	6	8	15	15
대전광역시	중구	산성동	산성동제1투	3015	2142	873	5	2137	1261	874	0	0	2	0
대전광역시	중구	산성동	산성동제2투	3304	2529	775	3	2526	1373	1149	3	0	0	1
대전광역시	중구	산성동	산성동제3투	3877	2586	1291	1	2585	1377	1202	1	1	4	0
대전광역시	중구	산성동	산성동제4투	2938	2379	559	8	2371	1331	1035	0	1	1	3
대전광역시	중구	산성동	산성동제5투	3268	2330	938	6	2324	1207	1105	0	2	5	5
대전광역시	중구	산성동	산성동제6투	3354	2375	979	6	2369	1210	1155	1	1	0	2
대전광역시	중구	산성동	산성동제7투	3827	2778	1049	14	2764	1396	1361	0	3	2	2
대전광역시	중구	산성동	산성동제8투	893	658	235	3	655	372	279	1	0	1	2
대전광역시	서구	계	계	382855	293767	89088	743	293024	144068	148011	87	148	414	296
대전광역시	서구	재외투표	재외투표	1601	1162	439	12	1150	387	755	0	2	2	4
대전광역시	서구	국내부재자투표	국내부재자투표	11410	10482	928	147	10335	4806	5435	17	20	20	37
대전광역시	서구	복수동	소계	15817	12351	3466	20	12331	5979	6318	2	4	16	12
대전광역시	서구	복수동	복수동제1투	3432	2627	805	1	2626	1392	1223	1	2	2	6
대전광역시	서구	복수동	복수동제2투	4678	3718	960	6	3712	1901	1801	1	1	7	1
대전광역시	서구	복수동	복수동제3투	2686	2263	423	5	2258	1059	1192	0	0	5	2
대전광역시	서구	복수동	복수동제4투	5021	3743	1278	8	3735	1627	2102	0	1	2	3
대전광역시	서구	도마1동	소계	16265	11455	4810	23	11432	6289	5113	3	2	14	11
대전광역시	서구	도마1동	도마1동제1투	2990	2070	920	3	2067	1228	831	2	0	2	4
대전광역시	서구	도마1동	도마1동제2투	3963	2878	1085	6	2872	1582	1286	1	1	0	2
대전광역시	서구	도마1동	도마1동제3투	2458	1774	684	4	1770	1004	763	0	0	3	0
대전광역시	서구	도마1동	도마1동제4투	3260	2245	1015	1	2244	1206	1031	0	1	4	2
대전광역시	서구	도마1동	도마1동제5투	3594	2488	1106	9	2479	1269	1202	0	0	5	3
대전광역시	서구	도마2동	소계	18070	13262	4808	26	13236	7174	6027	1	7	17	10
대전광역시	서구	도마2동	도마2동제1투	3867	2648	1219	3	2645	1429	1212	0	0	1	3
대전광역시	서구	도마2동	도마2동제2투	3682	2625	1057	9	2616	1441	1164	1	2	6	2
대전광역시	서구	도마2동	도마2동제3투	2905	2013	892	5	2008	1103	899	0	1	3	2
대전광역시	서구	도마2동	도마2동제4투	3922	2964	958	7	2957	1529	1421	0	3	3	1
대전광역시	서구	도마2동	도마2동제5투	3694	3012	682	2	3010	1672	1331	0	1	4	2
대전광역시	서구	정림동	소계	14586	11409	3177	21	11388	5737	5625	1	4	12	9
대전광역시	서구	정림동	정림동제1투	2960	2341	619	4	2337	1186	1142	0	2	5	2
대전광역시	서구	정림동	정림동제2투	3040	2485	555	2	2483	1275	1206	1	0	1	0
대전광역시	서구	정림동	정림동제3투	2465	1898	567	4	1894	1021	870	0	0	1	2
대전광역시	서구	정림동	정림동제4투	3010	2206	804	4	2202	1120	1075	0	1	3	3
대전광역시	서구	정림동	정림동제5투	3111	2479	632	7	2472	1135	1332	0	1	2	2
대전광역시	서구	변동	소계	14865	10706	4159	22	10684	5593	5063	1	4	14	9
대전광역시	서구	변동	변동제1투	3770	2698	1072	6	2692	1423	1266	0	2	1	0
대전광역시	서구	변동	변동제2투	4789	3454	1335	8	3446	1726	1709	0	1	6	4
대전광역시	서구	변동	변동제3투	2912	2079	833	0	2079	1087	988	0	0	4	0
대전광역시	서구	변동	변동제4투	3394	2475	919	8	2467	1357	1100	1	1	3	5
대전광역시	서구	용문동	소계	13396	9354	4042	17	9337	4687	4624	2	7	7	10
대전광역시	서구	용문동	용문동제1투	4977	3224	1753	3	3221	1515	1696	0	2	3	5
대전광역시	서구	용문동	용문동제2투	4447	3261	1186	9	3252	1618	1622	2	4	3	3
대전광역시	서구	용문동	용문동제3투	3972	2869	1103	5	2864	1554	1306	0	1	1	2
대전광역시	서구	탄방동	소계	23233	16939	6294	32	16907	7933	8918	4	8	28	16
대전광역시	서구	탄방동	탄방동제1투	4759	3014	1745	7	3007	1435	1558	3	1	3	7
대전광역시	서구	탄방동	탄방동제2투	5227	3594	1633	11	3583	1560	2013	0	5	4	1
대전광역시	서구	탄방동	탄방동제3투	2531	2065	466	3	2062	1007	1048	0	1	4	2
대전광역시	서구	탄방동	탄방동제4투	2575	2167	408	5	2162	1066	1084	1	0	8	3
대전광역시	서구	탄방동	탄방동제5투	3292	2560	732	6	2554	1276	1271	0	1	5	1
대전광역시	서구	탄방동	탄방동제6투	4849	3539	1310	0	3539	1589	1944	0	0	4	2
대전광역시	서구	둔산1동	소계	12102	10095	2007	12	10083	5810	4246	5	1	16	5
대전광역시	서구	둔산1동	둔산1동제1투	3199	2580	619	3	2577	1583	988	2	0	2	2
대전광역시	서구	둔산1동	둔산1동제2투	2774	2353	421	2	2351	1319	1025	1	0	4	2
대전광역시	서구	둔산1동	둔산1동제3투	3307	2768	539	5	2763	1500	1254	2	1	6	0
대전광역시	서구	둔산1동	둔산1동제4투	2822	2394	428	2	2392	1408	979	0	0	4	1
대전광역시	서구	둔산2동	소계	28452	23446	5006	37	23409	10326	12994	6	14	50	19
대전광역시	서구	둔산2동	둔산2동제1투	4522	3777	745	8	3769	1738	2022	0	1	5	3
대전광역시	서구	둔산2동	둔산2동제2투	4460	3751	709	7	3744	1606	2123	1	2	8	4
대전광역시	서구	둔산2동	둔산2동제3투	4738	3988	750	7	3981	1873	2096	0	2	8	2
대전광역시	서구	둔산2동	둔산2동제4투	3756	3144	612	2	3142	1566	1564	1	1	7	3
대전광역시	서구	둔산2동	둔산2동제5투	3776	3262	514	5	3257	1383	1850	0	6	15	3
대전광역시	서구	둔산2동	둔산2동제6투	3743	3248	495	4	3244	1230	2006	3	1	3	1
대전광역시	서구	둔산2동	둔산2동제7투	3457	2276	1181	4	2272	930	1333	1	1	4	3
대전광역시	서구	둔산3동	소계	16938	13546	3392	25	13521	7431	6067	5	0	14	4
대전광역시	서구	둔산3동	둔산3동제1투	2966	2417	549	4	2413	1273	1138	1	0	1	0
대전광역시	서구	둔산3동	둔산3동제2투	3883	3306	577	9	3297	1857	1430	1	0	9	0
대전광역시	서구	둔산3동	둔산3동제3투	3232	2724	508	2	2722	1629	1091	0	0	1	1
대전광역시	서구	둔산3동	둔산3동제4투	4451	3405	1046	7	3398	1794	1602	0	0	1	1
대전광역시	서구	둔산3동	둔산3동제5투	2406	1694	712	3	1691	878	806	3	0	2	2
대전광역시	서구	괴정동	소계	16535	11067	5468	23	11044	5142	5863	4	8	12	15
대전광역시	서구	괴정동	괴정동제1투	4712	3060	1652	11	3049	1445	1599	2	1	1	1
대전광역시	서구	괴정동	괴정동제2투	5374	3326	2048	4	3322	1460	1849	0	1	4	8
대전광역시	서구	괴정동	괴정동제3투	3441	2397	1044	5	2392	1122	1256	2	4	5	3
대전광역시	서구	괴정동	괴정동제4투	3008	2284	724	3	2281	1115	1159	0	2	2	3
대전광역시	서구	가장동	소계	10815	8499	2316	19	8480	4534	3920	1	4	11	10
대전광역시	서구	가장동	가장동제1투	2073	1481	592	4	1477	814	660	0	0	2	1
대전광역시	서구	가장동	가장동제2투	2556	1917	639	7	1910	1017	884	1	1	4	3
대전광역시	서구	가장동	가장동제3투	3478	2932	546	5	2927	1566	1353	0	2	3	3
대전광역시	서구	가장동	가장동제4투	2708	2169	539	3	2166	1137	1023	0	1	2	3
대전광역시	서구	내동	소계	19817	15583	4234	29	15554	8049	7463	3	2	21	16
대전광역시	서구	내동	내동제1투	2983	2223	760	6	2217	1098	1108	0	0	3	8
대전광역시	서구	내동	내동제2투	3089	2169	920	5	2164	1184	974	0	0	5	1
대전광역시	서구	내동	내동제3투	4843	3682	1161	6	3676	1851	1815	1	1	4	4
대전광역시	서구	내동	내동제4투	3996	3387	609	5	3382	1868	1508	2	1	3	0
대전광역시	서구	내동	내동제5투	4906	4122	784	7	4115	2048	2058	0	0	6	3
대전광역시	서구	갈마1동	소계	19271	13934	5337	18	13916	6793	7096	1	7	12	7
대전광역시	서구	갈마1동	갈마1동제1투	3576	2998	578	5	2993	1617	1373	0	3	0	0
대전광역시	서구	갈마1동	갈마1동제2투	3634	2844	790	2	2842	1481	1357	0	0	2	2
대전광역시	서구	갈마1동	갈마1동제3투	4301	2798	1503	2	2796	1326	1463	0	1	4	2
대전광역시	서구	갈마1동	갈마1동제4투	3809	2579	1230	6	2573	1211	1354	1	1	5	1
대전광역시	서구	갈마1동	갈마1동제5투	3951	2715	1236	3	2712	1158	1549	0	2	1	2
대전광역시	서구	갈마2동	소계	21660	15065	6595	40	15025	6777	8198	7	13	12	18
대전광역시	서구	갈마2동	갈마2동제1투	4519	2579	1940	5	2574	1095	1470	1	4	2	2
대전광역시	서구	갈마2동	갈마2동제2투	4719	3731	988	11	3720	1633	2078	2	2	3	2
대전광역시	서구	갈마2동	갈마2동제3투	4204	3174	1030	10	3164	1396	1760	1	1	2	4
대전광역시	서구	갈마2동	갈마2동제4투	3921	2536	1385	4	2532	1163	1355	2	3	3	6
대전광역시	서구	갈마2동	갈마2동제5투	4297	3045	1252	10	3035	1490	1535	1	3	2	4
대전광역시	서구	월평1동	소계	10217	6868	3349	12	6856	3173	3662	1	2	10	8
대전광역시	서구	월평1동	월평1동제1투	3381	2206	1175	3	2203	1056	1139	0	1	5	2
대전광역시	서구	월평1동	월평1동제2투	3713	2696	1017	6	2690	1213	1467	1	0	5	4
대전광역시	서구	월평1동	월평1동제3투	3123	1966	1157	3	1963	904	1056	0	1	0	2
대전광역시	서구	월평2동	소계	14607	11483	3124	33	11450	6049	5361	3	4	19	14
대전광역시	서구	월평2동	월평2동제1투	3124	2234	890	10	2224	1138	1075	1	2	4	4
대전광역시	서구	월평2동	월평2동제2투	4089	3430	659	6	3424	1749	1667	1	0	5	2
대전광역시	서구	월평2동	월평2동제3투	3240	2360	880	9	2351	1218	1118	1	2	5	7
대전광역시	서구	월평2동	월평2동제4투	4154	3459	695	8	3451	1944	1501	0	0	5	1
대전광역시	서구	월평3동	소계	18265	15370	2895	20	15350	7549	7757	1	7	30	6
대전광역시	서구	월평3동	월평3동제1투	2967	2420	547	2	2418	1113	1301	0	1	3	0
대전광역시	서구	월평3동	월평3동제2투	3032	2526	506	4	2522	1192	1320	0	2	7	1
대전광역시	서구	월평3동	월평3동제3투	4478	3849	629	4	3845	1814	2022	1	1	6	1
대전광역시	서구	월평3동	월평3동제4투	4339	3665	674	7	3658	2090	1557	0	1	7	3
대전광역시	서구	월평3동	월평3동제5투	3449	2910	539	3	2907	1340	1557	0	2	7	1
대전광역시	서구	만년동	소계	10981	8954	2027	14	8940	3859	5049	2	3	22	5
대전광역시	서구	만년동	만년동제1투	4888	3753	1135	3	3750	1528	2206	0	2	13	1
대전광역시	서구	만년동	만년동제2투	2463	2087	376	5	2082	795	1282	0	0	4	1
대전광역시	서구	만년동	만년동제3투	3630	3114	516	6	3108	1536	1561	2	1	5	3
대전광역시	서구	가수원동	소계	16462	12932	3530	24	12908	6283	6593	4	3	14	11
대전광역시	서구	가수원동	가수원동제1투	2826	2138	688	6	2132	1169	957	2	0	3	1
대전광역시	서구	가수원동	가수원동제2투	3785	2938	847	5	2933	1587	1341	0	0	3	2
대전광역시	서구	가수원동	가수원동제3투	3885	2919	966	3	2916	1451	1456	1	1	3	4
대전광역시	서구	가수원동	가수원동제4투	2648	2205	443	5	2200	883	1311	0	1	4	1
대전광역시	서구	가수원동	가수원동제5투	3318	2732	586	5	2727	1193	1528	1	1	1	3
대전광역시	서구	관저1동	소계	11823	9441	2382	24	9417	4404	4985	1	9	11	7
대전광역시	서구	관저1동	관저1동제1투	3720	2896	824	12	2884	1263	1612	1	1	3	4
대전광역시	서구	관저1동	관저1동제2투	3159	2664	495	5	2659	1406	1244	0	5	4	0
대전광역시	서구	관저1동	관저1동제3투	4944	3881	1063	7	3874	1735	2129	0	3	4	3
대전광역시	서구	관저2동	소계	22016	17677	4339	30	17647	7671	9935	1	8	23	9
대전광역시	서구	관저2동	관저2동제1투	4857	3849	1008	5	3844	1851	1988	0	0	4	1
대전광역시	서구	관저2동	관저2동제2투	4674	3793	881	7	3786	1634	2141	0	2	7	2
대전광역시	서구	관저2동	관저2동제3투	4155	3246	909	6	3240	1272	1962	0	1	3	2
대전광역시	서구	관저2동	관저2동제4투	4549	3581	968	9	3572	1526	2043	1	2	0	0
대전광역시	서구	관저2동	관저2동제5투	3781	3208	573	3	3205	1388	1801	0	3	9	4
대전광역시	서구	기성동	소계	3651	2687	964	63	2624	1633	944	11	5	7	24
대전광역시	서구	기성동	기성동제1투	875	630	245	5	625	412	207	1	0	1	4
대전광역시	서구	기성동	기성동제2투	1337	952	385	10	942	587	333	3	3	4	12
대전광역시	서구	기성동	기성동제3투	1439	1105	334	48	1057	634	404	7	2	2	8
대전광역시	서구	잘못 투입·구분된 투표지	잘못 투입·구분된 투표지	0	0	0	0	0	0	0	0	0	0	0
대전광역시	유성구	계	계	225936	179329	46607	424	178905	81928	96401	55	92	282	147
대전광역시	유성구	재외투표	재외투표	1282	923	359	7	916	317	595	0	1	3	0
대전광역시	유성구	국내부재자투표	국내부재자투표	7395	6768	627	106	6662	3039	3563	12	12	18	18
대전광역시	유성구	진잠동	소계	24305	18327	5978	51	18276	8959	9264	5	10	20	18
대전광역시	유성구	진잠동	진잠동제1투	4226	2903	1323	7	2896	1497	1393	0	1	2	3
대전광역시	유성구	진잠동	진잠동제2투	3244	2620	624	9	2611	1240	1364	0	3	4	0
대전광역시	유성구	진잠동	진잠동제3투	3144	2525	619	4	2521	1189	1320	1	2	4	5
대전광역시	유성구	진잠동	진잠동제4투	3064	1860	1204	8	1852	1056	782	3	2	3	6
대전광역시	유성구	진잠동	진잠동제5투	536	390	146	2	388	235	150	1	0	1	1
대전광역시	유성구	진잠동	진잠동제6투	717	555	162	3	552	315	237	0	0	0	0
대전광역시	유성구	진잠동	진잠동제7투	3879	2993	886	10	2983	1359	1621	0	1	0	2
대전광역시	유성구	진잠동	진잠동제8투	3261	2648	613	4	2644	1158	1479	0	0	6	1
대전광역시	유성구	진잠동	진잠동제9투	2234	1833	401	4	1829	910	918	0	1	0	0
대전광역시	유성구	온천1동	소계	41579	31255	10324	74	31181	15405	15713	6	9	34	14
대전광역시	유성구	온천1동	온천1동제1투	4488	3145	1343	11	3134	1681	1447	1	0	4	1
대전광역시	유성구	온천1동	온천1동제2투	4952	3516	1436	8	3508	1845	1656	1	1	3	2
대전광역시	유성구	온천1동	온천1동제3투	3410	2620	790	10	2610	1457	1143	0	2	5	3
대전광역시	유성구	온천1동	온천1동제4투	4830	3217	1613	9	3208	1736	1470	0	1	0	1
대전광역시	유성구	온천1동	온천1동제5투	3638	3016	622	6	3010	1530	1476	0	0	4	0
대전광역시	유성구	온천1동	온천1동제6투	2151	1559	592	2	1557	689	865	1	2	0	0
대전광역시	유성구	온천1동	온천1동제7투	2714	2059	655	6	2053	965	1084	0	1	2	1
대전광역시	유성구	온천1동	온천1동제8투	1936	1645	291	2	1643	786	855	0	1	1	0
대전광역시	유성구	온천1동	온천1동제9투	3699	2797	902	5	2792	1258	1527	1	1	1	4
대전광역시	유성구	온천1동	온천1동제10투	2924	1886	1038	4	1882	790	1088	2	0	2	0
대전광역시	유성구	온천1동	온천1동제11투	4434	3771	663	11	3760	1942	1809	0	0	7	2
대전광역시	유성구	온천1동	온천1동제12투	2403	2024	379	0	2024	726	1293	0	0	5	0
대전광역시	유성구	온천2동	소계	25454	19582	5872	35	19547	9139	10332	8	10	38	20
대전광역시	유성구	온천2동	온천2동제1투	4367	2966	1401	4	2962	1550	1403	1	0	4	4
대전광역시	유성구	온천2동	온천2동제2투	5223	3936	1287	6	3930	2114	1802	2	0	8	4
대전광역시	유성구	온천2동	온천2동제3투	3101	2247	854	9	2238	962	1267	2	2	3	2
대전광역시	유성구	온천2동	온천2동제4투	3014	2481	533	1	2480	1124	1348	0	2	5	1
대전광역시	유성구	온천2동	온천2동제5투	2891	2448	443	7	2441	1056	1371	1	1	9	3
대전광역시	유성구	온천2동	온천2동제6투	3481	2910	571	6	2904	1161	1729	1	3	7	3
대전광역시	유성구	온천2동	온천2동제7투	3377	2594	783	2	2592	1172	1412	1	2	2	3
대전광역시	유성구	노은1동	소계	16302	13172	3130	23	13149	6018	7101	1	5	17	7
대전광역시	유성구	노은1동	노은1동제1투	3548	2818	730	4	2814	1061	1747	1	0	4	1
대전광역시	유성구	노은1동	노은1동제2투	3987	3418	569	6	3412	1720	1686	0	0	3	3
대전광역시	유성구	노은1동	노은1동제3투	4637	3718	919	3	3715	1571	2136	0	2	4	2
대전광역시	유성구	노은1동	노은1동제4투	4130	3218	912	10	3208	1666	1532	0	3	6	1
대전광역시	유성구	노은2동	소계	30592	25148	5444	33	25115	10943	14102	10	5	41	14
대전광역시	유성구	노은2동	노은2동제1투	4356	3723	633	4	3719	1657	2048	4	0	6	4
대전광역시	유성구	노은2동	노은2동제2투	4110	3400	710	3	3397	1419	1969	0	0	4	5
대전광역시	유성구	노은2동	노은2동제3투	3770	3139	631	5	3134	1396	1732	0	0	5	1
대전광역시	유성구	노은2동	노은2동제4투	3346	2569	777	0	2569	1152	1408	2	0	7	0
대전광역시	유성구	노은2동	노은2동제5투	3772	3042	730	5	3037	1234	1794	2	1	5	1
대전광역시	유성구	노은2동	노은2동제6투	3183	2657	526	6	2651	1350	1298	1	0	1	1
대전광역시	유성구	노은2동	노은2동제7투	3431	2938	493	1	2937	1183	1748	0	1	4	1
대전광역시	유성구	노은2동	노은2동제8투	1828	1593	235	2	1591	619	964	1	1	6	0
대전광역시	유성구	노은2동	노은2동제9투	2796	2087	709	7	2080	933	1141	0	2	3	1
대전광역시	유성구	신성동	소계	18461	14994	3467	25	14969	7453	7447	8	9	39	13
대전광역시	유성구	신성동	신성동제1투	2468	1883	585	4	1879	792	1080	2	0	3	2
대전광역시	유성구	신성동	신성동제2투	2894	2391	503	4	2387	1021	1354	1	0	7	4
대전광역시	유성구	신성동	신성동제3투	3946	3142	804	5	3137	1179	1943	1	5	8	1
대전광역시	유성구	신성동	신성동제4투	3374	2842	532	7	2835	1227	1597	1	1	8	1
대전광역시	유성구	신성동	신성동제5투	4114	3375	739	4	3371	2336	1021	2	2	5	5
대전광역시	유성구	신성동	신성동제6투	1665	1361	304	1	1360	898	452	1	1	8	0
대전광역시	유성구	전민동	소계	18026	14934	3092	23	14911	6451	8426	1	1	22	10
대전광역시	유성구	전민동	전민동제1투	3386	2801	585	4	2797	1047	1744	0	0	5	1
대전광역시	유성구	전민동	전민동제2투	4351	3434	917	4	3430	1452	1969	0	0	6	3
대전광역시	유성구	전민동	전민동제3투	3268	2777	491	4	2773	1169	1598	1	0	3	2
대전광역시	유성구	전민동	전민동제4투	3206	2674	532	4	2670	1270	1393	0	0	5	2
대전광역시	유성구	전민동	전민동제5투	3815	3248	567	7	3241	1513	1722	0	1	3	2
대전광역시	유성구	구즉동	소계	22459	17482	4977	28	17454	7136	10248	3	21	23	23
대전광역시	유성구	구즉동	구즉동제1투	1956	1299	657	4	1295	528	760	0	1	2	4
대전광역시	유성구	구즉동	구즉동제2투	735	510	225	1	509	296	208	1	0	1	3
대전광역시	유성구	구즉동	구즉동제3투	522	393	129	0	393	238	155	0	0	0	0
대전광역시	유성구	구즉동	구즉동제4투	3129	2210	919	8	2202	982	1206	0	1	7	6
대전광역시	유성구	구즉동	구즉동제5투	4392	3610	782	2	3608	1495	2102	1	4	3	3
대전광역시	유성구	구즉동	구즉동제6투	3803	3034	769	5	3029	1124	1891	1	7	3	3
대전광역시	유성구	구즉동	구즉동제7투	3671	3019	652	5	3014	1108	1892	0	6	5	3
대전광역시	유성구	구즉동	구즉동제8투	4251	3407	844	3	3404	1365	2034	0	2	2	1
대전광역시	유성구	관평동	소계	20081	16744	3337	19	16725	7068	9610	1	9	27	10
대전광역시	유성구	관평동	관평동제1투	3477	2981	496	2	2979	1087	1883	0	2	6	1
대전광역시	유성구	관평동	관평동제2투	2998	2567	431	4	2563	1019	1538	0	0	2	4
대전광역시	유성구	관평동	관평동제3투	4371	3738	633	4	3734	1496	2223	1	2	8	4
대전광역시	유성구	관평동	관평동제4투	3896	3186	710	8	3178	1717	1452	0	2	7	0
대전광역시	유성구	관평동	관평동제5투	5339	4272	1067	1	4271	1749	2514	0	3	4	1
대전광역시	대덕구	계	계	160418	121479	38939	442	121037	61558	59023	44	78	165	169
대전광역시	대덕구	재외투표	재외투표	466	327	139	3	324	107	215	1	0	1	0
대전광역시	대덕구	국내부재자투표	국내부재자투표	4139	3799	340	64	3735	1751	1933	10	6	15	20
대전광역시	대덕구	오정동	소계	15833	11480	4353	25	11455	6085	5334	1	5	14	16
대전광역시	대덕구	오정동	오정동제1투	2835	2055	780	1	2054	1123	926	0	0	1	4
대전광역시	대덕구	오정동	오정동제2투	1856	1306	550	4	1302	727	570	0	0	4	1
대전광역시	대덕구	오정동	오정동제3투	2607	1821	786	4	1817	838	969	0	5	2	3
대전광역시	대덕구	오정동	오정동제4투	2787	2019	768	7	2012	1132	873	1	0	1	5
대전광역시	대덕구	오정동	오정동제5투	3234	2586	648	5	2581	1361	1218	0	0	2	0
대전광역시	대덕구	오정동	오정동제6투	2514	1693	821	4	1689	904	778	0	0	4	3
대전광역시	대덕구	대화동	소계	7930	5682	2248	102	5580	3063	2472	6	11	11	17
대전광역시	대덕구	대화동	대화동제1투	2518	1745	773	90	1655	915	706	6	8	7	13
대전광역시	대덕구	대화동	대화동제2투	2207	1603	604	5	1598	912	683	0	1	0	2
대전광역시	대덕구	대화동	대화동제3투	3205	2334	871	7	2327	1236	1083	0	2	4	2
대전광역시	대덕구	회덕동	소계	14017	10528	3489	27	10501	5657	4803	3	6	17	15
대전광역시	대덕구	회덕동	회덕동제1투	3391	2649	742	5	2644	1358	1274	1	2	7	2
대전광역시	대덕구	회덕동	회덕동제2투	2806	1994	812	4	1990	1067	911	0	1	5	6
대전광역시	대덕구	회덕동	회덕동제3투	3332	2387	945	9	2378	1283	1089	0	2	2	2
대전광역시	대덕구	회덕동	회덕동제4투	3711	2940	771	8	2932	1602	1323	1	1	2	3
대전광역시	대덕구	회덕동	회덕동제5투	777	558	219	1	557	347	206	1	0	1	2
대전광역시	대덕구	비래동	소계	14650	11199	3451	23	11176	5833	5310	4	5	11	13
대전광역시	대덕구	비래동	비래동제1투	3048	2271	777	3	2268	1255	1006	0	2	2	3
대전광역시	대덕구	비래동	비래동제2투	2733	2089	644	4	2085	1111	969	1	0	1	3
대전광역시	대덕구	비래동	비래동제3투	2939	2217	722	5	2212	1140	1062	3	1	3	3
대전광역시	대덕구	비래동	비래동제4투	3326	2570	756	5	2565	1339	1221	0	1	2	2
대전광역시	대덕구	비래동	비래동제5투	2604	2052	552	6	2046	988	1052	0	1	3	2
대전광역시	대덕구	송촌동	소계	21852	17279	4573	33	17246	8088	9111	3	8	23	13
대전광역시	대덕구	송촌동	송촌동제1투	3608	3055	553	3	3052	1409	1627	0	2	9	5
대전광역시	대덕구	송촌동	송촌동제2투	3921	3097	824	4	3093	1371	1716	0	1	3	2
대전광역시	대덕구	송촌동	송촌동제3투	3606	2984	622	9	2975	1260	1711	1	0	1	2
대전광역시	대덕구	송촌동	송촌동제4투	3835	3132	703	6	3126	1467	1653	1	2	3	0
대전광역시	대덕구	송촌동	송촌동제5투	2022	1459	563	3	1456	712	738	1	0	3	2
대전광역시	대덕구	송촌동	송촌동제6투	2325	1636	689	4	1632	895	730	0	2	3	2
대전광역시	대덕구	송촌동	송촌동제7투	2535	1916	619	4	1912	974	936	0	1	1	0
대전광역시	대덕구	중리동	소계	18873	13306	5567	26	13280	6791	6441	4	6	22	16
대전광역시	대덕구	중리동	중리동제1투	2773	1922	851	5	1917	1066	844	1	2	3	1
대전광역시	대덕구	중리동	중리동제2투	1997	1454	543	5	1449	715	728	0	1	1	4
대전광역시	대덕구	중리동	중리동제3투	2621	1807	814	2	1805	906	891	0	1	4	3
대전광역시	대덕구	중리동	중리동제4투	2923	2179	744	5	2174	1079	1085	2	1	3	4
대전광역시	대덕구	중리동	중리동제5투	2839	1932	907	1	1931	969	955	0	0	5	2
대전광역시	대덕구	중리동	중리동제6투	3002	2160	842	4	2156	1159	990	1	1	4	1
대전광역시	대덕구	중리동	중리동제7투	2718	1852	866	4	1848	897	948	0	0	2	1
대전광역시	대덕구	법1동	소계	11161	8409	2752	24	8385	4213	4153	1	5	6	7
대전광역시	대덕구	법1동	법1동제1투	2011	1450	561	3	1447	679	765	0	0	1	2
대전광역시	대덕구	법1동	법1동제2투	2832	2134	698	4	2130	948	1176	1	3	2	0
대전광역시	대덕구	법1동	법1동제3투	3765	3040	725	6	3034	1559	1469	0	2	2	2
대전광역시	대덕구	법1동	법1동제4투	2553	1785	768	11	1774	1027	743	0	0	1	3
대전광역시	대덕구	법2동	소계	15009	12100	2909	32	12068	6161	5866	3	8	18	12
대전광역시	대덕구	법2동	법2동제1투	2702	1974	728	11	1963	1108	841	3	3	3	5
대전광역시	대덕구	법2동	법2동제2투	4455	3734	721	6	3728	1986	1734	0	0	5	3
대전광역시	대덕구	법2동	법2동제3투	4422	3673	749	9	3664	1806	1847	0	3	6	2
대전광역시	대덕구	법2동	법2동제4투	994	690	304	1	689	402	283	0	1	2	1
대전광역시	대덕구	법2동	법2동제5투	2436	2029	407	5	2024	859	1161	0	1	2	1
대전광역시	대덕구	신탄진동	소계	10505	7812	2693	21	7791	4197	3570	2	2	10	10
대전광역시	대덕구	신탄진동	신탄진동제1투	3186	2209	977	3	2206	1206	995	0	0	4	1
대전광역시	대덕구	신탄진동	신탄진동제2투	3359	2654	705	7	2647	1365	1274	0	1	2	5
대전광역시	대덕구	신탄진동	신탄진동제3투	3331	2487	844	8	2479	1361	1110	2	1	3	2
대전광역시	대덕구	신탄진동	신탄진동제4투	629	462	167	3	459	265	191	0	0	1	2
대전광역시	대덕구	석봉동	소계	7904	6103	1801	21	6082	3092	2973	2	4	2	9
대전광역시	대덕구	석봉동	석봉동제1투	2957	2239	718	9	2230	1223	1000	0	2	1	4
대전광역시	대덕구	석봉동	석봉동제2투	2207	1644	563	8	1636	950	681	2	1	1	1
대전광역시	대덕구	석봉동	석봉동제3투	2740	2220	520	4	2216	919	1292	0	1	0	4
대전광역시	대덕구	덕암동	소계	12683	9416	3267	31	9385	4615	4731	2	7	13	17
대전광역시	대덕구	덕암동	덕암동제1투	3478	2495	983	13	2482	1297	1170	0	4	4	7
대전광역시	대덕구	덕암동	덕암동제2투	4123	3151	972	9	3142	1510	1623	1	0	5	3
대전광역시	대덕구	덕암동	덕암동제3투	3511	2513	998	7	2506	1298	1198	1	3	0	6
대전광역시	대덕구	덕암동	덕암동제4투	1571	1257	314	2	1255	510	740	0	0	4	1
대전광역시	대덕구	목상동	소계	5396	4039	1357	10	4029	1905	2111	2	5	2	4
대전광역시	대덕구	목상동	목상동제1투	2570	1834	736	2	1832	901	928	0	1	1	1
대전광역시	대덕구	목상동	목상동제2투	2826	2205	621	8	2197	1004	1183	2	4	1	3
울산광역시	중구	계	계	185086	144599	40487	509	144090	90238	53304	41	74	148	285
울산광역시	중구	재외투표	재외투표	703	483	220	5	478	194	282	0	0	2	0
울산광역시	중구	국내부재자투표	국내부재자투표	5670	5282	388	114	5168	2522	2581	6	9	17	33
울산광역시	중구	학성동	소계	9947	7362	2585	25	7337	5104	2210	0	5	3	15
울산광역시	중구	학성동	학성동제1투	2484	1740	744	7	1733	1213	516	0	2	1	1
울산광역시	중구	학성동	학성동제2투	2524	1908	616	10	1898	1358	534	0	2	0	4
울산광역시	중구	학성동	학성동제3투	2381	1866	515	5	1861	1277	577	0	1	1	5
울산광역시	중구	학성동	학성동제4투	2558	1848	710	3	1845	1256	583	0	0	1	5
울산광역시	중구	반구1동	소계	13306	10033	3273	33	10000	6273	3677	5	8	16	21
울산광역시	중구	반구1동	반구1동제1투	2914	2044	870	7	2037	1346	680	1	3	4	3
울산광역시	중구	반구1동	반구1동제2투	3769	3005	764	11	2994	1743	1229	1	2	10	9
울산광역시	중구	반구1동	반구1동제3투	4006	3050	956	10	3040	1960	1068	1	2	2	7
울산광역시	중구	반구1동	반구1동제4투	2617	1934	683	5	1929	1224	700	2	1	0	2
울산광역시	중구	반구2동	소계	8261	6406	1855	27	6379	4146	2206	2	1	9	15
울산광역시	중구	반구2동	반구2동제1투	2993	2273	720	12	2261	1471	779	0	1	4	6
울산광역시	중구	반구2동	반구2동제2투	2900	2308	592	10	2298	1496	795	1	0	2	4
울산광역시	중구	반구2동	반구2동제3투	2368	1825	543	5	1820	1179	632	1	0	3	5
울산광역시	중구	복산1동	소계	8434	6243	2191	14	6229	4173	2033	2	3	2	16
울산광역시	중구	복산1동	복산1동제1투	3274	2470	804	6	2464	1595	862	0	1	1	5
울산광역시	중구	복산1동	복산1동제2투	3054	2197	857	2	2195	1478	710	2	1	0	4
울산광역시	중구	복산1동	복산1동제3투	2106	1576	530	6	1570	1100	461	0	1	1	7
울산광역시	중구	복산2동	소계	7758	6102	1656	13	6089	3809	2263	2	1	6	8
울산광역시	중구	복산2동	복산2동제1투	2851	2296	555	7	2289	1382	895	0	0	5	7
울산광역시	중구	복산2동	복산2동제2투	2876	2216	660	3	2213	1382	828	0	1	1	1
울산광역시	중구	복산2동	복산2동제3투	2031	1590	441	3	1587	1045	540	2	0	0	0
울산광역시	중구	북정동	소계	16404	12922	3482	31	12891	7579	5268	3	6	14	21
울산광역시	중구	북정동	북정동제1투	2276	1652	624	4	1648	1189	452	2	0	2	3
울산광역시	중구	북정동	북정동제2투	3688	2928	760	4	2924	1671	1242	0	1	1	9
울산광역시	중구	북정동	북정동제3투	3413	2672	741	8	2664	1550	1110	1	1	1	1
울산광역시	중구	북정동	북정동제4투	3612	2886	726	4	2882	1613	1259	0	2	6	2
울산광역시	중구	북정동	북정동제5투	3415	2784	631	11	2773	1556	1205	0	2	4	6
울산광역시	중구	중앙동	소계	12492	9035	3457	25	9010	6473	2515	2	3	4	13
울산광역시	중구	중앙동	중앙동제1투	3754	2618	1136	8	2610	1935	673	0	0	1	1
울산광역시	중구	중앙동	중앙동제2투	3215	2410	805	5	2405	1721	677	2	0	1	4
울산광역시	중구	중앙동	중앙동제3투	2814	2006	808	3	2003	1403	594	0	1	0	5
울산광역시	중구	중앙동	중앙동제4투	2709	2001	708	9	1992	1414	571	0	2	2	3
울산광역시	중구	우정동	소계	18172	14329	3843	50	14279	9246	4989	3	6	9	26
울산광역시	중구	우정동	우정동제1투	4161	3051	1110	9	3042	2069	962	1	3	1	6
울산광역시	중구	우정동	우정동제2투	3048	2102	946	11	2091	1509	577	0	0	1	4
울산광역시	중구	우정동	우정동제3투	2440	1907	533	3	1904	1303	594	1	1	0	5
울산광역시	중구	우정동	우정동제4투	4187	3545	642	11	3534	2139	1384	0	1	4	6
울산광역시	중구	우정동	우정동제5투	4336	3724	612	16	3708	2226	1472	1	1	3	5
울산광역시	중구	태화동	소계	20161	16355	3806	32	16323	10097	6182	1	4	14	25
울산광역시	중구	태화동	태화동제1투	3018	2355	663	5	2350	1568	774	0	1	3	4
울산광역시	중구	태화동	태화동제2투	2794	2145	649	3	2142	1429	705	0	0	0	8
울산광역시	중구	태화동	태화동제3투	4215	3393	822	6	3387	2141	1238	1	0	4	3
울산광역시	중구	태화동	태화동제4투	3152	2685	467	3	2682	1568	1110	0	0	0	4
울산광역시	중구	태화동	태화동제5투	3482	2779	703	10	2769	1750	1012	0	0	4	3
울산광역시	중구	태화동	태화동제6투	3500	2998	502	5	2993	1641	1343	0	3	3	3
울산광역시	중구	다운동	소계	23433	18197	5236	51	18146	11629	6447	5	8	21	36
울산광역시	중구	다운동	다운동제1투	4386	3377	1009	9	3368	2194	1161	1	1	6	5
울산광역시	중구	다운동	다운동제2투	3903	2883	1020	10	2873	1868	995	0	2	3	5
울산광역시	중구	다운동	다운동제3투	3859	3094	765	5	3089	1983	1095	1	2	0	8
울산광역시	중구	다운동	다운동제4투	3870	2950	920	7	2943	1995	938	0	1	4	5
울산광역시	중구	다운동	다운동제5투	3702	2855	847	10	2845	1885	951	1	1	3	4
울산광역시	중구	다운동	다운동제6투	3713	3038	675	10	3028	1704	1307	2	1	5	9
울산광역시	중구	병영1동	소계	20737	16206	4531	42	16164	9756	6360	4	7	15	22
울산광역시	중구	병영1동	병영1동제1투	3681	2651	1030	7	2644	1755	882	0	2	2	3
울산광역시	중구	병영1동	병영1동제2투	3223	2412	811	7	2405	1531	865	1	0	3	5
울산광역시	중구	병영1동	병영1동제3투	2855	2183	672	9	2174	1367	801	0	1	0	5
울산광역시	중구	병영1동	병영1동제4투	2969	2171	798	9	2162	1482	668	2	1	2	7
울산광역시	중구	병영1동	병영1동제5투	3378	2798	580	6	2792	1540	1247	0	1	3	1
울산광역시	중구	병영1동	병영1동제6투	4631	3991	640	4	3987	2081	1897	1	2	5	1
울산광역시	중구	병영2동	소계	13547	10443	3104	38	10405	6358	3996	5	9	11	26
울산광역시	중구	병영2동	병영2동제1투	3346	2609	737	7	2602	1577	1010	1	5	3	6
울산광역시	중구	병영2동	병영2동제2투	2144	1588	556	6	1582	1023	550	1	1	2	5
울산광역시	중구	병영2동	병영2동제3투	2132	1563	569	5	1558	969	583	0	1	0	5
울산광역시	중구	병영2동	병영2동제4투	2429	1820	609	10	1810	1216	582	2	2	2	6
울산광역시	중구	병영2동	병영2동제5투	3496	2863	633	10	2853	1573	1271	1	0	4	4
울산광역시	중구	약사동	소계	6061	5201	860	9	5192	2879	2295	1	4	5	8
울산광역시	중구	약사동	약사동제1투	3034	2643	391	6	2637	1470	1156	1	2	3	5
울산광역시	중구	약사동	약사동제2투	3027	2558	469	3	2555	1409	1139	0	2	2	3
울산광역시	남구	계	계	269354	211458	57896	615	210843	129515	80536	52	88	291	361
울산광역시	남구	재외투표	재외투표	1042	710	332	5	705	314	385	2	2	2	0
울산광역시	남구	국내부재자투표	국내부재자투표	8480	7859	621	111	7748	3817	3851	9	10	17	44
울산광역시	남구	신정1동	소계	16511	12547	3964	36	12511	8581	3893	4	3	14	16
울산광역시	남구	신정1동	신정1동제1투	4339	2939	1400	14	2925	2094	825	0	2	1	3
울산광역시	남구	신정1동	신정1동제2투	4055	3039	1016	9	3030	2153	867	1	0	3	6
울산광역시	남구	신정1동	신정1동제3투	4110	3313	797	7	3306	2171	1121	1	1	8	4
울산광역시	남구	신정1동	신정1동제4투	4007	3256	751	6	3250	2163	1080	2	0	2	3
울산광역시	남구	신정2동	소계	16856	13491	3365	26	13465	8742	4676	2	2	20	23
울산광역시	남구	신정2동	신정2동제1투	3489	2537	952	6	2531	1741	783	0	0	3	4
울산광역시	남구	신정2동	신정2동제2투	3152	2519	633	2	2517	1464	1042	1	2	3	5
울산광역시	남구	신정2동	신정2동제3투	3180	2479	701	6	2473	1710	755	0	0	3	5
울산광역시	남구	신정2동	신정2동제4투	4384	3650	734	8	3642	2324	1307	0	0	6	5
울산광역시	남구	신정2동	신정2동제5투	2651	2306	345	4	2302	1503	789	1	0	5	4
울산광역시	남구	신정3동	소계	12136	9094	3042	26	9068	6032	2997	1	9	17	12
울산광역시	남구	신정3동	신정3동제1투	3427	2453	974	3	2450	1735	699	1	4	5	6
울산광역시	남구	신정3동	신정3동제2투	4069	3275	794	10	3265	1938	1317	0	2	8	0
울산광역시	남구	신정3동	신정3동제3투	4640	3366	1274	13	3353	2359	981	0	3	4	6
울산광역시	남구	신정4동	소계	18902	15206	3696	30	15176	9229	5904	3	3	11	26
울산광역시	남구	신정4동	신정4동제1투	3965	3328	637	7	3321	1935	1381	0	0	2	3
울산광역시	남구	신정4동	신정4동제2투	3330	2627	703	5	2622	1738	873	1	1	4	5
울산광역시	남구	신정4동	신정4동제3투	3121	2521	600	5	2516	1615	894	2	2	0	3
울산광역시	남구	신정4동	신정4동제4투	2292	1765	527	6	1759	1170	585	0	0	0	4
울산광역시	남구	신정4동	신정4동제5투	2878	2163	715	1	2162	1271	886	0	0	1	4
울산광역시	남구	신정4동	신정4동제6투	3316	2802	514	6	2796	1500	1285	0	0	4	7
울산광역시	남구	신정5동	소계	7156	5267	1889	9	5258	3522	1713	1	1	9	12
울산광역시	남구	신정5동	신정5동제1투	3844	2901	943	4	2897	1918	966	0	1	6	6
울산광역시	남구	신정5동	신정5동제2투	3312	2366	946	5	2361	1604	747	1	0	3	6
울산광역시	남구	달동	소계	23709	18045	5664	47	17998	11045	6885	3	6	28	31
울산광역시	남구	달동	달동제1투	5098	3605	1493	6	3599	2276	1310	1	0	8	4
울산광역시	남구	달동	달동제2투	3754	2750	1004	11	2739	1816	910	0	2	5	6
울산광역시	남구	달동	달동제3투	3106	2506	600	3	2503	1483	1017	0	1	1	1
울산광역시	남구	달동	달동제4투	3420	2462	958	13	2449	1655	781	1	3	2	7
울산광역시	남구	달동	달동제5투	3950	3118	832	5	3113	1754	1341	1	0	7	10
울산광역시	남구	달동	달동제6투	4381	3604	777	9	3595	2061	1526	0	0	5	3
울산광역시	남구	삼산동	소계	37929	28152	9777	71	28081	16290	11709	6	15	31	30
울산광역시	남구	삼산동	삼산동제1투	4783	3631	1152	7	3624	2086	1528	0	3	4	3
울산광역시	남구	삼산동	삼산동제2투	3880	2895	985	8	2887	1805	1073	2	3	3	1
울산광역시	남구	삼산동	삼산동제3투	3569	2737	832	6	2731	1729	989	1	3	6	3
울산광역시	남구	삼산동	삼산동제4투	4365	2426	1939	4	2422	1506	915	0	0	0	1
울산광역시	남구	삼산동	삼산동제5투	3655	2776	879	13	2763	1476	1283	0	0	3	1
울산광역시	남구	삼산동	삼산동제6투	4783	3825	958	12	3813	2093	1709	1	0	5	5
울산광역시	남구	삼산동	삼산동제7투	3477	2926	551	7	2919	1430	1478	0	3	3	5
울산광역시	남구	삼산동	삼산동제8투	4389	3254	1135	8	3246	1996	1238	2	2	3	5
울산광역시	남구	삼산동	삼산동제9투	5028	3682	1346	6	3676	2169	1496	0	1	4	6
울산광역시	남구	삼호동	소계	18319	14120	4199	33	14087	8823	5207	5	6	23	23
울산광역시	남구	삼호동	삼호동제1투	2710	1978	732	6	1972	1321	648	0	0	2	1
울산광역시	남구	삼호동	삼호동제2투	3871	2916	955	7	2909	1915	982	0	2	4	6
울산광역시	남구	삼호동	삼호동제3투	3660	2712	948	4	2708	1824	873	1	0	6	4
울산광역시	남구	삼호동	삼호동제4투	3853	2948	905	8	2940	1802	1124	2	2	9	1
울산광역시	남구	삼호동	삼호동제5투	4225	3566	659	8	3558	1961	1580	2	2	2	11
울산광역시	남구	무거동	소계	27077	21845	5232	56	21789	12579	9137	3	4	35	31
울산광역시	남구	무거동	무거동제1투	3483	2621	862	12	2609	1638	963	0	0	4	4
울산광역시	남구	무거동	무거동제2투	2914	2285	629	6	2279	1422	844	0	0	7	6
울산광역시	남구	무거동	무거동제3투	4056	3339	717	8	3331	1928	1396	0	1	4	2
울산광역시	남구	무거동	무거동제4투	3625	2995	630	5	2990	1549	1427	1	0	7	6
울산광역시	남구	무거동	무거동제5투	4205	3277	928	8	3269	2024	1238	1	1	2	3
울산광역시	남구	무거동	무거동제6투	4709	3927	782	11	3916	2114	1788	1	1	8	4
울산광역시	남구	무거동	무거동제7투	4085	3401	684	6	3395	1904	1481	0	1	3	6
울산광역시	남구	옥동	소계	20350	17020	3330	45	16975	10374	6556	3	6	19	17
울산광역시	남구	옥동	옥동제1투	3419	2694	725	8	2686	1771	906	1	2	1	5
울산광역시	남구	옥동	옥동제2투	3825	3258	567	6	3252	1979	1265	0	1	4	3
울산광역시	남구	옥동	옥동제3투	3069	2634	435	3	2631	1526	1099	1	0	3	2
울산광역시	남구	옥동	옥동제4투	3348	2773	575	11	2762	1631	1123	0	1	4	3
울산광역시	남구	옥동	옥동제5투	3588	3018	570	6	3012	1887	1117	0	1	3	4
울산광역시	남구	옥동	옥동제6투	3101	2643	458	11	2632	1580	1046	1	1	4	0
울산광역시	남구	야음장생포동	소계	11485	8433	3052	29	8404	5977	2392	2	1	11	21
울산광역시	남구	야음장생포동	야음장생포동제1투	3801	2639	1162	8	2631	1905	718	0	0	4	4
울산광역시	남구	야음장생포동	야음장생포동제2투	2821	2148	673	6	2142	1466	667	1	1	2	5
울산광역시	남구	야음장생포동	야음장생포동제3투	3609	2694	915	10	2684	1876	798	1	0	3	6
울산광역시	남구	야음장생포동	야음장생포동제4투	1254	952	302	5	947	730	209	0	0	2	6
울산광역시	남구	대현동	소계	23383	18698	4685	36	18662	11418	7166	2	8	30	38
울산광역시	남구	대현동	대현동제1투	4359	3362	997	5	3357	2124	1221	0	0	9	3
울산광역시	남구	대현동	대현동제2투	4070	3496	574	5	3491	2047	1428	0	2	8	6
울산광역시	남구	대현동	대현동제3투	4409	3600	809	4	3596	2133	1447	0	1	4	11
울산광역시	남구	대현동	대현동제4투	3830	3052	778	8	3044	1806	1229	0	0	3	6
울산광역시	남구	대현동	대현동제5투	4283	3357	926	5	3352	2057	1279	1	3	3	9
울산광역시	남구	대현동	대현동제6투	2432	1831	601	9	1822	1251	562	1	2	3	3
울산광역시	남구	수암동	소계	13135	10819	2316	30	10789	6469	4280	4	6	16	14
울산광역시	남구	수암동	수암동제1투	2925	2374	551	6	2368	1395	966	2	0	2	3
울산광역시	남구	수암동	수암동제2투	3279	2595	684	8	2587	1599	972	0	4	7	5
울산광역시	남구	수암동	수암동제3투	3882	3289	593	7	3282	1983	1294	1	0	0	4
울산광역시	남구	수암동	수암동제4투	3049	2561	488	9	2552	1492	1048	1	2	7	2
울산광역시	남구	선암동	소계	12884	10152	2732	25	10127	6303	3785	2	6	8	23
울산광역시	남구	선암동	선암동제1투	3004	2099	905	11	2088	1473	609	0	1	0	5
울산광역시	남구	선암동	선암동제2투	4266	3450	816	5	3445	1993	1436	1	5	3	7
울산광역시	남구	선암동	선암동제3투	2690	2221	469	7	2214	1415	791	0	0	3	5
울산광역시	남구	선암동	선암동제4투	2924	2382	542	2	2380	1422	949	1	0	2	6
울산광역시	동구	계	계	137363	107305	30058	398	106907	58969	47401	40	81	150	266
울산광역시	동구	재외투표	재외투표	450	305	145	2	303	123	179	0	0	0	1
울산광역시	동구	국내부재자투표	국내부재자투표	3764	3489	275	61	3428	1575	1811	8	5	8	21
울산광역시	동구	방어동	소계	31682	23512	8170	85	23427	13422	9909	11	11	26	48
울산광역시	동구	방어동	방어동제1투	4205	2969	1236	8	2961	1904	1047	2	1	3	4
울산광역시	동구	방어동	방어동제2투	4923	3557	1366	14	3543	2199	1324	2	6	3	9
울산광역시	동구	방어동	방어동제3투	3508	2547	961	8	2539	1472	1057	4	0	2	4
울산광역시	동구	방어동	방어동제4투	3508	2656	852	17	2639	1466	1165	3	0	2	3
울산광역시	동구	방어동	방어동제5투	3999	3091	908	15	3076	1724	1339	0	1	4	8
울산광역시	동구	방어동	방어동제6투	3960	3078	882	9	3069	1592	1462	0	1	4	10
울산광역시	동구	방어동	방어동제7투	3907	3026	881	12	3014	1615	1387	0	2	4	6
울산광역시	동구	방어동	방어동제8투	3672	2588	1084	2	2586	1450	1128	0	0	4	4
울산광역시	동구	일산동	소계	6470	4630	1840	16	4614	2926	1668	2	2	8	8
울산광역시	동구	일산동	일산동제1투	3208	2258	950	12	2246	1460	775	1	2	4	4
울산광역시	동구	일산동	일산동제2투	3262	2372	890	4	2368	1466	893	1	0	4	4
울산광역시	동구	화정동	소계	14529	10699	3830	34	10665	6335	4267	4	6	18	35
울산광역시	동구	화정동	화정동제1투	1812	1277	535	1	1276	828	443	0	0	0	5
울산광역시	동구	화정동	화정동제2투	3149	2226	923	8	2218	1447	759	2	0	2	8
울산광역시	동구	화정동	화정동제3투	3699	2804	895	9	2795	1470	1308	0	0	8	9
울산광역시	동구	화정동	화정동제4투	2532	1894	638	11	1883	1155	713	2	3	3	7
울산광역시	동구	화정동	화정동제5투	3337	2498	839	5	2493	1435	1044	0	3	5	6
울산광역시	동구	대송동	소계	11415	8936	2479	26	8910	4723	4145	2	8	15	17
울산광역시	동구	대송동	대송동제1투	2893	2303	590	12	2291	1224	1057	1	3	2	4
울산광역시	동구	대송동	대송동제2투	3010	2531	479	6	2525	1211	1302	0	2	5	5
울산광역시	동구	대송동	대송동제3투	2822	2089	733	3	2086	1113	959	1	2	5	6
울산광역시	동구	대송동	대송동제4투	2690	2013	677	5	2008	1175	827	0	1	3	2
울산광역시	동구	전하1동	소계	13636	10909	2727	29	10880	5897	4926	3	11	17	26
울산광역시	동구	전하1동	전하1동제1투	2500	1788	712	1	1787	1024	754	0	3	3	3
울산광역시	동구	전하1동	전하1동제2투	4227	3340	887	8	3332	1848	1468	2	3	2	9
울산광역시	동구	전하1동	전하1동제3투	3453	2798	655	13	2785	1482	1283	1	4	7	8
울산광역시	동구	전하1동	전하1동제4투	3456	2983	473	7	2976	1543	1421	0	1	5	6
울산광역시	동구	전하2동	소계	14755	11815	2940	34	11781	6508	5229	1	11	11	21
울산광역시	동구	전하2동	전하2동제1투	3264	2536	728	11	2525	1493	1025	1	1	2	3
울산광역시	동구	전하2동	전하2동제2투	3143	2355	788	9	2346	1342	994	0	0	4	6
울산광역시	동구	전하2동	전하2동제3투	2676	2092	584	5	2087	1235	844	0	2	1	5
울산광역시	동구	전하2동	전하2동제4투	3535	2995	540	7	2988	1579	1402	0	3	0	4
울산광역시	동구	전하2동	전하2동제5투	2137	1837	300	2	1835	859	964	0	5	4	3
울산광역시	동구	남목1동	소계	8910	6987	1923	19	6968	3917	3023	3	8	2	15
울산광역시	동구	남목1동	남목1동제1투	2611	1978	633	6	1972	1194	772	2	2	1	1
울산광역시	동구	남목1동	남목1동제2투	3712	2914	798	8	2906	1703	1189	1	1	0	12
울산광역시	동구	남목1동	남목1동제3투	2587	2095	492	5	2090	1020	1062	0	5	1	2
울산광역시	동구	남목2동	소계	20383	16740	3643	60	16680	8610	7974	3	13	30	50
울산광역시	동구	남목2동	남목2동제1투	3490	2712	778	6	2706	1460	1231	0	1	5	9
울산광역시	동구	남목2동	남목2동제2투	1971	1599	372	4	1595	842	741	1	1	3	7
울산광역시	동구	남목2동	남목2동제3투	3813	3057	756	13	3044	1474	1551	2	3	2	12
울산광역시	동구	남목2동	남목2동제4투	3920	3280	640	12	3268	1670	1577	0	5	7	9
울산광역시	동구	남목2동	남목2동제5투	2995	2441	554	11	2430	1334	1086	0	1	5	4
울산광역시	동구	남목2동	남목2동제6투	4194	3651	543	14	3637	1830	1788	0	2	8	9
울산광역시	동구	남목3동	소계	11369	9283	2086	32	9251	4933	4270	3	6	15	24
울산광역시	동구	남목3동	남목3동제1투	3677	3010	667	10	3000	1543	1440	1	2	6	8
울산광역시	동구	남목3동	남목3동제2투	3424	2754	670	11	2743	1522	1209	1	3	3	5
울산광역시	동구	남목3동	남목3동제3투	3583	2962	621	11	2951	1423	1511	1	1	6	9
울산광역시	동구	남목3동	남목3동제4투	685	557	128	0	557	445	110	0	0	0	2
울산광역시	북구	계	계	134522	107875	26647	350	107525	57809	49202	28	119	148	219
울산광역시	북구	재외투표	재외투표	399	262	137	2	260	103	156	0	1	0	0
울산광역시	북구	국내부재자투표	국내부재자투표	4019	3753	266	63	3690	1747	1898	5	7	8	25
울산광역시	북구	농소1동	소계	20778	16376	4402	55	16321	9405	6837	5	22	20	32
울산광역시	북구	농소1동	농소1동제1투	2843	2119	724	13	2106	1458	632	2	3	4	7
울산광역시	북구	농소1동	농소1동제2투	5112	3720	1392	11	3709	2275	1415	2	8	4	5
울산광역시	북구	농소1동	농소1동제3투	4670	3859	811	12	3847	2070	1763	1	1	7	5
울산광역시	북구	농소1동	농소1동제4투	1912	1514	398	6	1508	931	569	0	4	0	4
울산광역시	북구	농소1동	농소1동제5투	1682	1313	369	1	1312	730	574	0	2	2	4
울산광역시	북구	농소1동	농소1동제6투	2777	2342	435	4	2338	1214	1116	0	2	2	4
울산광역시	북구	농소1동	농소1동제7투	1782	1509	273	8	1501	727	768	0	2	1	3
울산광역시	북구	농소2동	소계	23036	18168	4868	40	18128	10207	7843	4	16	24	34
울산광역시	북구	농소2동	농소2동제1투	3006	2312	694	2	2310	1231	1069	1	2	5	2
울산광역시	북구	농소2동	농소2동제2투	2487	1928	559	4	1924	1201	712	1	1	3	6
울산광역시	북구	농소2동	농소2동제3투	3786	2962	824	10	2952	1770	1171	0	1	4	6
울산광역시	북구	농소2동	농소2동제4투	3008	2278	730	8	2270	1431	827	2	1	3	6
울산광역시	북구	농소2동	농소2동제5투	2930	2225	705	6	2219	1191	1014	0	6	4	4
울산광역시	북구	농소2동	농소2동제6투	3559	2871	688	5	2866	1622	1233	0	4	5	2
울산광역시	북구	농소2동	농소2동제7투	4260	3592	668	5	3587	1761	1817	0	1	0	8
울산광역시	북구	농소3동	소계	26984	21973	5011	42	21931	11310	10533	4	16	36	32
울산광역시	북구	농소3동	농소3동제1투	3479	2748	731	6	2742	1575	1155	1	1	4	6
울산광역시	북구	농소3동	농소3동제2투	4080	3321	759	5	3316	1740	1558	0	6	5	7
울산광역시	북구	농소3동	농소3동제3투	4396	3714	682	13	3701	1829	1862	1	4	3	2
울산광역시	북구	농소3동	농소3동제4투	4453	3528	925	8	3520	1810	1698	0	3	4	5
울산광역시	북구	농소3동	농소3동제5투	2232	1676	556	2	1674	952	716	0	0	3	3
울산광역시	북구	농소3동	농소3동제6투	3871	3251	620	1	3250	1528	1707	1	1	7	6
울산광역시	북구	농소3동	농소3동제7투	4473	3735	738	7	3728	1876	1837	1	1	10	3
울산광역시	북구	강동동	소계	3928	2889	1039	15	2874	2187	662	2	2	4	17
울산광역시	북구	강동동	강동동제1투	883	563	320	2	561	429	129	0	0	1	2
울산광역시	북구	강동동	강동동제2투	1724	1273	451	5	1268	931	324	0	2	2	9
울산광역시	북구	강동동	강동동제3투	743	593	150	3	590	478	106	1	0	1	4
울산광역시	북구	강동동	강동동제4투	578	460	118	5	455	349	103	1	0	0	2
울산광역시	북구	효문동	소계	21324	17028	4296	47	16981	9095	7824	2	23	18	19
울산광역시	북구	효문동	효문동제1투	2781	1995	786	4	1991	1201	778	0	3	3	6
울산광역시	북구	효문동	효문동제2투	1110	821	289	3	818	596	217	1	0	0	4
울산광역시	북구	효문동	효문동제3투	2670	2268	402	7	2261	1156	1100	1	3	1	0
울산광역시	북구	효문동	효문동제4투	4328	3498	830	12	3486	1872	1601	0	8	2	3
울산광역시	북구	효문동	효문동제5투	2984	2331	653	4	2327	1160	1158	0	3	5	1
울산광역시	북구	효문동	효문동제6투	3674	3039	635	6	3033	1462	1564	0	2	3	2
울산광역시	북구	효문동	효문동제7투	3777	3076	701	11	3065	1648	1406	0	4	4	3
울산광역시	북구	송정동	소계	14347	11816	2531	32	11784	6200	5538	2	5	18	21
울산광역시	북구	송정동	송정동제1투	3026	2520	506	5	2515	1396	1110	0	0	4	5
울산광역시	북구	송정동	송정동제2투	1933	1674	259	3	1671	756	906	1	1	6	1
울산광역시	북구	송정동	송정동제3투	3015	2485	530	8	2477	1342	1125	0	3	2	5
울산광역시	북구	송정동	송정동제4투	3649	3036	613	8	3028	1480	1537	1	1	2	7
울산광역시	북구	송정동	송정동제5투	2724	2101	623	8	2093	1226	860	0	0	4	3
울산광역시	북구	양정동	소계	9542	7608	1934	21	7587	3510	4036	1	13	10	17
울산광역시	북구	양정동	양정동제1투	3510	3047	463	6	3041	1380	1647	1	2	3	8
울산광역시	북구	양정동	양정동제2투	2397	1764	633	2	1762	883	874	0	2	0	3
울산광역시	북구	양정동	양정동제3투	3635	2797	838	13	2784	1247	1515	0	9	7	6
울산광역시	북구	염포동	소계	10165	8002	2163	33	7969	4045	3875	3	14	10	22
울산광역시	북구	염포동	염포동제1투	1522	1144	378	5	1139	595	534	0	4	1	5
울산광역시	북구	염포동	염포동제2투	1840	1359	481	5	1354	689	655	0	5	1	4
울산광역시	북구	염포동	염포동제3투	4354	3769	585	13	3756	1765	1968	1	4	7	11
울산광역시	북구	염포동	염포동제4투	2449	1730	719	10	1720	996	718	2	1	1	2
울산광역시	울주군	계	계	159736	123701	36035	633	123068	77446	45008	49	72	161	332
울산광역시	울주군	재외투표	재외투표	741	495	246	1	494	272	217	2	0	1	2
울산광역시	울주군	국내부재자투표	국내부재자투표	4613	4247	366	136	4111	2097	1952	13	8	10	31
울산광역시	울주군	온산읍	소계	18719	13245	5474	63	13182	8425	4715	5	2	10	25
울산광역시	울주군	온산읍	온산읍제1투	3161	1970	1191	5	1965	1412	547	0	0	2	4
울산광역시	울주군	온산읍	온산읍제2투	2530	1916	614	9	1907	1091	808	0	1	2	5
울산광역시	울주군	온산읍	온산읍제3투	2716	1847	869	8	1839	1213	619	0	1	2	4
울산광역시	울주군	온산읍	온산읍제4투	3607	2529	1078	14	2515	1585	925	1	0	1	3
울산광역시	울주군	온산읍	온산읍제5투	2564	1805	759	9	1796	1109	682	1	0	1	3
울산광역시	울주군	온산읍	온산읍제6투	3168	2456	712	14	2442	1486	949	3	0	0	4
울산광역시	울주군	온산읍	온산읍제7투	973	722	251	4	718	529	185	0	0	2	2
울산광역시	울주군	언양읍	소계	19988	15269	4719	74	15195	10036	5088	4	7	22	38
울산광역시	울주군	언양읍	언양읍제1투	3183	2395	788	10	2385	1663	717	1	0	2	2
울산광역시	울주군	언양읍	언양읍제2투	4438	3451	987	14	3437	2116	1299	1	2	8	11
울산광역시	울주군	언양읍	언양읍제3투	4621	3383	1238	22	3361	2418	929	2	1	3	8
울산광역시	울주군	언양읍	언양읍제4투	4059	3129	930	13	3116	1936	1168	0	2	5	5
울산광역시	울주군	언양읍	언양읍제5투	1568	1184	384	8	1176	909	256	0	1	2	8
울산광역시	울주군	언양읍	언양읍제6투	2119	1727	392	7	1720	994	719	0	1	2	4
울산광역시	울주군	온양읍	소계	17747	13542	4205	42	13500	8534	4908	6	9	14	29
울산광역시	울주군	온양읍	온양읍제1투	2462	1829	633	16	1813	1362	435	2	2	3	9
울산광역시	울주군	온양읍	온양읍제2투	1926	1383	543	3	1380	911	462	1	1	2	3
울산광역시	울주군	온양읍	온양읍제3투	2811	2029	782	6	2023	1370	643	1	2	1	6
울산광역시	울주군	온양읍	온양읍제4투	2183	1765	418	5	1760	1058	696	1	1	2	2
울산광역시	울주군	온양읍	온양읍제5투	2337	1856	481	5	1851	1118	728	1	1	1	2
울산광역시	울주군	온양읍	온양읍제6투	3543	2689	854	6	2683	1492	1185	0	1	2	3
울산광역시	울주군	온양읍	온양읍제7투	2485	1991	494	1	1990	1223	759	0	1	3	4
울산광역시	울주군	범서읍	소계	44868	36977	7891	82	36895	20427	16333	5	19	51	60
울산광역시	울주군	범서읍	범서읍제1투	4535	3744	791	8	3736	1982	1740	2	2	3	7
울산광역시	울주군	범서읍	범서읍제2투	2877	2260	617	4	2256	1369	871	0	2	4	10
울산광역시	울주군	범서읍	범서읍제3투	1717	1386	331	7	1379	1013	357	0	1	2	6
울산광역시	울주군	범서읍	범서읍제4투	3812	3102	710	8	3094	1744	1334	1	4	7	4
울산광역시	울주군	범서읍	범서읍제5투	2690	2134	556	6	2128	1197	925	0	0	3	3
울산광역시	울주군	범서읍	범서읍제6투	2559	2138	421	2	2136	1179	950	0	3	2	2
울산광역시	울주군	범서읍	범서읍제7투	3090	2543	547	5	2538	1531	992	0	1	9	5
울산광역시	울주군	범서읍	범서읍제8투	3885	3176	709	6	3170	1699	1459	0	0	6	6
울산광역시	울주군	범서읍	범서읍제9투	3648	2977	671	10	2967	1693	1264	0	2	4	4
울산광역시	울주군	범서읍	범서읍제10투	3924	3205	719	7	3198	1767	1423	0	1	2	5
울산광역시	울주군	범서읍	범서읍제11투	3735	3180	555	5	3175	1498	1670	0	1	4	2
울산광역시	울주군	범서읍	범서읍제12투	4452	3795	657	8	3787	1850	1931	0	0	2	4
울산광역시	울주군	범서읍	범서읍제13투	3944	3337	607	6	3331	1905	1417	2	2	3	2
울산광역시	울주군	서생면	소계	6891	5061	1830	23	5038	3780	1231	4	3	10	10
울산광역시	울주군	서생면	서생면제1투	2598	1889	709	6	1883	1486	382	2	2	7	4
울산광역시	울주군	서생면	서생면제2투	1501	1122	379	6	1116	822	287	2	0	2	3
울산광역시	울주군	서생면	서생면제3투	2792	2050	742	11	2039	1472	562	0	1	1	3
울산광역시	울주군	청량면	소계	10973	8532	2441	27	8505	5533	2936	1	3	7	25
울산광역시	울주군	청량면	청량면제1투	1753	1205	548	1	1204	879	320	1	1	0	3
울산광역시	울주군	청량면	청량면제2투	2898	2298	600	16	2282	1539	728	0	1	2	12
울산광역시	울주군	청량면	청량면제3투	1110	897	213	4	893	656	236	0	1	0	0
울산광역시	울주군	청량면	청량면제4투	3756	3080	676	3	3077	1695	1371	0	0	5	6
울산광역시	울주군	청량면	청량면제5투	1456	1052	404	3	1049	764	281	0	0	0	4
울산광역시	울주군	웅촌면	소계	7234	5467	1767	37	5430	3720	1681	2	5	3	19
울산광역시	울주군	웅촌면	웅촌면제1투	2648	1937	711	18	1919	1409	502	1	0	0	7
울산광역시	울주군	웅촌면	웅촌면제2투	1747	1331	416	13	1318	919	392	1	1	2	3
울산광역시	울주군	웅촌면	웅촌면제3투	2839	2199	640	6	2193	1392	787	0	4	1	9
울산광역시	울주군	두동면	소계	3389	2461	928	45	2416	1799	578	3	2	5	29
울산광역시	울주군	두동면	두동면제1투	2275	1642	633	33	1609	1157	426	0	2	5	19
울산광역시	울주군	두동면	두동면제2투	1114	819	295	12	807	642	152	3	0	0	10
울산광역시	울주군	두서면	소계	2853	2220	633	28	2192	1641	531	0	1	3	16
울산광역시	울주군	두서면	두서면제1투	2135	1658	477	23	1635	1196	427	0	1	1	10
울산광역시	울주군	두서면	두서면제2투	718	562	156	5	557	445	104	0	0	2	6
울산광역시	울주군	상북면	소계	7200	5280	1920	35	5245	3763	1454	1	2	8	17
울산광역시	울주군	상북면	상북면제1투	2948	2178	770	9	2169	1485	675	1	0	3	5
울산광역시	울주군	상북면	상북면제2투	1529	1114	415	20	1094	806	282	0	0	1	5
울산광역시	울주군	상북면	상북면제3투	2723	1988	735	6	1982	1472	497	0	2	4	7
울산광역시	울주군	삼남면	소계	12831	9590	3241	30	9560	6516	2997	3	7	16	21
울산광역시	울주군	삼남면	삼남면제1투	3472	2636	836	11	2625	1903	703	2	2	6	9
울산광역시	울주군	삼남면	삼남면제2투	2099	1562	537	4	1558	1054	495	1	2	1	5
울산광역시	울주군	삼남면	삼남면제3투	4855	3643	1212	9	3634	2373	1248	0	2	6	5
울산광역시	울주군	삼남면	삼남면제4투	2405	1749	656	6	1743	1186	551	0	1	3	2
울산광역시	울주군	삼동면	소계	1689	1315	374	10	1305	903	387	0	4	1	10
울산광역시	울주군	삼동면	삼동면제1투	956	741	215	6	735	504	225	0	1	0	5
울산광역시	울주군	삼동면	삼동면제2투	733	574	159	4	570	399	162	0	3	1	5
세종특별자치시	세종특별자치시	계	계	87707	64990	22717	293	64697	33587	30787	31	38	99	155
세종특별자치시	세종특별자치시	재외투표	재외투표	356	259	97	0	259	116	141	0	0	0	2
세종특별자치시	세종특별자치시	국내부재자투표	국내부재자투표	2878	2612	266	89	2523	1136	1335	11	10	18	13
세종특별자치시	세종특별자치시	조치원읍	소계	32472	23706	8766	52	23654	11957	11629	5	10	25	28
세종특별자치시	세종특별자치시	조치원읍	조치원읍제1투	2538	1721	817	3	1718	980	735	0	0	2	1
세종특별자치시	세종특별자치시	조치원읍	조치원읍제2투	995	703	292	3	700	456	242	0	2	0	0
세종특별자치시	세종특별자치시	조치원읍	조치원읍제3투	4329	3244	1085	7	3237	1621	1603	1	2	3	7
세종특별자치시	세종특별자치시	조치원읍	조치원읍제4투	2322	1534	788	6	1528	725	798	0	0	2	3
세종특별자치시	세종특별자치시	조치원읍	조치원읍제5투	1691	1231	460	5	1226	711	514	0	1	0	0
세종특별자치시	세종특별자치시	조치원읍	조치원읍제6투	3207	2261	946	7	2254	1310	938	0	1	1	4
세종특별자치시	세종특별자치시	조치원읍	조치원읍제7투	5067	3724	1343	4	3720	1850	1860	0	1	3	6
세종특별자치시	세종특별자치시	조치원읍	조치원읍제8투	3309	2432	877	6	2426	1251	1168	2	0	2	3
세종특별자치시	세종특별자치시	조치원읍	조치원읍제9투	1911	1315	596	4	1311	692	613	0	0	4	2
세종특별자치시	세종특별자치시	조치원읍	조치원읍제10투	1277	884	393	4	880	462	414	0	0	2	2
세종특별자치시	세종특별자치시	조치원읍	조치원읍제11투	3137	2506	631	2	2504	1082	1418	1	2	1	0
세종특별자치시	세종특별자치시	조치원읍	조치원읍제12투	2689	2151	538	1	2150	817	1326	1	1	5	0
세종특별자치시	세종특별자치시	연기면	소계	2705	1890	815	7	1883	1117	752	2	1	3	8
세종특별자치시	세종특별자치시	연기면	연기면제1투	2233	1552	681	5	1547	909	631	1	0	1	5
세종특별자치시	세종특별자치시	연기면	연기면제2투	472	338	134	2	336	208	121	1	1	2	3
세종특별자치시	세종특별자치시	연동면	소계	3381	2392	989	13	2379	1409	960	1	0	4	5
세종특별자치시	세종특별자치시	연동면	연동면제1투	1772	1254	518	8	1246	735	506	0	0	3	2
세종특별자치시	세종특별자치시	연동면	연동면제2투	1609	1138	471	5	1133	674	454	1	0	1	3
세종특별자치시	세종특별자치시	부강면	소계	5312	3971	1341	16	3955	2329	1608	1	5	5	7
세종특별자치시	세종특별자치시	부강면	부강면제1투	3487	2581	906	5	2576	1496	1074	0	2	3	1
세종특별자치시	세종특별자치시	부강면	부강면제2투	1825	1390	435	11	1379	833	534	1	3	2	6
세종특별자치시	세종특별자치시	금남면	소계	8664	6346	2318	32	6314	3674	2596	1	2	10	31
세종특별자치시	세종특별자치시	금남면	금남면제1투	4155	3085	1070	16	3069	1745	1309	0	0	4	11
세종특별자치시	세종특별자치시	금남면	금남면제2투	1621	1144	477	6	1138	688	439	1	2	3	5
세종특별자치시	세종특별자치시	금남면	금남면제3투	1710	1268	442	3	1265	743	510	0	0	1	11
세종특별자치시	세종특별자치시	금남면	금남면제4투	1178	849	329	7	842	498	338	0	0	2	4
세종특별자치시	세종특별자치시	장군면	소계	4087	3020	1067	12	3008	1768	1213	1	1	8	17
세종특별자치시	세종특별자치시	장군면	장군면제1투	2065	1509	556	7	1502	872	621	1	0	3	5
세종특별자치시	세종특별자치시	장군면	장군면제2투	1404	1032	372	4	1028	617	402	0	1	4	4
세종특별자치시	세종특별자치시	장군면	장군면제3투	618	479	139	1	478	279	190	0	0	1	8
세종특별자치시	세종특별자치시	연서면	소계	6396	4732	1664	22	4710	2537	2155	1	2	4	11
세종특별자치시	세종특별자치시	연서면	연서면제1투	1392	1049	343	3	1046	610	433	1	1	0	1
세종특별자치시	세종특별자치시	연서면	연서면제2투	702	527	175	3	524	267	253	0	0	0	4
세종특별자치시	세종특별자치시	연서면	연서면제3투	943	698	245	5	693	401	290	0	0	1	1
세종특별자치시	세종특별자치시	연서면	연서면제4투	3359	2458	901	11	2447	1259	1179	0	1	3	5
세종특별자치시	세종특별자치시	전의면	소계	5605	3929	1676	15	3914	2443	1449	2	1	6	13
세종특별자치시	세종특별자치시	전의면	전의면제1투	2354	1538	816	5	1533	951	576	1	1	1	3
세종특별자치시	세종특별자치시	전의면	전의면제2투	2418	1755	663	7	1748	1100	640	0	0	3	5
세종특별자치시	세종특별자치시	전의면	전의면제3투	833	636	197	3	633	392	233	1	0	2	5
세종특별자치시	세종특별자치시	전동면	소계	3345	2287	1058	9	2278	1406	849	4	1	6	12
세종특별자치시	세종특별자치시	전동면	전동면제1투	1787	1281	506	2	1279	797	470	2	1	4	5
세종특별자치시	세종특별자치시	전동면	전동면제2투	565	433	132	6	427	253	170	1	0	1	2
세종특별자치시	세종특별자치시	전동면	전동면제3투	993	573	420	1	572	356	209	1	0	1	5
세종특별자치시	세종특별자치시	소정면	소계	2349	1732	617	14	1718	1144	569	0	1	0	4
세종특별자치시	세종특별자치시	소정면	소정면투표소	2349	1732	617	14	1718	1144	569	0	1	0	4
세종특별자치시	세종특별자치시	한솔동	소계	10157	8114	2043	12	8102	2551	5531	2	4	10	4
세종특별자치시	세종특별자치시	한솔동	한솔동제1투	3886	3114	772	5	3109	1006	2093	1	2	5	2
세종특별자치시	세종특별자치시	한솔동	한솔동제2투	6271	5000	1271	7	4993	1545	3438	1	2	5	2
경기도	수원시장안구	계	계	225754	175095	50659	503	174592	85548	88360	45	96	375	168
경기도	수원시장안구	재외투표	재외투표	1177	844	333	3	841	305	532	1	1	2	0
경기도	수원시장안구	국내부재자투표	국내부재자투표	5368	5084	284	82	5002	2431	2519	6	9	13	24
경기도	수원시장안구	파장동	소계	17801	13047	4754	56	12991	6687	6257	4	9	20	14
경기도	수원시장안구	파장동	파장동제1투	2455	1590	865	4	1586	840	744	0	0	2	0
경기도	수원시장안구	파장동	파장동제2투	3405	2494	911	11	2483	1254	1221	0	2	2	4
경기도	수원시장안구	파장동	파장동제3투	3473	2483	990	7	2476	1282	1187	0	0	5	2
경기도	수원시장안구	파장동	파장동제4투	3169	2388	781	2	2386	1189	1193	0	2	2	0
경기도	수원시장안구	파장동	파장동제5투	3217	2433	784	9	2424	1284	1127	1	2	4	6
경기도	수원시장안구	파장동	파장동제6투	2082	1659	423	23	1636	838	785	3	3	5	2
경기도	수원시장안구	율천동	소계	34250	27518	6732	69	27449	11523	15813	6	20	63	24
경기도	수원시장안구	율천동	율천동제1투	4094	3221	873	5	3216	1327	1875	0	3	7	4
경기도	수원시장안구	율천동	율천동제2투	3849	2775	1074	8	2767	1195	1561	0	1	9	1
경기도	수원시장안구	율천동	율천동제3투	2695	2277	418	2	2275	914	1352	0	1	6	2
경기도	수원시장안구	율천동	율천동제4투	3632	3024	608	5	3019	1226	1775	1	4	10	3
경기도	수원시장안구	율천동	율천동제5투	4341	3623	718	7	3616	1610	1985	0	4	13	4
경기도	수원시장안구	율천동	율천동제6투	3463	2668	795	4	2664	1114	1534	3	3	8	2
경기도	수원시장안구	율천동	율천동제7투	4868	3857	1011	9	3848	1655	2184	2	1	4	2
경기도	수원시장안구	율천동	율천동제8투	2592	2118	474	21	2097	656	1431	0	3	2	5
경기도	수원시장안구	율천동	율천동제9투	4716	3955	761	8	3947	1826	2116	0	0	4	1
경기도	수원시장안구	정자1동	소계	18477	14067	4410	33	14034	6881	7106	1	9	21	16
경기도	수원시장안구	정자1동	정자1동제1투	4340	3266	1074	8	3258	1611	1633	0	2	8	4
경기도	수원시장안구	정자1동	정자1동제2투	2204	1549	655	3	1546	784	759	0	1	2	0
경기도	수원시장안구	정자1동	정자1동제3투	4525	3527	998	7	3520	1632	1877	1	0	4	6
경기도	수원시장안구	정자1동	정자1동제4투	4935	3946	989	11	3935	1930	1990	0	5	4	6
경기도	수원시장안구	정자1동	정자1동제5투	2473	1779	694	4	1775	924	847	0	1	3	0
경기도	수원시장안구	정자2동	소계	25298	19670	5628	44	19626	9640	9906	6	10	49	15
경기도	수원시장안구	정자2동	정자2동제1투	3670	2530	1140	5	2525	1385	1124	1	1	8	6
경기도	수원시장안구	정자2동	정자2동제2투	4083	3322	761	7	3315	1755	1548	2	3	6	1
경기도	수원시장안구	정자2동	정자2동제3투	4235	3119	1116	2	3117	1620	1486	2	1	5	3
경기도	수원시장안구	정자2동	정자2동제4투	2801	2017	784	6	2011	1103	902	0	1	3	2
경기도	수원시장안구	정자2동	정자2동제5투	3485	2915	570	8	2907	1257	1633	1	4	11	1
경기도	수원시장안구	정자2동	정자2동제6투	4092	3307	785	6	3301	1488	1803	0	0	10	0
경기도	수원시장안구	정자2동	정자2동제7투	2932	2460	472	10	2450	1032	1410	0	0	6	2
경기도	수원시장안구	정자3동	소계	31600	26428	5172	55	26373	11388	14875	4	13	72	21
경기도	수원시장안구	정자3동	정자3동제1투	3333	2701	632	4	2697	1341	1342	0	3	7	4
경기도	수원시장안구	정자3동	정자3동제2투	3210	2725	485	6	2719	1367	1340	1	1	9	1
경기도	수원시장안구	정자3동	정자3동제3투	3822	3270	552	10	3260	1224	2024	0	0	11	1
경기도	수원시장안구	정자3동	정자3동제4투	3037	2610	427	2	2608	1075	1522	1	1	9	0
경기도	수원시장안구	정자3동	정자3동제5투	4593	3899	694	4	3895	1683	2200	1	1	8	2
경기도	수원시장안구	정자3동	정자3동제6투	4421	3820	601	9	3811	1788	2005	1	3	10	4
경기도	수원시장안구	정자3동	정자3동제7투	2674	2151	523	3	2148	818	1322	0	1	4	3
경기도	수원시장안구	정자3동	정자3동제8투	3920	3214	706	10	3204	1189	2003	0	1	6	5
경기도	수원시장안구	정자3동	정자3동제9투	2590	2038	552	7	2031	903	1117	0	2	8	1
경기도	수원시장안구	영화동	소계	18809	13146	5663	38	13108	7389	5679	3	3	22	12
경기도	수원시장안구	영화동	영화동제1투	4075	2670	1405	10	2660	1584	1069	2	0	2	3
경기도	수원시장안구	영화동	영화동제2투	3795	2644	1151	5	2639	1547	1087	0	0	4	1
경기도	수원시장안구	영화동	영화동제3투	4105	3014	1091	6	3008	1684	1309	1	0	8	6
경기도	수원시장안구	영화동	영화동제4투	3200	2302	898	9	2293	1216	1071	0	1	3	2
경기도	수원시장안구	영화동	영화동제5투	3634	2516	1118	8	2508	1358	1143	0	2	5	0
경기도	수원시장안구	송죽동	소계	15452	11431	4021	23	11408	5714	5655	2	6	24	7
경기도	수원시장안구	송죽동	송죽동제1투	3779	2811	968	5	2806	1403	1394	1	1	6	1
경기도	수원시장안구	송죽동	송죽동제2투	3534	2651	883	10	2641	1339	1290	0	2	8	2
경기도	수원시장안구	송죽동	송죽동제3투	4283	3188	1095	3	3185	1563	1613	1	2	3	3
경기도	수원시장안구	송죽동	송죽동제4투	3856	2781	1075	5	2776	1409	1358	0	1	7	1
경기도	수원시장안구	조원1동	소계	24906	18700	6206	42	18658	9773	8820	3	9	42	11
경기도	수원시장안구	조원1동	조원1동제1투	4697	3204	1493	8	3196	1657	1527	1	0	9	2
경기도	수원시장안구	조원1동	조원1동제2투	3374	2463	911	8	2455	1235	1210	0	1	6	3
경기도	수원시장안구	조원1동	조원1동제3투	3651	2662	989	8	2654	1391	1254	0	2	7	0
경기도	수원시장안구	조원1동	조원1동제4투	2929	2184	745	1	2183	1192	985	1	2	3	0
경기도	수원시장안구	조원1동	조원1동제5투	3995	3088	907	10	3078	1867	1199	0	0	7	5
경기도	수원시장안구	조원1동	조원1동제6투	2561	2046	515	3	2043	1017	1017	1	3	5	0
경기도	수원시장안구	조원1동	조원1동제7투	3699	3053	646	4	3049	1414	1628	0	1	5	1
경기도	수원시장안구	조원2동	소계	15003	12615	2388	30	12585	6583	5967	2	2	20	11
경기도	수원시장안구	조원2동	조원2동제1투	3926	3252	674	8	3244	1713	1521	1	0	6	3
경기도	수원시장안구	조원2동	조원2동제2투	3959	3343	616	8	3335	1787	1542	0	0	3	3
경기도	수원시장안구	조원2동	조원2동제3투	3620	3061	559	7	3054	1460	1583	1	2	5	3
경기도	수원시장안구	조원2동	조원2동제4투	3498	2959	539	7	2952	1623	1321	0	0	6	2
경기도	수원시장안구	연무동	소계	17613	12545	5068	28	12517	7234	5231	7	5	27	13
경기도	수원시장안구	연무동	연무동제1투	2089	1310	779	6	1304	819	478	2	1	2	2
경기도	수원시장안구	연무동	연무동제2투	2813	2037	776	1	2036	1128	900	0	0	6	2
경기도	수원시장안구	연무동	연무동제3투	4307	3102	1205	8	3094	1772	1308	1	1	6	6
경기도	수원시장안구	연무동	연무동제4투	485	399	86	2	397	284	108	1	1	3	0
경기도	수원시장안구	연무동	연무동제5투	3878	2805	1073	5	2800	1585	1208	1	1	4	1
경기도	수원시장안구	연무동	연무동제6투	4041	2892	1149	6	2886	1646	1229	2	1	6	2
경기도	수원시권선구	계	계	258753	192297	66456	584	191713	94970	96064	57	109	330	183
경기도	수원시권선구	재외투표	재외투표	1000	701	299	8	693	267	423	0	1	1	1
경기도	수원시권선구	국내부재자투표	국내부재자투표	5989	5657	332	107	5550	2672	2801	16	15	18	28
경기도	수원시권선구	세류1동	소계	3692	2404	1288	11	2393	1414	972	1	2	3	1
경기도	수원시권선구	세류1동	세류1동제1투	2657	1679	978	8	1671	979	687	0	2	2	1
경기도	수원시권선구	세류1동	세류1동제2투	1035	725	310	3	722	435	285	1	0	1	0
경기도	수원시권선구	세류2동	소계	22058	14606	7452	36	14570	7933	6600	0	3	21	13
경기도	수원시권선구	세류2동	세류2동제1투	4798	3087	1711	8	3079	1739	1332	0	2	4	2
경기도	수원시권선구	세류2동	세류2동제2투	3014	2065	949	5	2060	1111	941	0	1	6	1
경기도	수원시권선구	세류2동	세류2동제3투	3463	2248	1215	5	2243	1173	1070	0	0	0	0
경기도	수원시권선구	세류2동	세류2동제4투	3356	2129	1227	11	2118	1191	922	0	0	3	2
경기도	수원시권선구	세류2동	세류2동제5투	4571	3166	1405	4	3162	1650	1503	0	0	5	4
경기도	수원시권선구	세류2동	세류2동제6투	2856	1911	945	3	1908	1069	832	0	0	3	4
경기도	수원시권선구	세류3동	소계	20390	13697	6693	30	13667	7494	6136	4	6	16	11
경기도	수원시권선구	세류3동	세류3동제1투	3844	2513	1331	4	2509	1430	1069	3	1	4	2
경기도	수원시권선구	세류3동	세류3동제2투	4039	2736	1303	11	2725	1483	1237	1	1	1	2
경기도	수원시권선구	세류3동	세류3동제3투	4094	2857	1237	5	2852	1541	1307	0	1	1	2
경기도	수원시권선구	세류3동	세류3동제4투	4412	2822	1590	6	2816	1567	1237	0	1	7	4
경기도	수원시권선구	세류3동	세류3동제5투	4001	2769	1232	4	2765	1473	1286	0	2	3	1
경기도	수원시권선구	평동	소계	27966	20820	7146	54	20766	10878	9820	3	11	35	19
경기도	수원시권선구	평동	평동제1투	2501	1682	819	4	1678	986	683	2	1	5	1
경기도	수원시권선구	평동	평동제2투	3002	2137	865	3	2134	1221	909	0	1	1	2
경기도	수원시권선구	평동	평동제3투	4000	2923	1077	3	2920	1537	1373	0	1	6	3
경기도	수원시권선구	평동	평동제4투	3638	2779	859	5	2774	1319	1444	0	3	5	3
경기도	수원시권선구	평동	평동제5투	4202	3157	1045	18	3139	1667	1459	1	3	6	3
경기도	수원시권선구	평동	평동제6투	5307	3906	1401	16	3890	2027	1851	0	2	7	3
경기도	수원시권선구	평동	평동제7투	5316	4236	1080	5	4231	2121	2101	0	0	5	4
경기도	수원시권선구	서둔동	소계	33110	23896	9214	58	23838	11721	12016	10	18	53	20
경기도	수원시권선구	서둔동	서둔동제1투	2589	1920	669	3	1917	953	957	1	1	4	1
경기도	수원시권선구	서둔동	서둔동제2투	2639	2038	601	1	2037	957	1074	0	1	2	3
경기도	수원시권선구	서둔동	서둔동제3투	3983	2761	1222	10	2751	1510	1224	2	4	8	3
경기도	수원시권선구	서둔동	서둔동제4투	2759	1755	1004	1	1754	941	809	0	1	1	2
경기도	수원시권선구	서둔동	서둔동제5투	4274	3112	1162	3	3109	1553	1545	1	3	7	0
경기도	수원시권선구	서둔동	서둔동제6투	4364	3196	1168	21	3175	1556	1598	2	5	10	4
경기도	수원시권선구	서둔동	서둔동제7투	3205	2615	590	4	2611	1180	1414	2	2	9	4
경기도	수원시권선구	서둔동	서둔동제8투	4599	3303	1296	8	3295	1584	1700	2	1	7	1
경기도	수원시권선구	서둔동	서둔동제9투	4698	3196	1502	7	3189	1487	1695	0	0	5	2
경기도	수원시권선구	구운동	소계	21693	16308	5385	46	16262	8159	8049	2	7	35	10
경기도	수원시권선구	구운동	구운동제1투	6253	4196	2057	11	4185	2130	2044	0	1	7	3
경기도	수원시권선구	구운동	구운동제2투	4191	3406	785	11	3395	1621	1760	0	2	10	2
경기도	수원시권선구	구운동	구운동제3투	3231	2332	899	4	2328	1295	1023	1	1	4	4
경기도	수원시권선구	구운동	구운동제4투	3791	2768	1023	11	2757	1394	1355	1	3	4	0
경기도	수원시권선구	구운동	구운동제5투	4227	3606	621	9	3597	1719	1867	0	0	10	1
경기도	수원시권선구	금호동	소계	37960	29648	8312	72	29576	13867	15614	8	22	42	23
경기도	수원시권선구	금호동	금호동제1투	3468	2511	957	8	2503	1294	1200	1	2	4	2
경기도	수원시권선구	금호동	금호동제2투	2635	2066	569	5	2061	1020	1034	0	1	3	3
경기도	수원시권선구	금호동	금호동제3투	4300	3481	819	13	3468	1623	1833	1	1	5	5
경기도	수원시권선구	금호동	금호동제4투	4305	3450	855	5	3445	1701	1731	0	2	7	4
경기도	수원시권선구	금호동	금호동제5투	3739	3108	631	10	3098	1522	1566	2	1	6	1
경기도	수원시권선구	금호동	금호동제6투	3882	3217	665	7	3210	1491	1709	1	4	4	1
경기도	수원시권선구	금호동	금호동제7투	3218	2510	708	7	2503	1221	1280	0	0	0	2
경기도	수원시권선구	금호동	금호동제8투	3797	2776	1021	8	2768	1339	1417	0	2	5	5
경기도	수원시권선구	금호동	금호동제9투	4697	3503	1194	4	3499	1438	2051	2	7	1	0
경기도	수원시권선구	금호동	금호동제10투	3919	3026	893	5	3021	1218	1793	1	2	7	0
경기도	수원시권선구	권선1동	소계	20344	14348	5996	25	14323	7276	7014	1	3	16	13
경기도	수원시권선구	권선1동	권선1동제1투	3394	2611	783	4	2607	1415	1187	1	0	3	1
경기도	수원시권선구	권선1동	권선1동제2투	5020	3576	1444	5	3571	1732	1830	0	1	5	3
경기도	수원시권선구	권선1동	권선1동제3투	2997	1803	1194	5	1798	837	959	0	0	1	1
경기도	수원시권선구	권선1동	권선1동제4투	2987	1969	1018	6	1963	1127	832	0	0	1	3
경기도	수원시권선구	권선1동	권선1동제5투	2794	1842	952	2	1840	1009	823	0	2	1	5
경기도	수원시권선구	권선1동	권선1동제6투	3152	2547	605	3	2544	1156	1383	0	0	5	0
경기도	수원시권선구	권선2동	소계	30691	25015	5676	72	24943	12474	12384	5	7	51	22
경기도	수원시권선구	권선2동	권선2동제1투	3662	2951	711	8	2943	1627	1308	1	1	5	1
경기도	수원시권선구	권선2동	권선2동제2투	4206	3426	780	13	3413	1861	1538	0	2	7	5
경기도	수원시권선구	권선2동	권선2동제3투	2701	2152	549	6	2146	1058	1077	0	0	7	4
경기도	수원시권선구	권선2동	권선2동제4투	2848	2156	692	4	2152	1093	1052	1	2	2	2
경기도	수원시권선구	권선2동	권선2동제5투	3114	2575	539	12	2563	1190	1367	1	0	3	2
경기도	수원시권선구	권선2동	권선2동제6투	3867	3086	781	8	3078	1435	1631	2	1	7	2
경기도	수원시권선구	권선2동	권선2동제7투	4050	3405	645	6	3399	1590	1797	0	0	10	2
경기도	수원시권선구	권선2동	권선2동제8투	3273	2759	514	9	2750	1399	1342	0	1	5	3
경기도	수원시권선구	권선2동	권선2동제9투	2970	2505	465	6	2499	1221	1272	0	0	5	1
경기도	수원시권선구	곡선동	소계	23853	17023	6830	45	16978	7147	9774	4	9	26	18
경기도	수원시권선구	곡선동	곡선동제1투	2200	1715	485	5	1710	741	966	1	1	1	0
경기도	수원시권선구	곡선동	곡선동제2투	3523	2990	533	14	2976	1446	1521	0	1	7	1
경기도	수원시권선구	곡선동	곡선동제3투	4760	3349	1411	5	3344	1579	1743	2	4	11	5
경기도	수원시권선구	곡선동	곡선동제4투	3426	2833	593	5	2828	1077	1745	0	1	3	2
경기도	수원시권선구	곡선동	곡선동제5투	4498	2733	1765	7	2726	956	1762	1	2	3	2
경기도	수원시권선구	곡선동	곡선동제6투	5446	3403	2043	9	3394	1348	2037	0	0	1	8
경기도	수원시권선구	입북동	소계	10007	8174	1833	20	8154	3668	4461	3	5	13	4
경기도	수원시권선구	입북동	입북동제1투	3176	2608	568	5	2603	1190	1409	0	1	3	0
경기도	수원시권선구	입북동	입북동제2투	3690	3012	678	10	3002	1375	1616	1	3	5	2
경기도	수원시권선구	입북동	입북동제3투	3141	2554	587	5	2549	1103	1436	2	1	5	2
경기도	수원시팔달구	계	계	167784	121476	46308	355	121121	63522	57156	36	63	197	147
경기도	수원시팔달구	재외투표	재외투표	872	625	247	2	623	252	370	0	0	0	1
경기도	수원시팔달구	국내부재자투표	국내부재자투표	3465	3249	216	55	3194	1573	1587	5	6	6	17
경기도	수원시팔달구	행궁동	소계	10978	7433	3545	20	7413	4481	2918	1	1	7	5
경기도	수원시팔달구	행궁동	행궁동제1투	5120	3428	1692	12	3416	2050	1362	1	0	2	1
경기도	수원시팔달구	행궁동	행궁동제2투	3316	2283	1033	8	2275	1382	888	0	0	3	2
경기도	수원시팔달구	행궁동	행궁동제3투	2542	1722	820	0	1722	1049	668	0	1	2	2
경기도	수원시팔달구	매교동	소계	9606	6381	3225	22	6359	3766	2567	2	4	11	9
경기도	수원시팔달구	매교동	매교동제1투	4686	3045	1641	10	3035	1806	1214	1	1	6	7
경기도	수원시팔달구	매교동	매교동제2투	2831	1925	906	8	1917	1144	765	0	3	3	2
경기도	수원시팔달구	매교동	매교동제3투	2089	1411	678	4	1407	816	588	1	0	2	0
경기도	수원시팔달구	매산동	소계	10557	7347	3210	19	7328	3844	3453	0	6	10	15
경기도	수원시팔달구	매산동	매산동제1투	4549	2691	1858	4	2687	1334	1343	0	3	4	3
경기도	수원시팔달구	매산동	매산동제2투	3814	3142	672	9	3133	1735	1382	0	3	3	10
경기도	수원시팔달구	매산동	매산동제3투	2194	1514	680	6	1508	775	728	0	0	3	2
경기도	수원시팔달구	고등동	소계	10511	6766	3745	18	6748	3761	2957	4	7	14	5
경기도	수원시팔달구	고등동	고등동제1투	3729	2133	1596	6	2127	1134	987	0	1	4	1
경기도	수원시팔달구	고등동	고등동제2투	2818	1942	876	5	1937	1097	834	2	1	3	0
경기도	수원시팔달구	고등동	고등동제3투	3964	2691	1273	7	2684	1530	1136	2	5	7	4
경기도	수원시팔달구	화서1동	소계	20850	15343	5507	39	15304	7872	7390	2	4	26	10
경기도	수원시팔달구	화서1동	화서1동제1투	4414	3087	1327	7	3080	1648	1424	0	1	5	2
경기도	수원시팔달구	화서1동	화서1동제2투	3927	2805	1122	7	2798	1474	1318	0	1	2	3
경기도	수원시팔달구	화서1동	화서1동제3투	4315	3132	1183	9	3123	1691	1424	0	1	5	2
경기도	수원시팔달구	화서1동	화서1동제4투	3605	2533	1072	10	2523	1428	1087	1	0	5	2
경기도	수원시팔달구	화서1동	화서1동제5투	4589	3786	803	6	3780	1631	2137	1	1	9	1
경기도	수원시팔달구	화서2동	소계	21465	17630	3835	30	17600	8193	9341	4	13	32	17
경기도	수원시팔달구	화서2동	화서2동제1투	2819	2279	540	1	2278	1175	1092	1	3	4	3
경기도	수원시팔달구	화서2동	화서2동제2투	3511	2810	701	7	2803	1240	1554	1	0	4	4
경기도	수원시팔달구	화서2동	화서2동제3투	2940	2452	488	3	2449	1065	1375	0	2	3	4
경기도	수원시팔달구	화서2동	화서2동제4투	3703	2992	711	7	2985	1500	1475	0	3	5	2
경기도	수원시팔달구	화서2동	화서2동제5투	3832	3164	668	5	3159	1532	1619	1	2	4	1
경기도	수원시팔달구	화서2동	화서2동제6투	4660	3933	727	7	3926	1681	2226	1	3	12	3
경기도	수원시팔달구	지동	소계	13255	9091	4164	39	9052	5296	3726	2	3	13	12
경기도	수원시팔달구	지동	지동제1투	3755	2534	1221	7	2527	1388	1129	1	2	4	3
경기도	수원시팔달구	지동	지동제2투	3745	2575	1170	13	2562	1545	1009	1	0	5	2
경기도	수원시팔달구	지동	지동제3투	2840	1939	901	12	1927	1140	786	0	0	0	1
경기도	수원시팔달구	지동	지동제4투	2915	2043	872	7	2036	1223	802	0	1	4	6
경기도	수원시팔달구	우만1동	소계	19153	13512	5641	32	13480	6990	6438	5	6	19	22
경기도	수원시팔달구	우만1동	우만1동제1투	3973	2702	1271	7	2695	1375	1310	0	1	2	7
경기도	수원시팔달구	우만1동	우만1동제2투	4286	2973	1313	10	2963	1580	1373	0	2	5	3
경기도	수원시팔달구	우만1동	우만1동제3투	3400	2444	956	1	2443	1198	1233	1	2	5	4
경기도	수원시팔달구	우만1동	우만1동제4투	3378	2300	1078	7	2293	1182	1103	1	1	5	1
경기도	수원시팔달구	우만1동	우만1동제5투	1925	1387	538	6	1381	846	523	3	0	2	7
경기도	수원시팔달구	우만1동	우만1동제6투	2191	1706	485	1	1705	809	896	0	0	0	0
경기도	수원시팔달구	우만2동	소계	13802	11049	2753	31	11018	5330	5638	2	3	31	14
경기도	수원시팔달구	우만2동	우만2동제1투	3888	2900	988	7	2893	1307	1571	0	0	7	8
경기도	수원시팔달구	우만2동	우만2동제2투	3633	2917	716	9	2908	1316	1581	0	2	6	3
경기도	수원시팔달구	우만2동	우만2동제3투	3217	2678	539	10	2668	1448	1205	2	0	11	2
경기도	수원시팔달구	우만2동	우만2동제4투	3064	2554	510	5	2549	1259	1281	0	1	7	1
경기도	수원시팔달구	인계동	소계	33270	23050	10220	48	23002	12164	10771	9	10	28	20
경기도	수원시팔달구	인계동	인계동제1투	5384	3415	1969	11	3404	2035	1360	1	1	3	4
경기도	수원시팔달구	인계동	인계동제2투	4736	3169	1567	7	3162	1721	1437	1	0	1	2
경기도	수원시팔달구	인계동	인계동제3투	3626	2683	943	8	2675	1331	1340	0	1	2	1
경기도	수원시팔달구	인계동	인계동제4투	3510	2700	810	5	2695	1406	1275	2	1	8	3
경기도	수원시팔달구	인계동	인계동제5투	4461	3750	711	2	3748	1739	1997	2	0	6	4
경기도	수원시팔달구	인계동	인계동제6투	3289	2010	1279	4	2006	990	1008	0	3	4	1
경기도	수원시팔달구	인계동	인계동제7투	3934	2373	1561	4	2369	1272	1087	3	2	1	4
경기도	수원시팔달구	인계동	인계동제8투	4330	2950	1380	7	2943	1670	1267	0	2	3	1
경기도	수원시영통구	계	계	208298	165741	42557	408	165333	74873	89927	40	72	305	116
경기도	수원시영통구	재외투표	재외투표	1297	863	434	4	859	315	541	0	2	1	0
경기도	수원시영통구	국내부재자투표	국내부재자투표	5366	5019	347	78	4941	2377	2529	8	9	7	11
경기도	수원시영통구	매탄1동	소계	16091	12663	3428	33	12630	6143	6448	0	3	28	8
경기도	수원시영통구	매탄1동	매탄1동제1투	2415	1895	520	7	1888	871	1012	0	0	3	2
경기도	수원시영통구	매탄1동	매탄1동제2투	3026	2524	502	8	2516	1294	1212	0	0	9	1
경기도	수원시영통구	매탄1동	매탄1동제3투	2998	2495	503	3	2492	1289	1197	0	0	5	1
경기도	수원시영통구	매탄1동	매탄1동제4투	2514	2070	444	3	2067	943	1117	0	1	5	1
경기도	수원시영통구	매탄1동	매탄1동제5투	2517	1833	684	6	1827	869	953	0	0	3	2
경기도	수원시영통구	매탄1동	매탄1동제6투	2621	1846	775	6	1840	877	957	0	2	3	1
경기도	수원시영통구	매탄2동	소계	13404	10082	3322	15	10067	5104	4936	0	1	18	8
경기도	수원시영통구	매탄2동	매탄2동제1투	3903	2793	1110	5	2788	1447	1333	0	0	5	3
경기도	수원시영통구	매탄2동	매탄2동제2투	3828	2723	1105	6	2717	1459	1250	0	0	4	4
경기도	수원시영통구	매탄2동	매탄2동제3투	5673	4566	1107	4	4562	2198	2353	0	1	9	1
경기도	수원시영통구	매탄3동	소계	28054	22195	5859	49	22146	10210	11873	6	10	24	23
경기도	수원시영통구	매탄3동	매탄3동제1투	4973	4153	820	9	4144	1869	2266	2	0	5	2
경기도	수원시영통구	매탄3동	매탄3동제2투	4353	3303	1050	4	3299	1357	1930	1	1	3	7
경기도	수원시영통구	매탄3동	매탄3동제3투	3962	3213	749	12	3201	1488	1703	2	3	3	2
경기도	수원시영통구	매탄3동	매탄3동제4투	4462	3665	797	10	3655	1825	1823	0	1	3	3
경기도	수원시영통구	매탄3동	매탄3동제5투	4245	3251	994	2	3249	1588	1654	0	2	2	3
경기도	수원시영통구	매탄3동	매탄3동제6투	4029	3188	841	10	3178	1638	1526	0	2	6	6
경기도	수원시영통구	매탄3동	매탄3동제7투	2030	1422	608	2	1420	445	971	1	1	2	0
경기도	수원시영통구	매탄4동	소계	19006	14393	4613	41	14352	6797	7511	2	3	35	4
경기도	수원시영통구	매탄4동	매탄4동제1투	3860	2710	1150	9	2701	1280	1413	1	1	4	2
경기도	수원시영통구	매탄4동	매탄4동제2투	3705	2960	745	12	2948	1364	1576	0	0	8	0
경기도	수원시영통구	매탄4동	매탄4동제3투	3671	2652	1019	10	2642	1240	1391	0	0	10	1
경기도	수원시영통구	매탄4동	매탄4동제4투	3648	2836	812	2	2834	1253	1569	1	1	10	0
경기도	수원시영통구	매탄4동	매탄4동제5투	4122	3235	887	8	3227	1660	1562	0	1	3	1
경기도	수원시영통구	원천동	소계	31267	24348	6919	59	24289	10505	13710	5	13	41	15
경기도	수원시영통구	원천동	원천동제1투	4529	3696	833	9	3687	1494	2180	2	1	7	3
경기도	수원시영통구	원천동	원천동제2투	5233	3807	1426	13	3794	1645	2134	1	4	5	5
경기도	수원시영통구	원천동	원천동제3투	4851	3400	1451	7	3393	1342	2040	1	2	6	2
경기도	수원시영통구	원천동	원천동제4투	4662	3788	874	10	3778	1578	2192	1	4	3	0
경기도	수원시영통구	원천동	원천동제5투	3922	2943	979	6	2937	1407	1524	0	1	4	1
경기도	수원시영통구	원천동	원천동제6투	3701	3095	606	8	3087	1303	1776	0	1	7	0
경기도	수원시영통구	원천동	원천동제7투	1372	1117	255	2	1115	493	617	0	0	3	2
경기도	수원시영통구	원천동	원천동제8투	2997	2502	495	4	2498	1243	1247	0	0	6	2
경기도	수원시영통구	영통1동	소계	30430	24787	5643	44	24743	10396	14273	7	10	43	14
경기도	수원시영통구	영통1동	영통1동제1투	4035	3318	717	3	3315	1302	2002	3	1	5	2
경기도	수원시영통구	영통1동	영통1동제2투	4991	4076	915	7	4069	1496	2551	2	3	11	6
경기도	수원시영통구	영통1동	영통1동제3투	3876	3237	639	7	3230	1362	1855	1	2	9	1
경기도	수원시영통구	영통1동	영통1동제4투	4225	3602	623	9	3593	1643	1940	0	0	9	1
경기도	수원시영통구	영통1동	영통1동제5투	4277	3028	1249	6	3022	1204	1813	0	0	3	2
경기도	수원시영통구	영통1동	영통1동제6투	5021	4154	867	7	4147	2001	2137	1	3	4	1
경기도	수원시영통구	영통1동	영통1동제7투	4005	3372	633	5	3367	1388	1975	0	1	2	1
경기도	수원시영통구	영통2동	소계	33339	27580	5759	45	27535	11752	15693	5	12	56	17
경기도	수원시영통구	영통2동	영통2동제1투	3864	3144	720	1	3143	1111	2019	1	3	7	2
경기도	수원시영통구	영통2동	영통2동제2투	4335	3609	726	5	3604	1339	2260	1	0	4	0
경기도	수원시영통구	영통2동	영통2동제3투	4599	3732	867	5	3727	1292	2425	1	1	4	4
경기도	수원시영통구	영통2동	영통2동제4투	3247	2731	516	8	2723	1327	1384	1	2	7	2
경기도	수원시영통구	영통2동	영통2동제5투	3530	3028	502	6	3022	1489	1518	0	1	11	3
경기도	수원시영통구	영통2동	영통2동제6투	2956	2389	567	5	2384	854	1526	0	0	4	0
경기도	수원시영통구	영통2동	영통2동제7투	3642	3008	634	10	2998	1167	1821	1	2	4	3
경기도	수원시영통구	영통2동	영통2동제8투	4924	4116	808	4	4112	2388	1711	0	1	10	2
경기도	수원시영통구	영통2동	영통2동제9투	2242	1823	419	1	1822	785	1029	0	2	5	1
경기도	수원시영통구	태장동	소계	30044	23811	6233	40	23771	11274	12413	7	9	52	16
경기도	수원시영통구	태장동	태장동제1투	4413	3470	943	5	3465	1689	1763	0	2	9	2
경기도	수원시영통구	태장동	태장동제2투	3871	3040	831	4	3036	1380	1648	0	2	4	2
경기도	수원시영통구	태장동	태장동제3투	4587	3792	795	7	3785	2013	1756	2	2	11	1
경기도	수원시영통구	태장동	태장동제4투	3378	2700	678	2	2698	1282	1405	1	1	6	3
경기도	수원시영통구	태장동	태장동제5투	2286	1882	404	2	1880	723	1150	0	1	3	3
경기도	수원시영통구	태장동	태장동제6투	5228	3961	1267	7	3954	1839	2105	0	1	7	2
경기도	수원시영통구	태장동	태장동제7투	2897	2342	555	6	2336	987	1336	3	0	8	2
경기도	수원시영통구	태장동	태장동제8투	3384	2624	760	7	2617	1361	1250	1	0	4	1
경기도	성남시수정구	계	계	193613	138079	55534	438	137641	62526	74640	44	68	235	128
경기도	성남시수정구	재외투표	재외투표	803	571	232	1	570	225	344	0	1	0	0
경기도	성남시수정구	국내부재자투표	국내부재자투표	3843	3610	233	65	3545	1629	1883	6	6	11	10
경기도	성남시수정구	신흥1동	소계	13412	8671	4741	22	8649	3982	4645	5	1	11	5
경기도	성남시수정구	신흥1동	신흥1동제1투	3898	2357	1541	4	2353	1082	1264	1	1	3	2
경기도	성남시수정구	신흥1동	신흥1동제2투	3238	2101	1137	4	2097	935	1159	0	0	2	1
경기도	성남시수정구	신흥1동	신흥1동제3투	2998	1985	1013	7	1978	895	1078	2	0	3	0
경기도	성남시수정구	신흥1동	신흥1동제4투	3278	2228	1050	7	2221	1070	1144	2	0	3	2
경기도	성남시수정구	신흥2동	소계	24115	17665	6450	43	17622	7979	9573	4	8	38	20
경기도	성남시수정구	신흥2동	신흥2동제1투	2928	1886	1042	3	1883	892	984	2	0	2	3
경기도	성남시수정구	신흥2동	신흥2동제2투	5158	4098	1060	7	4091	1926	2153	0	1	9	2
경기도	성남시수정구	신흥2동	신흥2동제3투	4598	3189	1409	6	3183	1391	1775	2	3	9	3
경기도	성남시수정구	신흥2동	신흥2동제4투	4260	2762	1498	9	2753	1252	1492	0	2	4	3
경기도	성남시수정구	신흥2동	신흥2동제5투	2094	1532	562	5	1527	678	840	0	0	3	6
경기도	성남시수정구	신흥2동	신흥2동제6투	5077	4198	879	13	4185	1840	2329	0	2	11	3
경기도	성남시수정구	신흥3동	소계	10137	6630	3507	21	6609	3201	3393	2	3	7	3
경기도	성남시수정구	신흥3동	신흥3동제1투	3210	2059	1151	6	2053	1017	1035	0	0	0	1
경기도	성남시수정구	신흥3동	신흥3동제2투	3201	2107	1094	7	2100	994	1098	2	0	4	2
경기도	성남시수정구	신흥3동	신흥3동제3투	3726	2464	1262	8	2456	1190	1260	0	3	3	0
경기도	성남시수정구	태평1동	소계	15757	10975	4782	19	10956	4883	6043	0	6	13	11
경기도	성남시수정구	태평1동	태평1동제1투	4788	3324	1464	3	3321	1465	1850	0	1	1	4
경기도	성남시수정구	태평1동	태평1동제2투	3788	2643	1145	8	2635	1215	1411	0	2	5	2
경기도	성남시수정구	태평1동	태평1동제3투	3818	2604	1214	2	2602	1163	1432	0	1	3	3
경기도	성남시수정구	태평1동	태평1동제4투	3363	2404	959	6	2398	1040	1350	0	2	4	2
경기도	성남시수정구	태평2동	소계	15970	11095	4875	37	11058	5018	6007	3	5	12	13
경기도	성남시수정구	태평2동	태평2동제1투	3519	2278	1241	6	2272	951	1316	1	0	4	0
경기도	성남시수정구	태평2동	태평2동제2투	3868	2810	1058	11	2799	1264	1529	0	2	1	3
경기도	성남시수정구	태평2동	태평2동제3투	2416	1676	740	4	1672	727	939	0	1	2	3
경기도	성남시수정구	태평2동	태평2동제4투	2892	2090	802	7	2083	967	1111	1	1	0	3
경기도	성남시수정구	태평2동	태평2동제5투	3275	2241	1034	9	2232	1109	1112	1	1	5	4
경기도	성남시수정구	태평3동	소계	13241	9378	3863	27	9351	4195	5121	4	10	16	5
경기도	성남시수정구	태평3동	태평3동제1투	3352	2439	913	10	2429	1030	1387	2	3	5	2
경기도	성남시수정구	태평3동	태평3동제2투	3187	2295	892	8	2287	1105	1175	0	2	4	1
경기도	성남시수정구	태평3동	태평3동제3투	3497	2311	1186	3	2308	1031	1265	2	4	4	2
경기도	성남시수정구	태평3동	태평3동제4투	3205	2333	872	6	2327	1029	1294	0	1	3	0
경기도	성남시수정구	태평4동	소계	13210	9331	3879	26	9305	4142	5132	4	4	18	5
경기도	성남시수정구	태평4동	태평4동제1투	3227	2165	1062	8	2157	947	1199	0	2	9	0
경기도	성남시수정구	태평4동	태평4동제2투	2628	1790	838	5	1785	830	951	2	0	1	1
경기도	성남시수정구	태평4동	태평4동제3투	3706	2702	1004	7	2695	1150	1534	2	2	6	1
경기도	성남시수정구	태평4동	태평4동제4투	3649	2674	975	6	2668	1215	1448	0	0	2	3
경기도	성남시수정구	수진1동	소계	13622	9103	4519	26	9077	4206	4831	4	3	17	16
경기도	성남시수정구	수진1동	수진1동제1투	3355	2293	1062	7	2286	1072	1205	2	0	3	4
경기도	성남시수정구	수진1동	수진1동제2투	3549	2412	1137	6	2406	1182	1211	2	1	5	5
경기도	성남시수정구	수진1동	수진1동제3투	3347	2083	1264	7	2076	908	1156	0	2	7	3
경기도	성남시수정구	수진1동	수진1동제4투	3371	2315	1056	6	2309	1044	1259	0	0	2	4
경기도	성남시수정구	수진2동	소계	16309	12021	4288	43	11978	5494	6455	1	8	14	6
경기도	성남시수정구	수진2동	수진2동제1투	3781	2594	1187	13	2581	1149	1430	0	0	2	0
경기도	성남시수정구	수진2동	수진2동제2투	3715	2605	1110	9	2596	1157	1435	0	2	1	1
경기도	성남시수정구	수진2동	수진2동제3투	2579	1813	766	9	1804	854	942	0	1	5	2
경기도	성남시수정구	수진2동	수진2동제4투	2240	1735	505	3	1732	779	948	0	3	1	1
경기도	성남시수정구	수진2동	수진2동제5투	3994	3274	720	9	3265	1555	1700	1	2	5	2
경기도	성남시수정구	단대동	소계	12768	9544	3224	30	9514	4328	5152	1	4	21	8
경기도	성남시수정구	단대동	단대동제1투	2965	2103	862	6	2097	977	1112	0	1	6	1
경기도	성남시수정구	단대동	단대동제2투	4308	3488	820	12	3476	1566	1897	1	2	7	3
경기도	성남시수정구	단대동	단대동제3투	2956	2098	858	5	2093	943	1144	0	1	4	1
경기도	성남시수정구	단대동	단대동제4투	2539	1855	684	7	1848	842	999	0	0	4	3
경기도	성남시수정구	산성동	소계	12892	9145	3747	25	9120	3897	5198	3	3	10	9
경기도	성남시수정구	산성동	산성동제1투	3336	2376	960	10	2366	1023	1334	1	2	4	2
경기도	성남시수정구	산성동	산성동제2투	3488	2678	810	7	2671	1110	1552	1	1	4	3
경기도	성남시수정구	산성동	산성동제3투	3455	2236	1219	3	2233	958	1272	0	0	0	3
경기도	성남시수정구	산성동	산성동제4투	2613	1855	758	5	1850	806	1040	1	0	2	1
경기도	성남시수정구	양지동	소계	8831	6466	2365	24	6442	2859	3550	2	1	25	5
경기도	성남시수정구	양지동	양지동제1투	3511	2562	949	9	2553	1107	1429	1	1	12	3
경기도	성남시수정구	양지동	양지동제2투	3080	2272	808	9	2263	1002	1247	1	0	11	2
경기도	성남시수정구	양지동	양지동제3투	2240	1632	608	6	1626	750	874	0	0	2	0
경기도	성남시수정구	복정동	소계	11017	8092	2925	10	8082	2829	5234	2	2	10	5
경기도	성남시수정구	복정동	복정동제1투	2865	2157	708	5	2152	778	1366	1	1	2	4
경기도	성남시수정구	복정동	복정동제2투	806	566	240	1	565	339	225	0	0	1	0
경기도	성남시수정구	복정동	복정동제3투	3452	2515	937	0	2515	821	1691	0	1	2	0
경기도	성남시수정구	복정동	복정동제4투	3894	2854	1040	4	2850	891	1952	1	0	5	1
경기도	성남시수정구	신촌동	소계	2487	1851	636	7	1844	1160	676	2	1	5	0
경기도	성남시수정구	신촌동	신촌동투표소	2487	1851	636	7	1844	1160	676	2	1	5	0
경기도	성남시수정구	고등동	소계	2449	1790	659	9	1781	1126	649	1	0	2	3
경기도	성남시수정구	고등동	고등동투표소	2449	1790	659	9	1781	1126	649	1	0	2	3
경기도	성남시수정구	시흥동	소계	2750	2141	609	3	2138	1373	754	0	2	5	4
경기도	성남시수정구	시흥동	시흥동투표소	2750	2141	609	3	2138	1373	754	0	2	5	4
경기도	성남시중원구	계	계	206445	147567	58878	516	147051	68309	78261	35	74	214	158
경기도	성남시중원구	재외투표	재외투표	732	507	225	2	505	200	302	0	1	1	1
경기도	성남시중원구	국내부재자투표	국내부재자투표	4136	3887	249	80	3807	1784	1983	7	7	10	16
경기도	성남시중원구	성남동	소계	26528	18519	8009	55	18464	8657	9747	4	9	37	10
경기도	성남시중원구	성남동	성남동제1투	5731	3849	1882	12	3837	1756	2072	1	0	5	3
경기도	성남시중원구	성남동	성남동제2투	5036	3597	1439	5	3592	1649	1928	0	2	9	4
경기도	성남시중원구	성남동	성남동제3투	3922	3021	901	11	3010	1476	1525	1	1	6	1
경기도	성남시중원구	성남동	성남동제4투	3913	2701	1212	11	2690	1230	1452	0	1	6	1
경기도	성남시중원구	성남동	성남동제5투	5432	3618	1814	13	3605	1714	1880	2	3	5	1
경기도	성남시중원구	성남동	성남동제6투	2494	1733	761	3	1730	832	890	0	2	6	0
경기도	성남시중원구	중앙동	소계	16786	11040	5746	31	11009	5362	5607	1	11	13	15
경기도	성남시중원구	중앙동	중앙동제1투	3259	2052	1207	5	2047	986	1055	1	0	3	2
경기도	성남시중원구	중앙동	중앙동제2투	3360	2317	1043	10	2307	1051	1245	0	4	4	3
경기도	성남시중원구	중앙동	중앙동제3투	2823	1816	1007	4	1812	925	884	0	2	0	1
경기도	성남시중원구	중앙동	중앙동제4투	3251	2008	1243	5	2003	1015	983	0	0	2	3
경기도	성남시중원구	중앙동	중앙동제5투	4093	2847	1246	7	2840	1385	1440	0	5	4	6
경기도	성남시중원구	금광1동	소계	19255	13325	5930	41	13284	6120	7122	5	9	19	9
경기도	성남시중원구	금광1동	금광1동제1투	3648	2241	1407	5	2236	1091	1128	4	3	5	5
경기도	성남시중원구	금광1동	금광1동제2투	3617	2621	996	8	2613	1201	1406	0	1	4	1
경기도	성남시중원구	금광1동	금광1동제3투	3827	2625	1202	5	2620	1242	1373	1	1	3	0
경기도	성남시중원구	금광1동	금광1동제4투	2645	1798	847	12	1786	803	978	0	1	2	2
경기도	성남시중원구	금광1동	금광1동제5투	3257	2243	1014	7	2236	1065	1166	0	0	5	0
경기도	성남시중원구	금광1동	금광1동제6투	2261	1797	464	4	1793	718	1071	0	3	0	1
경기도	성남시중원구	금광2동	소계	23927	16926	7001	48	16878	7657	9182	5	7	15	12
경기도	성남시중원구	금광2동	금광2동제1투	3830	2534	1296	4	2530	1161	1361	1	2	3	2
경기도	성남시중원구	금광2동	금광2동제2투	4271	2924	1347	11	2913	1274	1634	0	1	3	1
경기도	성남시중원구	금광2동	금광2동제3투	2941	2085	856	6	2079	915	1158	0	1	3	2
경기도	성남시중원구	금광2동	금광2동제4투	3568	2530	1038	3	2527	1136	1386	1	2	0	2
경기도	성남시중원구	금광2동	금광2동제5투	4587	3115	1472	19	3096	1440	1648	2	0	2	4
경기도	성남시중원구	금광2동	금광2동제6투	4730	3738	992	5	3733	1731	1995	1	1	4	1
경기도	성남시중원구	은행1동	소계	10005	7342	2663	19	7323	3328	3973	0	3	14	5
경기도	성남시중원구	은행1동	은행1동제1투	3030	2084	946	5	2079	970	1100	0	0	4	5
경기도	성남시중원구	은행1동	은행1동제2투	3625	2536	1089	11	2525	1104	1418	0	1	2	0
경기도	성남시중원구	은행1동	은행1동제3투	3350	2722	628	3	2719	1254	1455	0	2	8	0
경기도	성남시중원구	은행2동	소계	23114	16611	6503	64	16547	7499	8991	5	7	21	24
경기도	성남시중원구	은행2동	은행2동제1투	4675	2961	1714	19	2942	1348	1585	0	2	3	4
경기도	성남시중원구	은행2동	은행2동제2투	2934	2082	852	2	2080	927	1147	0	1	2	3
경기도	성남시중원구	은행2동	은행2동제3투	3004	2354	650	3	2351	1021	1323	1	1	3	2
경기도	성남시중원구	은행2동	은행2동제4투	1988	1412	576	12	1400	605	787	1	0	3	4
경기도	성남시중원구	은행2동	은행2동제5투	2246	1538	708	9	1529	674	846	1	0	3	5
경기도	성남시중원구	은행2동	은행2동제6투	4425	3483	942	11	3472	1606	1854	2	3	4	3
경기도	성남시중원구	은행2동	은행2동제7투	3842	2781	1061	8	2773	1318	1449	0	0	3	3
경기도	성남시중원구	상대원1동	소계	24549	17597	6952	50	17547	7934	9572	4	1	17	19
경기도	성남시중원구	상대원1동	상대원1동제1투	5223	3410	1813	9	3401	1578	1815	2	1	4	1
경기도	성남시중원구	상대원1동	상대원1동제2투	4883	3272	1611	15	3257	1450	1799	0	0	2	6
경기도	성남시중원구	상대원1동	상대원1동제3투	3054	2066	988	5	2061	992	1062	1	0	3	3
경기도	성남시중원구	상대원1동	상대원1동제4투	2656	2174	482	5	2169	925	1239	0	0	2	3
경기도	성남시중원구	상대원1동	상대원1동제5투	3116	2485	631	6	2479	1068	1407	0	0	2	2
경기도	성남시중원구	상대원1동	상대원1동제6투	1959	1449	510	1	1448	655	789	0	0	1	3
경기도	성남시중원구	상대원1동	상대원1동제7투	3658	2741	917	9	2732	1266	1461	1	0	3	1
경기도	성남시중원구	상대원2동	소계	14491	9644	4847	35	9609	4678	4906	0	7	7	11
경기도	성남시중원구	상대원2동	상대원2동제1투	3418	2145	1273	6	2139	1002	1133	0	2	0	2
경기도	성남시중원구	상대원2동	상대원2동제2투	2955	2034	921	8	2026	988	1034	0	0	3	1
경기도	성남시중원구	상대원2동	상대원2동제3투	2485	1696	789	5	1691	855	829	0	1	3	3
경기도	성남시중원구	상대원2동	상대원2동제4투	3018	2087	931	6	2081	1017	1061	0	1	1	1
경기도	성남시중원구	상대원2동	상대원2동제5투	2615	1682	933	10	1672	816	849	0	3	0	4
경기도	성남시중원구	상대원3동	소계	12775	8581	4194	23	8558	4047	4473	2	4	17	15
경기도	성남시중원구	상대원3동	상대원3동제1투	4727	3228	1499	12	3216	1579	1620	1	0	10	6
경기도	성남시중원구	상대원3동	상대원3동제2투	3650	2446	1204	3	2443	1123	1305	1	3	6	5
경기도	성남시중원구	상대원3동	상대원3동제3투	4398	2907	1491	8	2899	1345	1548	0	1	1	4
경기도	성남시중원구	하대원동	소계	18257	14335	3922	38	14297	6923	7334	1	3	23	13
경기도	성남시중원구	하대원동	하대원동제1투	3454	2521	933	4	2517	1233	1278	0	0	3	3
경기도	성남시중원구	하대원동	하대원동제2투	3681	2797	884	8	2789	1351	1429	1	0	5	3
경기도	성남시중원구	하대원동	하대원동제3투	4549	3608	941	8	3600	1660	1932	0	2	4	2
경기도	성남시중원구	하대원동	하대원동제4투	4149	3535	614	13	3522	1764	1746	0	1	8	3
경기도	성남시중원구	하대원동	하대원동제5투	2424	1874	550	5	1869	915	949	0	0	3	2
경기도	성남시중원구	도촌동	소계	11890	9253	2637	30	9223	4120	5069	1	5	20	8
경기도	성남시중원구	도촌동	도촌동제1투	2901	2177	724	10	2167	1019	1140	0	2	5	1
경기도	성남시중원구	도촌동	도촌동제2투	3844	3062	782	8	3054	1394	1649	0	0	8	3
경기도	성남시중원구	도촌동	도촌동제3투	4044	3142	902	8	3134	1352	1773	1	1	4	3
경기도	성남시중원구	도촌동	도촌동제4투	1101	872	229	4	868	355	507	0	2	3	1
경기도	성남시분당구	계	계	381468	306328	75140	795	305533	162103	142315	60	105	732	218
경기도	성남시분당구	재외투표	재외투표	4871	3613	1258	12	3601	1566	2021	0	3	9	2
경기도	성남시분당구	국내부재자투표	국내부재자투표	9214	8657	557	125	8532	4632	3844	5	13	14	24
경기도	성남시분당구	분당동	소계	21762	17202	4560	35	17167	8784	8333	1	2	38	9
경기도	성남시분당구	분당동	분당동제1투	3852	3090	762	6	3084	1677	1399	0	1	4	3
경기도	성남시분당구	분당동	분당동제2투	3361	2854	507	7	2847	1443	1390	0	0	14	0
경기도	성남시분당구	분당동	분당동제3투	3241	2617	624	5	2612	1600	1005	0	0	5	2
경기도	성남시분당구	분당동	분당동제4투	3797	2843	954	5	2838	1253	1578	0	1	4	2
경기도	성남시분당구	분당동	분당동제5투	3621	2920	701	4	2916	1519	1393	0	0	2	2
경기도	성남시분당구	분당동	분당동제6투	3890	2878	1012	8	2870	1292	1568	1	0	9	0
경기도	성남시분당구	수내1동	소계	13600	10779	2821	31	10748	6108	4591	0	6	39	4
경기도	성남시분당구	수내1동	수내1동제1투	2805	2191	614	4	2187	1299	878	0	2	8	0
경기도	성남시분당구	수내1동	수내1동제2투	2619	2177	442	7	2170	1342	819	0	1	5	3
경기도	성남시분당구	수내1동	수내1동제3투	3058	2250	808	6	2244	1061	1174	0	0	9	0
경기도	성남시분당구	수내1동	수내1동제4투	2222	1759	463	8	1751	899	844	0	1	6	1
경기도	성남시분당구	수내1동	수내1동제5투	2896	2402	494	6	2396	1507	876	0	2	11	0
경기도	성남시분당구	수내2동	소계	7737	6392	1345	18	6374	3887	2462	1	1	17	6
경기도	성남시분당구	수내2동	수내2동제1투	2716	2219	497	10	2209	1318	886	1	0	3	1
경기도	성남시분당구	수내2동	수내2동제2투	3142	2627	515	6	2621	1668	939	0	0	11	3
경기도	성남시분당구	수내2동	수내2동제3투	1879	1546	333	2	1544	901	637	0	1	3	2
경기도	성남시분당구	수내3동	소계	11157	8835	2322	19	8816	4504	4276	0	2	32	2
경기도	성남시분당구	수내3동	수내3동제1투	3387	2824	563	5	2819	1548	1261	0	1	8	1
경기도	성남시분당구	수내3동	수내3동제2투	3316	2784	532	7	2777	1556	1206	0	0	15	0
경기도	성남시분당구	수내3동	수내3동제3투	4454	3227	1227	7	3220	1400	1809	0	1	9	1
경기도	성남시분당구	정자1동	소계	37805	29556	8249	59	29497	17629	11779	5	5	70	9
경기도	성남시분당구	정자1동	정자1동제1투	3194	2507	687	4	2503	1400	1096	0	0	5	2
경기도	성남시분당구	정자1동	정자1동제2투	3233	2567	666	5	2562	1685	873	0	0	4	0
경기도	성남시분당구	정자1동	정자1동제3투	4513	3709	804	5	3704	2128	1566	1	0	9	0
경기도	성남시분당구	정자1동	정자1동제4투	4145	3479	666	8	3471	1428	2032	1	2	7	1
경기도	성남시분당구	정자1동	정자1동제5투	3881	2837	1044	6	2831	1289	1534	1	1	5	1
경기도	성남시분당구	정자1동	정자1동제6투	3999	3100	899	5	3095	2133	950	0	0	11	1
경기도	성남시분당구	정자1동	정자1동제7투	3073	2300	773	9	2291	1428	855	1	0	7	0
경기도	성남시분당구	정자1동	정자1동제8투	4413	3566	847	4	3562	2648	901	1	2	7	3
경기도	성남시분당구	정자1동	정자1동제9투	4487	3264	1223	7	3257	1841	1409	0	0	6	1
경기도	성남시분당구	정자1동	정자1동제10투	2867	2227	640	6	2221	1649	563	0	0	9	0
경기도	성남시분당구	정자2동	소계	14370	11511	2859	28	11483	5590	5843	2	6	29	13
경기도	성남시분당구	정자2동	정자2동제1투	2068	1614	454	0	1614	667	941	0	2	2	2
경기도	성남시분당구	정자2동	정자2동제2투	2964	2306	658	4	2302	889	1404	0	1	7	1
경기도	성남시분당구	정자2동	정자2동제3투	2203	1624	579	6	1618	843	762	2	1	4	6
경기도	성남시분당구	정자2동	정자2동제4투	2366	1945	421	7	1938	869	1064	0	1	3	1
경기도	성남시분당구	정자2동	정자2동제5투	2085	1779	306	6	1773	905	861	0	0	7	0
경기도	성남시분당구	정자2동	정자2동제6투	2684	2243	441	5	2238	1417	811	0	1	6	3
경기도	성남시분당구	정자3동	소계	12832	10240	2592	32	10208	5256	4925	0	6	18	3
경기도	성남시분당구	정자3동	정자3동제1투	4740	3810	930	15	3795	1897	1891	0	2	3	2
경기도	성남시분당구	정자3동	정자3동제2투	3656	2799	857	4	2795	1261	1526	0	1	6	1
경기도	성남시분당구	정자3동	정자3동제3투	4436	3631	805	13	3618	2098	1508	0	3	9	0
경기도	성남시분당구	서현1동	소계	24207	19033	5174	45	18988	10724	8214	1	5	39	5
경기도	성남시분당구	서현1동	서현1동제1투	4989	3512	1477	6	3506	1712	1785	0	0	7	2
경기도	성남시분당구	서현1동	서현1동제2투	4662	3695	967	8	3687	2232	1448	0	1	6	0
경기도	성남시분당구	서현1동	서현1동제3투	4557	3707	850	10	3697	2036	1651	0	2	7	1
경기도	성남시분당구	서현1동	서현1동제4투	3117	2579	538	11	2568	1646	916	1	0	5	0
경기도	성남시분당구	서현1동	서현1동제5투	4353	3571	782	6	3565	2185	1369	0	1	10	0
경기도	성남시분당구	서현1동	서현1동제6투	2529	1969	560	4	1965	913	1045	0	1	4	2
경기도	성남시분당구	서현2동	소계	15235	12374	2861	25	12349	6485	5808	2	2	41	11
경기도	성남시분당구	서현2동	서현2동제1투	3973	3264	709	4	3260	1910	1335	1	0	13	1
경기도	성남시분당구	서현2동	서현2동제2투	3648	3060	588	8	3052	1752	1284	0	1	10	5
경기도	성남시분당구	서현2동	서현2동제3투	3833	3052	781	8	3044	1380	1652	1	1	8	2
경기도	성남시분당구	서현2동	서현2동제4투	3781	2998	783	5	2993	1443	1537	0	0	10	3
경기도	성남시분당구	이매1동	소계	20648	16899	3749	35	16864	9457	7346	6	6	39	10
경기도	성남시분당구	이매1동	이매1동제1투	4695	3774	921	11	3763	2325	1427	2	1	6	2
경기도	성남시분당구	이매1동	이매1동제2투	3402	2845	557	10	2835	1631	1194	1	0	8	1
경기도	성남시분당구	이매1동	이매1동제3투	2663	2217	446	1	2216	1285	920	0	1	9	1
경기도	성남시분당구	이매1동	이매1동제4투	3329	2776	553	2	2774	1499	1268	0	0	5	2
경기도	성남시분당구	이매1동	이매1동제5투	2525	2153	372	4	2149	1059	1085	0	0	4	1
경기도	성남시분당구	이매1동	이매1동제6투	4034	3134	900	7	3127	1658	1452	3	4	7	3
경기도	성남시분당구	이매2동	소계	11333	9180	2153	15	9165	5587	3551	3	2	18	4
경기도	성남시분당구	이매2동	이매2동제1투	3187	2585	602	1	2584	1562	1017	1	1	3	0
경기도	성남시분당구	이매2동	이매2동제2투	3833	3064	769	10	3054	1872	1172	1	1	6	2
경기도	성남시분당구	이매2동	이매2동제3투	4313	3531	782	4	3527	2153	1362	1	0	9	2
경기도	성남시분당구	야탑1동	소계	14864	11942	2922	26	11916	6132	5738	1	4	31	10
경기도	성남시분당구	야탑1동	야탑1동제1투	2824	1964	860	7	1957	1021	930	0	0	5	1
경기도	성남시분당구	야탑1동	야탑1동제2투	4016	3317	699	9	3308	1792	1501	0	2	10	3
경기도	성남시분당구	야탑1동	야탑1동제3투	2835	2409	426	5	2404	1297	1098	0	1	5	3
경기도	성남시분당구	야탑1동	야탑1동제4투	2720	2274	446	3	2271	1049	1217	0	0	4	1
경기도	성남시분당구	야탑1동	야탑1동제5투	2469	1978	491	2	1976	973	992	1	1	7	2
경기도	성남시분당구	야탑2동	소계	14264	11686	2578	24	11662	6866	4754	4	2	30	6
경기도	성남시분당구	야탑2동	야탑2동제1투	3428	2789	639	8	2781	1790	982	1	0	8	0
경기도	성남시분당구	야탑2동	야탑2동제2투	4505	3726	779	4	3722	2304	1406	2	1	7	2
경기도	성남시분당구	야탑2동	야탑2동제3투	3676	3013	663	6	3007	1718	1278	1	0	9	1
경기도	성남시분당구	야탑2동	야탑2동제4투	2655	2158	497	6	2152	1054	1088	0	1	6	3
경기도	성남시분당구	야탑3동	소계	25677	20241	5436	52	20189	9069	11053	8	7	33	19
경기도	성남시분당구	야탑3동	야탑3동제1투	4746	3519	1227	10	3509	1544	1944	3	2	11	5
경기도	성남시분당구	야탑3동	야탑3동제2투	3801	3050	751	10	3040	1359	1674	1	0	4	2
경기도	성남시분당구	야탑3동	야탑3동제3투	4112	3431	681	8	3423	1452	1963	1	2	2	3
경기도	성남시분당구	야탑3동	야탑3동제4투	3554	2587	967	14	2573	1266	1295	1	1	5	5
경기도	성남시분당구	야탑3동	야탑3동제5투	2612	2160	452	0	2160	991	1162	0	1	4	2
경기도	성남시분당구	야탑3동	야탑3동제6투	3386	2709	677	6	2703	1325	1373	0	1	3	1
경기도	성남시분당구	야탑3동	야탑3동제7투	3466	2785	681	4	2781	1132	1642	2	0	4	1
경기도	성남시분당구	금곡동	소계	23532	18745	4787	49	18696	10204	8430	6	3	37	16
경기도	성남시분당구	금곡동	금곡동제1투	3670	2910	760	2	2908	1421	1483	0	1	1	2
경기도	성남시분당구	금곡동	금곡동제2투	3405	2898	507	8	2890	1585	1292	1	0	9	3
경기도	성남시분당구	금곡동	금곡동제3투	3310	2532	778	14	2518	1223	1282	3	0	5	5
경기도	성남시분당구	금곡동	금곡동제4투	4018	3313	705	14	3299	1958	1327	1	1	10	2
경기도	성남시분당구	금곡동	금곡동제5투	2397	1900	497	3	1897	882	1010	1	0	3	1
경기도	성남시분당구	금곡동	금곡동제6투	3926	3000	926	3	2997	1686	1304	0	0	7	0
경기도	성남시분당구	금곡동	금곡동제7투	2806	2192	614	5	2187	1449	732	0	1	2	3
경기도	성남시분당구	구미동	소계	25973	20725	5248	48	20677	10816	9787	3	7	46	18
경기도	성남시분당구	구미동	구미동제1투	2769	2391	378	9	2382	1206	1170	0	1	4	1
경기도	성남시분당구	구미동	구미동제2투	3408	2853	555	6	2847	1205	1630	0	1	9	2
경기도	성남시분당구	구미동	구미동제3투	1855	1559	296	1	1558	804	752	0	0	1	1
경기도	성남시분당구	구미동	구미동제4투	3150	2338	812	3	2335	1686	645	0	0	4	0
경기도	성남시분당구	구미동	구미동제5투	3759	3097	662	7	3090	1537	1540	1	0	10	2
경기도	성남시분당구	구미동	구미동제6투	3137	2486	651	4	2482	1400	1070	0	2	8	2
경기도	성남시분당구	구미동	구미동제7투	3820	2962	858	7	2955	1509	1435	0	1	5	5
경기도	성남시분당구	구미동	구미동제8투	4075	3039	1036	11	3028	1469	1545	2	2	5	5
경기도	성남시분당구	구미1동	소계	14093	11173	2920	26	11147	5498	5598	3	6	34	8
경기도	성남시분당구	구미1동	구미1동제1투	4524	3308	1216	7	3301	1520	1768	0	0	9	4
경기도	성남시분당구	구미1동	구미1동제2투	4600	3735	865	9	3726	1816	1896	0	3	10	1
경기도	성남시분당구	구미1동	구미1동제3투	2329	1907	422	7	1900	1120	767	2	1	9	1
경기도	성남시분당구	구미1동	구미1동제4투	2640	2223	417	3	2220	1042	1167	1	2	6	2
경기도	성남시분당구	판교동	소계	15651	12896	2755	19	12877	6599	6226	2	3	31	16
경기도	성남시분당구	판교동	판교동제1투	3300	2750	550	3	2747	1287	1451	0	0	5	4
경기도	성남시분당구	판교동	판교동제2투	4154	3494	660	5	3489	1898	1574	0	0	13	4
경기도	성남시분당구	판교동	판교동제3투	4162	3455	707	5	3450	1982	1453	0	2	10	3
경기도	성남시분당구	판교동	판교동제4투	4035	3197	838	6	3191	1432	1748	2	1	3	5
경기도	성남시분당구	삼평동	소계	17307	14028	3279	28	14000	6448	7506	3	7	28	8
경기도	성남시분당구	삼평동	삼평동제1투	4685	3805	880	8	3797	1681	2105	1	0	10	0
경기도	성남시분당구	삼평동	삼평동제2투	3398	2795	603	7	2788	1270	1507	1	1	8	1
경기도	성남시분당구	삼평동	삼평동제3투	4598	3498	1100	7	3491	1542	1940	0	3	4	2
경기도	성남시분당구	삼평동	삼평동제4투	4626	3930	696	6	3924	1955	1954	1	3	6	5
경기도	성남시분당구	백현동	소계	10487	8768	1719	20	8748	4145	4564	3	3	29	4
경기도	성남시분당구	백현동	백현동제1투	4173	3475	698	6	3469	1654	1801	1	1	12	0
경기도	성남시분당구	백현동	백현동제2투	3377	2848	529	9	2839	1274	1548	0	1	12	4
경기도	성남시분당구	백현동	백현동제3투	2937	2445	492	5	2440	1217	1215	2	1	5	0
경기도	성남시분당구	운중동	소계	14849	11853	2996	24	11829	6117	5666	1	4	30	11
경기도	성남시분당구	운중동	운중동제1투	2068	1578	490	3	1575	869	701	0	0	3	2
경기도	성남시분당구	운중동	운중동제2투	3112	2510	602	2	2508	1337	1160	0	1	9	1
경기도	성남시분당구	운중동	운중동제3투	2908	2305	603	7	2298	1216	1067	1	1	7	6
경기도	성남시분당구	운중동	운중동제4투	2114	1638	476	3	1635	695	934	0	2	2	2
경기도	성남시분당구	운중동	운중동제5투	4647	3822	825	9	3813	2000	1804	0	0	9	0
경기도	의정부시	계	계	337945	249229	88716	801	248428	127092	120550	64	117	368	237
경기도	의정부시	재외투표	재외투표	1529	1074	455	3	1071	449	618	0	2	1	1
경기도	의정부시	국내부재자투표	국내부재자투표	7141	6744	397	116	6628	3287	3270	12	18	11	30
경기도	의정부시	의정부1동	소계	17094	11154	5940	34	11120	6349	4744	3	4	11	9
경기도	의정부시	의정부1동	의정부1동제1투	4249	2637	1612	4	2633	1564	1062	1	1	4	1
경기도	의정부시	의정부1동	의정부1동제2투	3559	2120	1439	4	2116	1246	864	1	0	2	3
경기도	의정부시	의정부1동	의정부1동제3투	3761	2490	1271	10	2480	1407	1072	0	0	1	0
경기도	의정부시	의정부1동	의정부1동제4투	2304	1624	680	4	1620	877	739	0	1	1	2
경기도	의정부시	의정부1동	의정부1동제5투	3221	2283	938	12	2271	1255	1007	1	2	3	3
경기도	의정부시	의정부2동	소계	22798	15245	7553	40	15205	7754	7404	1	9	21	16
경기도	의정부시	의정부2동	의정부2동제1투	4739	2919	1820	7	2912	1406	1498	0	2	4	2
경기도	의정부시	의정부2동	의정부2동제2투	2708	1789	919	6	1783	1000	775	0	2	4	2
경기도	의정부시	의정부2동	의정부2동제3투	2852	1847	1005	3	1844	1060	780	0	0	2	2
경기도	의정부시	의정부2동	의정부2동제4투	3525	2461	1064	3	2458	1231	1217	1	3	3	3
경기도	의정부시	의정부2동	의정부2동제5투	3245	2198	1047	8	2190	1101	1086	0	1	0	2
경기도	의정부시	의정부2동	의정부2동제6투	3040	2071	969	9	2062	1034	1019	0	0	5	4
경기도	의정부시	의정부2동	의정부2동제7투	2689	1960	729	4	1956	922	1029	0	1	3	1
경기도	의정부시	의정부3동	소계	11777	7870	3907	26	7844	4344	3471	0	3	14	12
경기도	의정부시	의정부3동	의정부3동제1투	4105	2620	1485	10	2610	1474	1126	0	0	5	5
경기도	의정부시	의정부3동	의정부3동제2투	3718	2437	1281	6	2431	1461	956	0	1	7	6
경기도	의정부시	의정부3동	의정부3동제3투	3954	2813	1141	10	2803	1409	1389	0	2	2	1
경기도	의정부시	호원1동	소계	26266	20508	5758	54	20454	10228	10161	7	10	28	20
경기도	의정부시	호원1동	호원1동제1투	4215	3053	1162	4	3049	1520	1515	1	2	7	4
경기도	의정부시	호원1동	호원1동제2투	3928	3279	649	9	3270	1784	1473	0	4	7	2
경기도	의정부시	호원1동	호원1동제3투	2460	1733	727	7	1726	846	876	0	0	1	3
경기도	의정부시	호원1동	호원1동제4투	3000	2257	743	6	2251	1209	1038	1	0	0	3
경기도	의정부시	호원1동	호원1동제5투	3451	2789	662	8	2781	1296	1476	2	2	1	4
경기도	의정부시	호원1동	호원1동제6투	3032	2454	578	10	2444	1185	1250	2	2	4	1
경기도	의정부시	호원1동	호원1동제7투	4025	3222	803	5	3217	1511	1697	0	0	6	3
경기도	의정부시	호원1동	호원1동제8투	2155	1721	434	5	1716	877	836	1	0	2	0
경기도	의정부시	호원2동	소계	29349	23210	6139	61	23149	11370	11712	2	5	34	26
경기도	의정부시	호원2동	호원2동제1투	5246	4034	1212	10	4024	1940	2074	0	0	7	3
경기도	의정부시	호원2동	호원2동제2투	3789	3034	755	3	3031	1440	1584	0	0	4	3
경기도	의정부시	호원2동	호원2동제3투	4369	3361	1008	15	3346	1643	1690	0	2	7	4
경기도	의정부시	호원2동	호원2동제4투	4201	3330	871	5	3325	1559	1754	1	1	3	7
경기도	의정부시	호원2동	호원2동제5투	3581	2905	676	13	2892	1521	1364	1	1	3	2
경기도	의정부시	호원2동	호원2동제6투	3833	3055	778	6	3049	1458	1582	0	1	3	5
경기도	의정부시	호원2동	호원2동제7투	4330	3491	839	9	3482	1809	1664	0	0	7	2
경기도	의정부시	장암동	소계	17216	13403	3813	54	13349	6507	6796	2	7	19	18
경기도	의정부시	장암동	장암동제1투	3678	3069	609	10	3059	1507	1549	0	3	0	0
경기도	의정부시	장암동	장암동제2투	3823	2719	1104	16	2703	1436	1255	1	2	5	4
경기도	의정부시	장암동	장암동제3투	3335	2584	751	6	2578	1241	1329	1	1	2	4
경기도	의정부시	장암동	장암동제4투	3393	2602	791	10	2592	1279	1305	0	0	4	4
경기도	의정부시	장암동	장암동제5투	342	245	97	2	243	159	81	0	0	1	2
경기도	의정부시	장암동	장암동제6투	2645	2184	461	10	2174	885	1277	0	1	7	4
경기도	의정부시	신곡1동	소계	35775	26945	8830	94	26851	13487	13286	6	15	40	17
경기도	의정부시	신곡1동	신곡1동제1투	3978	2404	1574	11	2393	1248	1143	1	1	0	0
경기도	의정부시	신곡1동	신곡1동제2투	3562	2722	840	15	2707	1549	1154	1	0	1	2
경기도	의정부시	신곡1동	신곡1동제3투	3547	2378	1169	14	2364	1254	1099	2	2	4	3
경기도	의정부시	신곡1동	신곡1동제4투	3654	2806	848	12	2794	1403	1378	1	1	7	4
경기도	의정부시	신곡1동	신곡1동제5투	4585	3502	1083	5	3497	1848	1632	1	2	8	6
경기도	의정부시	신곡1동	신곡1동제6투	4203	3220	983	7	3213	1569	1638	0	0	5	1
경기도	의정부시	신곡1동	신곡1동제7투	3399	2762	637	6	2756	1224	1527	0	2	3	0
경기도	의정부시	신곡1동	신곡1동제8투	4475	3489	986	14	3475	1488	1981	0	2	4	0
경기도	의정부시	신곡1동	신곡1동제9투	4372	3662	710	10	3652	1904	1734	0	5	8	1
경기도	의정부시	신곡2동	소계	35522	27530	7992	65	27465	14225	13160	5	9	44	22
경기도	의정부시	신곡2동	신곡2동제1투	3629	2605	1024	9	2596	1306	1281	0	0	6	3
경기도	의정부시	신곡2동	신곡2동제2투	3385	2681	704	7	2674	1326	1337	1	1	5	4
경기도	의정부시	신곡2동	신곡2동제3투	3202	2475	727	6	2469	1313	1148	2	0	5	1
경기도	의정부시	신곡2동	신곡2동제4투	3279	2594	685	5	2589	1239	1345	0	2	2	1
경기도	의정부시	신곡2동	신곡2동제5투	3686	2872	814	6	2866	1381	1479	0	0	5	1
경기도	의정부시	신곡2동	신곡2동제6투	3504	2846	658	6	2840	1668	1167	0	0	4	1
경기도	의정부시	신곡2동	신곡2동제7투	3931	2855	1076	9	2846	1394	1442	1	2	5	2
경기도	의정부시	신곡2동	신곡2동제8투	3587	2927	660	7	2920	1539	1375	1	0	3	2
경기도	의정부시	신곡2동	신곡2동제9투	3618	3007	611	5	3002	1591	1397	0	2	8	4
경기도	의정부시	신곡2동	신곡2동제10투	3701	2668	1033	5	2663	1468	1189	0	2	1	3
경기도	의정부시	송산1동	소계	27160	19623	7537	58	19565	10013	9493	5	10	25	19
경기도	의정부시	송산1동	송산1동제1투	3593	2827	766	8	2819	1416	1392	0	1	6	4
경기도	의정부시	송산1동	송산1동제2투	2810	2197	613	8	2189	1063	1123	0	1	1	1
경기도	의정부시	송산1동	송산1동제3투	3929	2894	1035	15	2879	1379	1492	1	0	2	5
경기도	의정부시	송산1동	송산1동제4투	3047	2275	772	2	2273	965	1302	0	2	4	0
경기도	의정부시	송산1동	송산1동제5투	2628	1880	748	6	1874	1012	856	2	1	1	2
경기도	의정부시	송산1동	송산1동제6투	4145	2658	1487	7	2651	1445	1193	1	1	7	4
경기도	의정부시	송산1동	송산1동제7투	4910	3426	1484	7	3419	1728	1683	0	4	3	1
경기도	의정부시	송산1동	송산1동제8투	1080	774	306	4	770	572	197	0	0	1	0
경기도	의정부시	송산1동	송산1동제9투	1018	692	326	1	691	433	255	1	0	0	2
경기도	의정부시	송산2동	소계	26143	19678	6465	45	19633	9223	10350	10	5	31	14
경기도	의정부시	송산2동	송산2동제1투	4662	3299	1363	8	3291	1591	1683	4	2	7	4
경기도	의정부시	송산2동	송산2동제2투	4070	3087	983	5	3082	1352	1720	2	0	7	1
경기도	의정부시	송산2동	송산2동제3투	4279	3368	911	5	3363	1645	1707	1	2	5	3
경기도	의정부시	송산2동	송산2동제4투	4013	3174	839	7	3167	1470	1692	1	0	2	2
경기도	의정부시	송산2동	송산2동제5투	3866	2907	959	9	2898	1325	1568	1	1	2	1
경기도	의정부시	송산2동	송산2동제6투	5253	3843	1410	11	3832	1840	1980	1	0	8	3
경기도	의정부시	자금동	소계	23761	17293	6468	45	17248	9031	8167	2	9	25	14
경기도	의정부시	자금동	자금동제1투	3905	2473	1432	6	2467	1359	1105	0	1	1	1
경기도	의정부시	자금동	자금동제2투	4158	3101	1057	9	3092	1667	1413	0	3	6	3
경기도	의정부시	자금동	자금동제3투	3070	2211	859	6	2205	1276	923	0	2	4	0
경기도	의정부시	자금동	자금동제4투	3126	2159	967	9	2150	1184	956	0	1	5	4
경기도	의정부시	자금동	자금동제5투	4205	3125	1080	7	3118	1543	1569	1	1	2	2
경기도	의정부시	자금동	자금동제6투	5297	4224	1073	8	4216	2002	2201	1	1	7	4
경기도	의정부시	가능1동	소계	21124	14219	6905	44	14175	7779	6351	5	5	23	12
경기도	의정부시	가능1동	가능1동제1투	3758	2252	1506	6	2246	1269	970	1	0	2	4
경기도	의정부시	가능1동	가능1동제2투	4309	3159	1150	9	3150	1687	1453	1	1	7	1
경기도	의정부시	가능1동	가능1동제3투	3068	2084	984	8	2076	1094	980	0	0	1	1
경기도	의정부시	가능1동	가능1동제4투	2436	1704	732	6	1698	970	722	2	1	3	0
경기도	의정부시	가능1동	가능1동제5투	3893	2550	1343	10	2540	1400	1133	1	1	3	2
경기도	의정부시	가능1동	가능1동제6투	3660	2470	1190	5	2465	1359	1093	0	2	7	4
경기도	의정부시	가능2동	소계	8134	5276	2858	15	5261	2863	2383	2	1	12	0
경기도	의정부시	가능2동	가능2동제1투	2735	1525	1210	6	1519	838	678	1	0	2	0
경기도	의정부시	가능2동	가능2동제2투	2478	1712	766	3	1709	894	810	0	1	4	0
경기도	의정부시	가능2동	가능2동제3투	2921	2039	882	6	2033	1131	895	1	0	6	0
경기도	의정부시	가능3동	소계	9374	6387	2987	20	6367	3551	2804	0	1	7	4
경기도	의정부시	가능3동	가능3동제1투	3890	2628	1262	9	2619	1397	1218	0	1	2	1
경기도	의정부시	가능3동	가능3동제2투	2838	1980	858	6	1974	1113	859	0	0	1	1
경기도	의정부시	가능3동	가능3동제3투	2646	1779	867	5	1774	1041	727	0	0	4	2
경기도	의정부시	녹양동	소계	17782	13070	4712	27	13043	6632	6380	2	4	22	3
경기도	의정부시	녹양동	녹양동제1투	3786	2550	1236	5	2545	1333	1204	1	1	6	0
경기도	의정부시	녹양동	녹양동제2투	4075	3056	1019	8	3048	1455	1583	1	1	7	1
경기도	의정부시	녹양동	녹양동제3투	3195	2294	901	2	2292	1211	1075	0	1	4	1
경기도	의정부시	녹양동	녹양동제4투	4344	3345	999	6	3339	1634	1699	0	1	4	1
경기도	의정부시	녹양동	녹양동제5투	2382	1825	557	6	1819	999	819	0	0	1	0
경기도	안양시만안구	계	계	206674	156859	49815	472	156387	76396	79472	39	87	262	131
경기도	안양시만안구	재외투표	재외투표	1062	787	275	7	780	331	446	0	0	3	0
경기도	안양시만안구	국내부재자투표	국내부재자투표	4554	4303	251	69	4234	2116	2080	2	4	11	21
경기도	안양시만안구	안양1동	소계	14338	11605	2733	34	11571	5506	6025	1	10	24	5
경기도	안양시만안구	안양1동	안양1동제1투	2793	2244	549	6	2238	1020	1213	0	3	1	1
경기도	안양시만안구	안양1동	안양1동제2투	4843	4120	723	17	4103	1833	2256	0	2	10	2
경기도	안양시만안구	안양1동	안양1동제3투	2580	2070	510	5	2065	1008	1051	0	2	3	1
경기도	안양시만안구	안양1동	안양1동제4투	2825	2362	463	5	2357	1176	1168	0	3	9	1
경기도	안양시만안구	안양1동	안양1동제5투	1297	809	488	1	808	469	337	1	0	1	0
경기도	안양시만안구	안양2동	소계	19526	14080	5446	41	14039	6974	7011	4	11	25	14
경기도	안양시만안구	안양2동	안양2동제1투	4387	2889	1498	14	2875	1416	1447	1	1	7	3
경기도	안양시만안구	안양2동	안양2동제2투	4911	3727	1184	12	3715	1776	1927	0	3	6	3
경기도	안양시만안구	안양2동	안양2동제3투	3637	2567	1070	5	2562	1307	1242	2	6	5	0
경기도	안양시만안구	안양2동	안양2동제4투	3957	2930	1027	6	2924	1485	1427	0	1	5	6
경기도	안양시만안구	안양2동	안양2동제5투	2634	1967	667	4	1963	990	968	1	0	2	2
경기도	안양시만안구	안양3동	소계	15079	10970	4109	37	10933	5453	5443	5	6	19	7
경기도	안양시만안구	안양3동	안양3동제1투	3404	2315	1089	9	2306	1147	1151	1	1	5	1
경기도	안양시만안구	안양3동	안양3동제2투	3815	2766	1049	6	2760	1291	1457	0	3	7	2
경기도	안양시만안구	안양3동	안양3동제3투	4372	3013	1359	13	3000	1516	1474	2	1	4	3
경기도	안양시만안구	안양3동	안양3동제4투	3488	2876	612	9	2867	1499	1361	2	1	3	1
경기도	안양시만안구	안양4동	소계	5900	4480	1420	14	4466	2330	2125	2	2	5	2
경기도	안양시만안구	안양4동	안양4동제1투	2848	2060	788	9	2051	1083	964	1	0	2	1
경기도	안양시만안구	안양4동	안양4동제2투	3052	2420	632	5	2415	1247	1161	1	2	3	1
경기도	안양시만안구	안양5동	소계	12134	8631	3503	21	8610	4424	4165	2	7	7	5
경기도	안양시만안구	안양5동	안양5동제1투	4314	3254	1060	6	3248	1678	1562	0	3	4	1
경기도	안양시만안구	안양5동	안양5동제2투	4280	3066	1214	8	3058	1548	1503	1	2	2	2
경기도	안양시만안구	안양5동	안양5동제3투	3540	2311	1229	7	2304	1198	1100	1	2	1	2
경기도	안양시만안구	안양6동	소계	17464	12563	4901	40	12523	6278	6217	1	1	15	11
경기도	안양시만안구	안양6동	안양6동제1투	5385	3709	1676	12	3697	1806	1885	0	0	4	2
경기도	안양시만안구	안양6동	안양6동제2투	3741	2734	1007	4	2730	1412	1313	0	1	3	1
경기도	안양시만안구	안양6동	안양6동제3투	4903	3616	1287	14	3602	1821	1771	1	0	4	5
경기도	안양시만안구	안양6동	안양6동제4투	3435	2504	931	10	2494	1239	1248	0	0	4	3
경기도	안양시만안구	안양7동	소계	4260	2953	1307	9	2944	1467	1471	0	1	4	1
경기도	안양시만안구	안양7동	안양7동제1투	1541	926	615	4	922	485	435	0	1	1	0
경기도	안양시만안구	안양7동	안양7동제2투	2719	2027	692	5	2022	982	1036	0	0	3	1
경기도	안양시만안구	안양8동	소계	10269	7428	2841	25	7403	3585	3789	3	3	16	7
경기도	안양시만안구	안양8동	안양8동제1투	3621	2545	1076	10	2535	1243	1280	2	2	4	4
경기도	안양시만안구	안양8동	안양8동제2투	3757	2704	1053	9	2695	1273	1413	0	0	8	1
경기도	안양시만안구	안양8동	안양8동제3투	2891	2179	712	6	2173	1069	1096	1	1	4	2
경기도	안양시만안구	안양9동	소계	14958	11314	3644	26	11288	5671	5579	2	2	21	13
경기도	안양시만안구	안양9동	안양9동제1투	2835	2123	712	4	2119	1033	1075	0	1	5	5
경기도	안양시만안구	안양9동	안양9동제2투	3806	2935	871	3	2932	1403	1520	0	1	5	3
경기도	안양시만안구	안양9동	안양9동제3투	3653	2625	1028	9	2616	1351	1258	1	0	2	4
경기도	안양시만안구	안양9동	안양9동제4투	4664	3631	1033	10	3621	1884	1726	1	0	9	1
경기도	안양시만안구	석수1동	소계	16268	13057	3211	34	13023	6110	6868	3	8	28	6
경기도	안양시만안구	석수1동	석수1동제1투	5247	3992	1255	9	3983	1843	2129	1	2	8	0
경기도	안양시만안구	석수1동	석수1동제2투	3695	2793	902	9	2784	1329	1445	1	2	6	1
경기도	안양시만안구	석수1동	석수1동제3투	2374	1983	391	11	1972	847	1114	1	1	8	1
경기도	안양시만안구	석수1동	석수1동제4투	4952	4289	663	5	4284	2091	2180	0	3	6	4
경기도	안양시만안구	석수2동	소계	27053	21134	5919	47	21087	9872	11140	8	13	41	13
경기도	안양시만안구	석수2동	석수2동제1투	1946	1437	509	2	1435	687	745	1	0	1	1
경기도	안양시만안구	석수2동	석수2동제2투	4486	3501	985	7	3494	1746	1739	1	1	7	0
경기도	안양시만안구	석수2동	석수2동제3투	3057	2300	757	5	2295	1133	1151	2	1	7	1
경기도	안양시만안구	석수2동	석수2동제4투	3072	2519	553	3	2516	1258	1251	1	1	4	1
경기도	안양시만안구	석수2동	석수2동제5투	2895	2132	763	5	2127	1038	1083	2	0	3	1
경기도	안양시만안구	석수2동	석수2동제6투	3236	2380	856	8	2372	1144	1219	1	0	5	3
경기도	안양시만안구	석수2동	석수2동제7투	4463	3576	887	10	3566	1537	2010	0	8	9	2
경기도	안양시만안구	석수2동	석수2동제8투	3898	3289	609	7	3282	1329	1942	0	2	5	4
경기도	안양시만안구	석수3동	소계	12195	9169	3026	22	9147	4280	4836	1	10	12	8
경기도	안양시만안구	석수3동	석수3동제1투	4392	3154	1238	6	3148	1511	1628	1	3	4	1
경기도	안양시만안구	석수3동	석수3동제2투	3811	3064	747	5	3059	1386	1661	0	5	4	3
경기도	안양시만안구	석수3동	석수3동제3투	3992	2951	1041	11	2940	1383	1547	0	2	4	4
경기도	안양시만안구	박달1동	소계	14486	10539	3947	17	10522	5233	5263	2	2	13	9
경기도	안양시만안구	박달1동	박달1동제1투	4248	2951	1297	4	2947	1433	1504	1	2	5	2
경기도	안양시만안구	박달1동	박달1동제2투	2885	2073	812	2	2071	1092	972	1	0	5	1
경기도	안양시만안구	박달1동	박달1동제3투	3412	2388	1024	4	2384	1242	1138	0	0	1	3
경기도	안양시만안구	박달1동	박달1동제4투	3941	3127	814	7	3120	1466	1649	0	0	2	3
경기도	안양시만안구	박달2동	소계	17128	13846	3282	29	13817	6766	7014	3	7	18	9
경기도	안양시만안구	박달2동	박달2동제1투	3405	2585	820	6	2579	1258	1310	1	2	5	3
경기도	안양시만안구	박달2동	박달2동제2투	2706	2276	430	2	2274	1125	1145	0	0	2	2
경기도	안양시만안구	박달2동	박달2동제3투	3425	2822	603	5	2817	1404	1407	2	1	2	1
경기도	안양시만안구	박달2동	박달2동제4투	3884	3022	862	8	3014	1427	1581	0	2	3	1
경기도	안양시만안구	박달2동	박달2동제5투	3708	3141	567	8	3133	1552	1571	0	2	6	2
경기도	안양시동안구	계	계	276827	221572	55255	583	220989	103793	116384	54	111	471	176
경기도	안양시동안구	재외투표	재외투표	2019	1472	547	8	1464	570	886	1	2	4	1
경기도	안양시동안구	국내부재자투표	국내부재자투표	6734	6345	389	76	6269	3025	3192	10	8	16	18
경기도	안양시동안구	비산1동	소계	20537	16544	3993	39	16505	8146	8302	4	10	29	14
경기도	안양시동안구	비산1동	비산1동제1투	3047	2067	980	8	2059	970	1081	2	3	2	1
경기도	안양시동안구	비산1동	비산1동제2투	3138	2434	704	7	2427	1209	1214	0	1	0	3
경기도	안양시동안구	비산1동	비산1동제3투	4526	3746	780	6	3740	1627	2098	0	1	9	5
경기도	안양시동안구	비산1동	비산1동제4투	4309	3605	704	8	3597	2001	1588	0	2	6	0
경기도	안양시동안구	비산1동	비산1동제5투	2766	2353	413	6	2347	1222	1111	1	1	8	4
경기도	안양시동안구	비산1동	비산1동제6투	2751	2339	412	4	2335	1117	1210	1	2	4	1
경기도	안양시동안구	비산2동	소계	11159	9072	2087	23	9049	4419	4586	4	4	27	9
경기도	안양시동안구	비산2동	비산2동제1투	3100	2369	731	7	2362	1191	1156	1	3	9	2
경기도	안양시동안구	비산2동	비산2동제2투	4354	3573	781	10	3563	1662	1890	2	0	6	3
경기도	안양시동안구	비산2동	비산2동제3투	3705	3130	575	6	3124	1566	1540	1	1	12	4
경기도	안양시동안구	비산3동	소계	20258	15412	4846	45	15367	7565	7760	2	3	26	11
경기도	안양시동안구	비산3동	비산3동제1투	3715	2956	759	6	2950	1514	1428	0	1	4	3
경기도	안양시동안구	비산3동	비산3동제2투	3333	2717	616	10	2707	1358	1341	0	1	6	1
경기도	안양시동안구	비산3동	비산3동제3투	3685	2633	1052	7	2626	1207	1411	1	1	4	2
경기도	안양시동안구	비산3동	비산3동제4투	2855	2135	720	4	2131	1085	1041	0	0	3	2
경기도	안양시동안구	비산3동	비산3동제5투	3125	2370	755	9	2361	1133	1221	0	0	5	2
경기도	안양시동안구	비산3동	비산3동제6투	3545	2601	944	9	2592	1268	1318	1	0	4	1
경기도	안양시동안구	부흥동	소계	14314	11719	2595	28	11691	5260	6390	3	5	24	9
경기도	안양시동안구	부흥동	부흥동제1투	2526	2000	526	2	1998	895	1096	0	1	4	2
경기도	안양시동안구	부흥동	부흥동제2투	2733	2277	456	6	2271	1024	1242	1	0	3	1
경기도	안양시동안구	부흥동	부흥동제3투	2364	1784	580	5	1779	803	967	2	0	6	1
경기도	안양시동안구	부흥동	부흥동제4투	3866	3246	620	12	3234	1458	1764	0	3	5	4
경기도	안양시동안구	부흥동	부흥동제5투	2825	2412	413	3	2409	1080	1321	0	1	6	1
경기도	안양시동안구	달안동	소계	10057	7842	2215	33	7809	3035	4750	2	3	15	4
경기도	안양시동안구	달안동	달안동제1투	3494	2672	822	16	2656	1034	1614	1	0	6	1
경기도	안양시동안구	달안동	달안동제2투	3234	2451	783	4	2447	957	1481	0	1	6	2
경기도	안양시동안구	달안동	달안동제3투	3329	2719	610	13	2706	1044	1655	1	2	3	1
경기도	안양시동안구	관양1동	소계	28445	22013	6432	53	21960	10304	11579	3	14	46	14
경기도	안양시동안구	관양1동	관양1동제1투	4015	2909	1106	5	2904	1367	1523	0	3	9	2
경기도	안양시동안구	관양1동	관양1동제2투	4360	3426	934	13	3413	1800	1604	0	1	6	2
경기도	안양시동안구	관양1동	관양1동제3투	4122	3113	1009	6	3107	1496	1599	1	1	10	0
경기도	안양시동안구	관양1동	관양1동제4투	3662	2725	937	5	2720	1302	1407	0	1	9	1
경기도	안양시동안구	관양1동	관양1동제5투	2707	2091	616	5	2086	921	1158	0	4	2	1
경기도	안양시동안구	관양1동	관양1동제6투	3498	2679	819	8	2671	1237	1424	1	1	3	5
경기도	안양시동안구	관양1동	관양1동제7투	3748	3050	698	9	3041	1470	1563	0	2	5	1
경기도	안양시동안구	관양1동	관양1동제8투	2333	2020	313	2	2018	711	1301	1	1	2	2
경기도	안양시동안구	관양2동	소계	13231	9891	3340	26	9865	4486	5343	2	6	16	12
경기도	안양시동안구	관양2동	관양2동제1투	3447	2596	851	5	2591	1165	1415	1	1	5	4
경기도	안양시동안구	관양2동	관양2동제2투	3643	2602	1041	6	2596	1158	1431	0	1	3	3
경기도	안양시동안구	관양2동	관양2동제3투	2375	1665	710	3	1662	762	892	1	1	3	3
경기도	안양시동안구	관양2동	관양2동제4투	3766	3028	738	12	3016	1401	1605	0	3	5	2
경기도	안양시동안구	부림동	소계	19605	15832	3773	30	15802	6325	9422	0	11	33	11
경기도	안양시동안구	부림동	부림동제1투	3869	3040	829	7	3033	1192	1834	0	0	5	2
경기도	안양시동안구	부림동	부림동제2투	3361	2758	603	7	2751	1104	1633	0	5	8	1
경기도	안양시동안구	부림동	부림동제3투	3864	3214	650	8	3206	1434	1761	0	4	5	2
경기도	안양시동안구	부림동	부림동제4투	3791	3144	647	4	3140	1145	1984	0	2	5	4
경기도	안양시동안구	부림동	부림동제5투	4720	3676	1044	4	3672	1450	2210	0	0	10	2
경기도	안양시동안구	평촌동	소계	12049	10055	1994	15	10040	4532	5471	3	6	23	5
경기도	안양시동안구	평촌동	평촌동제1투	3526	2878	648	5	2873	1339	1531	0	0	2	1
경기도	안양시동안구	평촌동	평촌동제2투	3787	3169	618	5	3164	1454	1692	0	3	14	1
경기도	안양시동안구	평촌동	평촌동제3투	4736	4008	728	5	4003	1739	2248	3	3	7	3
경기도	안양시동안구	평안동	소계	18273	15403	2870	29	15374	6506	8806	7	3	44	8
경기도	안양시동안구	평안동	평안동제1투	3353	2743	610	10	2733	1054	1672	1	0	4	2
경기도	안양시동안구	평안동	평안동제2투	3807	3256	551	8	3248	1480	1761	1	0	4	2
경기도	안양시동안구	평안동	평안동제3투	3343	2785	558	5	2780	1097	1667	1	1	13	1
경기도	안양시동안구	평안동	평안동제4투	3374	2852	522	3	2849	1201	1636	3	1	7	1
경기도	안양시동안구	평안동	평안동제5투	4396	3767	629	3	3764	1674	2070	1	1	16	2
경기도	안양시동안구	귀인동	소계	12461	10402	2059	30	10372	5394	4939	2	2	30	5
경기도	안양시동안구	귀인동	귀인동제1투	3820	3233	587	12	3221	1822	1386	1	0	11	1
경기도	안양시동안구	귀인동	귀인동제2투	4648	3916	732	13	3903	2121	1766	1	2	10	3
경기도	안양시동안구	귀인동	귀인동제3투	3993	3253	740	5	3248	1451	1787	0	0	9	1
경기도	안양시동안구	호계1동	소계	14153	10256	3897	18	10238	5065	5150	2	4	5	12
경기도	안양시동안구	호계1동	호계1동제1투	3419	2293	1126	1	2292	1225	1064	1	0	0	2
경기도	안양시동안구	호계1동	호계1동제2투	3403	2534	869	7	2527	1225	1294	0	3	3	2
경기도	안양시동안구	호계1동	호계1동제3투	3497	2585	912	2	2583	1311	1265	0	1	1	5
경기도	안양시동안구	호계1동	호계1동제4투	3834	2844	990	8	2836	1304	1527	1	0	1	3
경기도	안양시동안구	호계2동	소계	21731	17272	4459	43	17229	8219	8948	3	13	30	16
경기도	안양시동안구	호계2동	호계2동제1투	4859	3686	1173	10	3676	1831	1832	0	4	4	5
경기도	안양시동안구	호계2동	호계2동제2투	4352	3473	879	8	3465	1780	1675	1	0	6	3
경기도	안양시동안구	호계2동	호계2동제3투	4191	3351	840	7	3344	1510	1827	1	0	5	1
경기도	안양시동안구	호계2동	호계2동제4투	4473	3609	864	9	3600	1761	1820	1	5	10	3
경기도	안양시동안구	호계2동	호계2동제5투	3856	3153	703	9	3144	1337	1794	0	4	5	4
경기도	안양시동안구	호계3동	소계	19502	15336	4166	32	15304	7461	7789	0	5	40	9
경기도	안양시동안구	호계3동	호계3동제1투	4417	3444	973	3	3441	1687	1742	0	2	8	2
경기도	안양시동안구	호계3동	호계3동제2투	4258	3086	1172	10	3076	1573	1493	0	1	6	3
경기도	안양시동안구	호계3동	호계3동제3투	3176	2491	685	6	2485	1108	1363	0	1	12	1
경기도	안양시동안구	호계3동	호계3동제4투	3485	2837	648	4	2833	1331	1491	0	1	8	2
경기도	안양시동안구	호계3동	호계3동제5투	4166	3478	688	9	3469	1762	1700	0	0	6	1
경기도	안양시동안구	범계동	소계	12216	10170	2046	16	10154	5131	4983	3	5	24	8
경기도	안양시동안구	범계동	범계동제1투	3503	2797	706	3	2794	1295	1491	0	1	5	2
경기도	안양시동안구	범계동	범계동제2투	3220	2654	566	3	2651	991	1651	1	1	5	2
경기도	안양시동안구	범계동	범계동제3투	2988	2572	416	4	2568	1558	994	1	2	11	2
경기도	안양시동안구	범계동	범계동제4투	2505	2147	358	6	2141	1287	847	1	1	3	2
경기도	안양시동안구	신촌동	소계	10782	8960	1822	19	8941	4236	4675	2	4	18	6
경기도	안양시동안구	신촌동	신촌동제1투	4682	3908	774	8	3900	1828	2058	0	1	11	2
경기도	안양시동안구	신촌동	신촌동제2투	4360	3581	779	7	3574	1700	1866	0	1	5	2
경기도	안양시동안구	신촌동	신촌동제3투	1740	1471	269	4	1467	708	751	2	2	2	2
경기도	안양시동안구	갈산동	소계	9301	7576	1725	20	7556	4114	3413	1	3	21	4
경기도	안양시동안구	갈산동	갈산동제1투	4146	3421	725	8	3413	2007	1390	1	1	12	2
경기도	안양시동안구	갈산동	갈산동제2투	2471	2086	385	6	2080	1209	865	0	1	4	1
경기도	안양시동안구	갈산동	갈산동제3투	2684	2069	615	6	2063	898	1158	0	1	5	1
경기도	부천시원미구	계	계	354869	268007	86862	727	267280	121498	144862	78	145	444	253
경기도	부천시원미구	재외투표	재외투표	1873	1318	555	10	1308	446	852	1	2	5	2
경기도	부천시원미구	국내부재자투표	국내부재자투표	8400	7881	519	121	7760	3543	4146	8	12	18	33
경기도	부천시원미구	심곡1동	소계	11720	7871	3849	24	7847	3566	4248	3	5	21	4
경기도	부천시원미구	심곡1동	심곡1동제1투	4569	3029	1540	7	3022	1391	1621	0	1	7	2
경기도	부천시원미구	심곡1동	심곡1동제2투	3521	2572	949	8	2564	1176	1376	2	2	7	1
경기도	부천시원미구	심곡1동	심곡1동제3투	3630	2270	1360	9	2261	999	1251	1	2	7	1
경기도	부천시원미구	심곡2동	소계	15236	9680	5556	23	9657	4237	5388	1	7	20	4
경기도	부천시원미구	심곡2동	심곡2동제1투	5699	3707	1992	10	3697	1582	2107	0	2	5	1
경기도	부천시원미구	심곡2동	심곡2동제2투	5033	3256	1777	5	3251	1437	1801	0	1	9	3
경기도	부천시원미구	심곡2동	심곡2동제3투	4504	2717	1787	8	2709	1218	1480	1	4	6	0
경기도	부천시원미구	심곡3동	소계	11884	8043	3841	23	8020	3718	4273	6	5	9	9
경기도	부천시원미구	심곡3동	심곡3동제1투	4488	2978	1510	5	2973	1385	1578	3	2	2	3
경기도	부천시원미구	심곡3동	심곡3동제2투	3930	2598	1332	9	2589	1237	1341	2	1	4	4
경기도	부천시원미구	심곡3동	심곡3동제3투	3466	2467	999	9	2458	1096	1354	1	2	3	2
경기도	부천시원미구	원미1동	소계	15016	10727	4289	25	10702	4983	5685	0	6	19	9
경기도	부천시원미구	원미1동	원미1동제1투	4885	3250	1635	9	3241	1479	1752	0	5	3	2
경기도	부천시원미구	원미1동	원미1동제2투	4591	3299	1292	7	3292	1608	1676	0	0	4	4
경기도	부천시원미구	원미1동	원미1동제3투	3002	2446	556	6	2440	1081	1349	0	1	7	2
경기도	부천시원미구	원미1동	원미1동제4투	2538	1732	806	3	1729	815	908	0	0	5	1
경기도	부천시원미구	원미2동	소계	12348	8908	3440	22	8886	4276	4576	2	2	13	17
경기도	부천시원미구	원미2동	원미2동제1투	4288	2923	1365	8	2915	1401	1497	1	1	5	10
경기도	부천시원미구	원미2동	원미2동제2투	4495	3472	1023	10	3462	1650	1805	1	0	2	4
경기도	부천시원미구	원미2동	원미2동제3투	3565	2513	1052	4	2509	1225	1274	0	1	6	3
경기도	부천시원미구	소사동	소계	8880	6128	2752	6	6122	2852	3252	2	2	7	7
경기도	부천시원미구	소사동	소사동제1투	4727	3278	1449	3	3275	1490	1770	2	2	6	5
경기도	부천시원미구	소사동	소사동제2투	4153	2850	1303	3	2847	1362	1482	0	0	1	2
경기도	부천시원미구	역곡1동	소계	15631	11936	3695	40	11896	5234	6623	1	6	22	10
경기도	부천시원미구	역곡1동	역곡1동제1투	5069	3719	1350	19	3700	1578	2117	0	0	3	2
경기도	부천시원미구	역곡1동	역곡1동제2투	4596	3538	1058	7	3531	1554	1965	1	2	7	2
경기도	부천시원미구	역곡1동	역곡1동제3투	2843	2277	566	7	2270	1017	1244	0	0	6	3
경기도	부천시원미구	역곡1동	역곡1동제4투	3123	2402	721	7	2395	1085	1297	0	4	6	3
경기도	부천시원미구	역곡2동	소계	16210	12223	3987	44	12179	5096	7044	4	10	17	8
경기도	부천시원미구	역곡2동	역곡2동제1투	5295	3986	1309	18	3968	1655	2299	3	2	6	3
경기도	부천시원미구	역곡2동	역곡2동제2투	5901	4635	1266	13	4622	1938	2673	0	5	3	3
경기도	부천시원미구	역곡2동	역곡2동제3투	5014	3602	1412	13	3589	1503	2072	1	3	8	2
경기도	부천시원미구	춘의동	소계	12447	8771	3676	32	8739	4171	4541	3	4	12	8
경기도	부천시원미구	춘의동	춘의동제1투	4334	2940	1394	11	2929	1384	1536	1	1	5	2
경기도	부천시원미구	춘의동	춘의동제2투	2881	2020	861	10	2010	998	1007	1	0	1	3
경기도	부천시원미구	춘의동	춘의동제3투	5232	3811	1421	11	3800	1789	1998	1	3	6	3
경기도	부천시원미구	도당동	소계	20050	14305	5745	37	14268	6702	7519	5	6	20	16
경기도	부천시원미구	도당동	도당동제1투	5850	4107	1743	10	4097	1827	2257	1	0	8	4
경기도	부천시원미구	도당동	도당동제2투	3882	2930	952	12	2918	1361	1547	2	1	4	3
경기도	부천시원미구	도당동	도당동제3투	4064	2974	1090	7	2967	1343	1613	1	4	2	4
경기도	부천시원미구	도당동	도당동제4투	3745	2609	1136	5	2604	1300	1295	0	1	3	5
경기도	부천시원미구	도당동	도당동제5투	2509	1685	824	3	1682	871	807	1	0	3	0
경기도	부천시원미구	약대동	소계	11156	8267	2889	19	8248	3693	4527	5	7	12	4
경기도	부천시원미구	약대동	약대동제1투	4895	3683	1212	5	3678	1637	2034	1	2	2	2
경기도	부천시원미구	약대동	약대동제2투	2886	2121	765	7	2114	947	1155	2	3	5	2
경기도	부천시원미구	약대동	약대동제3투	3375	2463	912	7	2456	1109	1338	2	2	5	0
경기도	부천시원미구	중동	소계	20740	15474	5266	37	15437	7283	8106	8	8	19	13
경기도	부천시원미구	중동	중동제1투	4411	2982	1429	7	2975	1453	1511	1	2	3	5
경기도	부천시원미구	중동	중동제2투	4175	3289	886	11	3278	1493	1769	2	1	10	3
경기도	부천시원미구	중동	중동제3투	4059	2921	1138	9	2912	1392	1512	2	1	4	1
경기도	부천시원미구	중동	중동제4투	3492	2440	1052	3	2437	1135	1294	1	2	2	3
경기도	부천시원미구	중동	중동제5투	4603	3842	761	7	3835	1810	2020	2	2	0	1
경기도	부천시원미구	중1동	소계	27137	21080	6057	45	21035	9177	11783	7	18	33	17
경기도	부천시원미구	중1동	중1동제1투	4061	2937	1124	2	2935	1223	1695	3	5	6	3
경기도	부천시원미구	중1동	중1동제2투	4262	3560	702	8	3552	1513	2027	0	5	4	3
경기도	부천시원미구	중1동	중1동제3투	4700	3161	1539	6	3155	1288	1854	1	2	5	5
경기도	부천시원미구	중1동	중1동제4투	2601	2149	452	4	2145	1039	1099	0	2	3	2
경기도	부천시원미구	중1동	중1동제5투	3277	2705	572	7	2698	1287	1403	2	2	4	0
경기도	부천시원미구	중1동	중1동제6투	3345	2519	826	9	2510	1047	1458	0	0	4	1
경기도	부천시원미구	중1동	중1동제7투	4891	4049	842	9	4040	1780	2247	1	2	7	3
경기도	부천시원미구	중2동	소계	25257	20051	5206	31	20020	10128	9839	3	7	33	10
경기도	부천시원미구	중2동	중2동제1투	5187	3913	1274	9	3904	1793	2103	1	2	2	3
경기도	부천시원미구	중2동	중2동제2투	3176	2593	583	6	2587	1542	1034	0	1	9	1
경기도	부천시원미구	중2동	중2동제3투	3807	2985	822	6	2979	1515	1453	0	1	10	0
경기도	부천시원미구	중2동	중2동제4투	5237	4237	1000	4	4233	2209	2016	0	1	6	1
경기도	부천시원미구	중2동	중2동제5투	3909	3127	782	4	3123	1533	1580	1	1	6	2
경기도	부천시원미구	중2동	중2동제6투	3941	3196	745	2	3194	1536	1653	1	1	0	3
경기도	부천시원미구	중3동	소계	19823	15179	4644	31	15148	6947	8149	3	10	26	13
경기도	부천시원미구	중3동	중3동제1투	3425	2527	898	2	2525	1186	1329	1	4	3	2
경기도	부천시원미구	중3동	중3동제2투	4286	3497	789	9	3488	1875	1605	0	1	6	1
경기도	부천시원미구	중3동	중3동제3투	4230	3137	1093	5	3132	1277	1845	0	2	5	3
경기도	부천시원미구	중3동	중3동제4투	4573	3669	904	4	3665	1531	2123	0	2	7	2
경기도	부천시원미구	중3동	중3동제5투	3309	2349	960	11	2338	1078	1247	2	1	5	5
경기도	부천시원미구	중4동	소계	17148	13392	3756	27	13365	5940	7380	6	4	28	7
경기도	부천시원미구	중4동	중4동제1투	5162	4190	972	7	4183	2131	2036	0	3	10	3
경기도	부천시원미구	중4동	중4동제2투	4083	2992	1091	6	2986	1342	1633	3	1	5	2
경기도	부천시원미구	중4동	중4동제3투	4174	3242	932	10	3232	1270	1956	2	0	3	1
경기도	부천시원미구	중4동	중4동제4투	3729	2968	761	4	2964	1197	1755	1	0	10	1
경기도	부천시원미구	상동	소계	16559	12328	4231	30	12298	6042	6201	4	3	31	17
경기도	부천시원미구	상동	상동제1투	4067	3269	798	7	3262	1775	1473	2	1	9	2
경기도	부천시원미구	상동	상동제2투	4716	3559	1157	8	3551	1712	1819	0	1	11	8
경기도	부천시원미구	상동	상동제3투	3633	2551	1082	9	2542	1173	1359	0	0	7	3
경기도	부천시원미구	상동	상동제4투	4143	2949	1194	6	2943	1382	1550	2	1	4	4
경기도	부천시원미구	상1동	소계	20554	16461	4093	31	16430	6512	9874	3	8	16	17
경기도	부천시원미구	상1동	상1동제1투	4823	3916	907	12	3904	1556	2331	1	2	10	4
경기도	부천시원미구	상1동	상1동제2투	5550	4314	1236	6	4308	1612	2690	0	1	2	3
경기도	부천시원미구	상1동	상1동제3투	4491	3611	880	7	3604	1438	2158	1	2	2	3
경기도	부천시원미구	상1동	상1동제4투	5690	4620	1070	6	4614	1906	2695	1	3	2	7
경기도	부천시원미구	상2동	소계	22909	18560	4349	29	18531	7800	10679	1	11	22	18
경기도	부천시원미구	상2동	상2동제1투	2811	2303	508	7	2296	983	1309	0	2	1	1
경기도	부천시원미구	상2동	상2동제2투	5367	4363	1004	9	4354	2016	2327	1	1	4	5
경기도	부천시원미구	상2동	상2동제3투	5115	4020	1095	3	4017	1868	2138	0	2	3	6
경기도	부천시원미구	상2동	상2동제4투	4256	3572	684	6	3566	1611	1943	0	3	6	3
경기도	부천시원미구	상2동	상2동제5투	5360	4302	1058	4	4298	1322	2962	0	3	8	3
경기도	부천시원미구	상3동	소계	23891	19424	4467	40	19384	9152	10177	2	2	41	10
경기도	부천시원미구	상3동	상3동제1투	5075	3972	1103	9	3963	1843	2111	0	0	6	3
경기도	부천시원미구	상3동	상3동제2투	4917	4007	910	9	3998	1650	2334	0	1	11	2
경기도	부천시원미구	상3동	상3동제3투	4750	3849	901	13	3836	2010	1811	1	0	11	3
경기도	부천시원미구	상3동	상3동제4투	4579	3785	794	5	3780	2033	1740	0	0	7	0
경기도	부천시원미구	상3동	상3동제5투	4570	3811	759	4	3807	1616	2181	1	1	6	2
경기도	부천시소사구	계	계	185997	140133	45864	488	139645	64835	74327	34	106	217	126
경기도	부천시소사구	재외투표	재외투표	974	691	283	6	685	261	420	2	1	1	0
경기도	부천시소사구	국내부재자투표	국내부재자투표	3984	3743	241	102	3641	1736	1868	4	9	9	15
경기도	부천시소사구	심곡본1동	소계	16752	11430	5322	38	11392	5366	5990	2	9	19	6
경기도	부천시소사구	심곡본1동	심곡본1동제1투	4912	3203	1709	9	3194	1521	1658	0	3	9	3
경기도	부천시소사구	심곡본1동	심곡본1동제2투	3871	2770	1101	9	2761	1254	1501	0	2	3	1
경기도	부천시소사구	심곡본1동	심곡본1동제3투	4421	3114	1307	9	3105	1470	1628	1	2	2	2
경기도	부천시소사구	심곡본1동	심곡본1동제4투	3548	2343	1205	11	2332	1121	1203	1	2	5	0
경기도	부천시소사구	심곡본동	소계	15950	11179	4771	27	11152	5519	5590	3	8	22	10
경기도	부천시소사구	심곡본동	심곡본동제1투	3938	2641	1297	10	2631	1310	1314	1	0	3	3
경기도	부천시소사구	심곡본동	심곡본동제2투	3942	2673	1269	8	2665	1342	1311	1	2	4	5
경기도	부천시소사구	심곡본동	심곡본동제3투	4138	2874	1264	3	2871	1400	1459	1	5	6	0
경기도	부천시소사구	심곡본동	심곡본동제4투	3932	2991	941	6	2985	1467	1506	0	1	9	2
경기도	부천시소사구	소사본동	소계	20908	14778	6130	46	14732	7272	7418	4	5	19	14
경기도	부천시소사구	소사본동	소사본동제1투	4419	3179	1240	9	3170	1629	1533	1	1	2	4
경기도	부천시소사구	소사본동	소사본동제2투	3375	2305	1070	9	2296	1154	1133	1	0	6	2
경기도	부천시소사구	소사본동	소사본동제3투	4107	2912	1195	8	2904	1398	1499	1	0	4	2
경기도	부천시소사구	소사본동	소사본동제4투	5299	3672	1627	9	3663	1786	1870	0	3	2	2
경기도	부천시소사구	소사본동	소사본동제5투	3708	2710	998	11	2699	1305	1383	1	1	5	4
경기도	부천시소사구	소사본3동	소계	27188	21205	5983	63	21142	9772	11309	1	13	33	14
경기도	부천시소사구	소사본3동	소사본3동제1투	3566	2657	909	13	2644	1300	1331	0	3	7	3
경기도	부천시소사구	소사본3동	소사본3동제2투	3652	2845	807	11	2834	1328	1499	0	3	1	3
경기도	부천시소사구	소사본3동	소사본3동제3투	4653	3676	977	11	3665	1618	2034	1	1	8	3
경기도	부천시소사구	소사본3동	소사본3동제4투	3573	2333	1240	6	2327	1173	1150	0	1	2	1
경기도	부천시소사구	소사본3동	소사본3동제5투	3553	2952	601	12	2940	1278	1658	0	0	2	2
경기도	부천시소사구	소사본3동	소사본3동제6투	3626	2994	632	2	2992	1549	1432	0	2	8	1
경기도	부천시소사구	소사본3동	소사본3동제7투	4565	3748	817	8	3740	1526	2205	0	3	5	1
경기도	부천시소사구	범박동	소계	17863	14502	3361	27	14475	6734	7682	1	15	23	20
경기도	부천시소사구	범박동	범박동제1투	5158	4075	1083	7	4068	1710	2347	0	2	6	3
경기도	부천시소사구	범박동	범박동제2투	3651	3128	523	2	3126	1472	1645	0	1	2	6
경기도	부천시소사구	범박동	범박동제3투	1222	804	418	3	801	444	353	0	1	1	2
경기도	부천시소사구	범박동	범박동제4투	3796	3127	669	6	3121	1399	1709	1	4	5	3
경기도	부천시소사구	범박동	범박동제5투	4036	3368	668	9	3359	1709	1628	0	7	9	6
경기도	부천시소사구	괴안동	소계	18032	13673	4359	42	13631	6181	7405	6	4	28	7
경기도	부천시소사구	괴안동	괴안동제1투	3880	2873	1007	10	2863	1341	1516	1	0	4	1
경기도	부천시소사구	괴안동	괴안동제2투	3660	2652	1008	12	2640	1195	1432	2	0	8	3
경기도	부천시소사구	괴안동	괴안동제3투	3891	2975	916	9	2966	1262	1694	1	4	5	0
경기도	부천시소사구	괴안동	괴안동제4투	2849	2124	725	9	2115	1001	1108	1	0	2	3
경기도	부천시소사구	괴안동	괴안동제5투	3752	3049	703	2	3047	1382	1655	1	0	9	0
경기도	부천시소사구	역곡3동	소계	22190	16599	5591	64	16535	7223	9262	6	12	17	15
경기도	부천시소사구	역곡3동	역곡3동제1투	3587	2548	1039	11	2537	1160	1372	3	0	1	1
경기도	부천시소사구	역곡3동	역곡3동제2투	4064	3030	1034	11	3019	1266	1743	0	2	4	4
경기도	부천시소사구	역곡3동	역곡3동제3투	3403	2500	903	10	2490	1057	1422	1	1	5	4
경기도	부천시소사구	역곡3동	역곡3동제4투	3779	2878	901	15	2863	1318	1534	2	5	3	1
경기도	부천시소사구	역곡3동	역곡3동제5투	3778	2996	782	7	2989	1269	1712	0	4	2	2
경기도	부천시소사구	역곡3동	역곡3동제6투	3579	2647	932	10	2637	1153	1479	0	0	2	3
경기도	부천시소사구	송내1동	소계	19794	15376	4418	25	15351	6885	8415	4	12	25	10
경기도	부천시소사구	송내1동	송내1동제1투	4119	2963	1156	4	2959	1269	1686	0	1	3	0
경기도	부천시소사구	송내1동	송내1동제2투	2873	2195	678	2	2193	949	1240	1	1	1	1
경기도	부천시소사구	송내1동	송내1동제3투	2760	2335	425	4	2331	1038	1283	0	3	5	2
경기도	부천시소사구	송내1동	송내1동제4투	4027	3248	779	8	3240	1480	1749	2	4	3	2
경기도	부천시소사구	송내1동	송내1동제5투	2729	2169	560	1	2168	980	1183	0	2	1	2
경기도	부천시소사구	송내1동	송내1동제6투	3286	2466	820	6	2460	1169	1274	1	1	12	3
경기도	부천시소사구	송내2동	소계	22362	16957	5405	48	16909	7886	8968	1	18	21	15
경기도	부천시소사구	송내2동	송내2동제1투	4065	2862	1203	7	2855	1328	1511	1	6	6	3
경기도	부천시소사구	송내2동	송내2동제2투	3829	2694	1135	9	2685	1379	1298	0	1	3	4
경기도	부천시소사구	송내2동	송내2동제3투	3983	3131	852	8	3123	1407	1706	0	1	5	4
경기도	부천시소사구	송내2동	송내2동제4투	4741	3672	1069	12	3660	1697	1953	0	7	1	2
경기도	부천시소사구	송내2동	송내2동제5투	3357	2544	813	3	2541	1184	1351	0	1	5	0
경기도	부천시소사구	송내2동	송내2동제6투	2387	2054	333	9	2045	891	1149	0	2	1	2
경기도	부천시오정구	계	계	151739	109015	42724	349	108666	50291	57987	35	54	171	128
경기도	부천시오정구	재외투표	재외투표	568	375	193	1	374	149	224	0	0	1	0
경기도	부천시오정구	국내부재자투표	국내부재자투표	3318	3147	171	53	3094	1449	1614	2	9	6	14
경기도	부천시오정구	성곡동	소계	34862	25609	9253	76	25533	11668	13771	5	7	52	30
경기도	부천시오정구	성곡동	성곡동제1투	4210	2846	1364	11	2835	1318	1506	0	0	8	3
경기도	부천시오정구	성곡동	성곡동제2투	3910	2839	1071	10	2829	1332	1493	2	0	1	1
경기도	부천시오정구	성곡동	성곡동제3투	3805	2627	1178	8	2619	1184	1424	0	0	7	4
경기도	부천시오정구	성곡동	성곡동제4투	3845	2774	1071	10	2764	1308	1442	1	2	9	2
경기도	부천시오정구	성곡동	성곡동제5투	2809	2028	781	5	2023	881	1135	0	0	2	5
경기도	부천시오정구	성곡동	성곡동제6투	3559	2539	1020	8	2531	1196	1327	0	1	4	3
경기도	부천시오정구	성곡동	성곡동제7투	2096	1634	462	4	1630	833	791	0	0	4	2
경기도	부천시오정구	성곡동	성곡동제8투	3177	2319	858	8	2311	1076	1227	0	1	6	1
경기도	부천시오정구	성곡동	성곡동제9투	3171	2513	658	4	2509	1162	1332	1	2	6	6
경기도	부천시오정구	성곡동	성곡동제10투	4280	3490	790	8	3482	1378	2094	1	1	5	3
경기도	부천시오정구	원종1동	소계	19743	13967	5776	36	13931	6618	7263	8	3	18	21
경기도	부천시오정구	원종1동	원종1동제1투	4169	2853	1316	9	2844	1341	1497	3	0	1	2
경기도	부천시오정구	원종1동	원종1동제2투	4205	3257	948	8	3249	1574	1662	1	0	7	5
경기도	부천시오정구	원종1동	원종1동제3투	3843	2664	1179	9	2655	1265	1382	1	0	3	4
경기도	부천시오정구	원종1동	원종1동제4투	3802	2713	1089	5	2708	1248	1446	2	1	2	9
경기도	부천시오정구	원종1동	원종1동제5투	3724	2480	1244	5	2475	1190	1276	1	2	5	1
경기도	부천시오정구	원종2동	소계	19353	13862	5491	41	13821	6210	7552	8	9	22	20
경기도	부천시오정구	원종2동	원종2동제1투	4368	2981	1387	8	2973	1382	1580	1	5	2	3
경기도	부천시오정구	원종2동	원종2동제2투	4127	3135	992	8	3127	1347	1765	1	2	9	3
경기도	부천시오정구	원종2동	원종2동제3투	3177	2400	777	9	2391	1043	1336	4	0	4	4
경기도	부천시오정구	원종2동	원종2동제4투	3740	2580	1160	8	2572	1194	1368	1	1	4	4
경기도	부천시오정구	원종2동	원종2동제5투	3941	2766	1175	8	2758	1244	1503	1	1	3	6
경기도	부천시오정구	고강본동	소계	25635	17816	7819	63	17753	7984	9720	4	10	24	11
경기도	부천시오정구	고강본동	고강본동제1투	4956	3373	1583	6	3367	1486	1867	1	3	5	5
경기도	부천시오정구	고강본동	고강본동제2투	4329	2936	1393	12	2924	1314	1598	0	2	7	3
경기도	부천시오정구	고강본동	고강본동제3투	4387	3078	1309	15	3063	1379	1679	1	1	3	0
경기도	부천시오정구	고강본동	고강본동제4투	4829	3449	1380	10	3439	1529	1903	0	2	4	1
경기도	부천시오정구	고강본동	고강본동제5투	4395	3012	1383	9	3003	1343	1653	2	1	3	1
경기도	부천시오정구	고강본동	고강본동제6투	2739	1968	771	11	1957	933	1020	0	1	2	1
경기도	부천시오정구	고강1동	소계	13262	9345	3917	20	9325	4250	5051	1	3	12	8
경기도	부천시오정구	고강1동	고강1동제1투	3096	2002	1094	7	1995	887	1103	1	2	1	1
경기도	부천시오정구	고강1동	고강1동제2투	3950	2837	1113	5	2832	1288	1537	0	1	5	1
경기도	부천시오정구	고강1동	고강1동제3투	2670	1972	698	0	1972	924	1043	0	0	3	2
경기도	부천시오정구	고강1동	고강1동제4투	3546	2534	1012	8	2526	1151	1368	0	0	3	4
경기도	부천시오정구	오정동	소계	18184	13353	4831	35	13318	6378	6901	3	7	16	13
경기도	부천시오정구	오정동	오정동제1투	4702	3371	1331	12	3359	1582	1767	0	2	4	4
경기도	부천시오정구	오정동	오정동제2투	5255	4156	1099	11	4145	1821	2311	1	2	7	3
경기도	부천시오정구	오정동	오정동제3투	3632	2592	1040	3	2589	1320	1263	0	0	4	2
경기도	부천시오정구	오정동	오정동제4투	4108	2895	1213	8	2887	1418	1460	2	2	1	4
경기도	부천시오정구	오정동	오정동제5투	487	339	148	1	338	237	100	0	1	0	0
경기도	부천시오정구	신흥동	소계	16814	11541	5273	24	11517	5585	5891	4	6	20	11
경기도	부천시오정구	신흥동	신흥동제1투	3111	2014	1097	3	2011	1012	990	0	2	3	4
경기도	부천시오정구	신흥동	신흥동제2투	5079	3640	1439	10	3630	1618	2006	0	0	5	1
경기도	부천시오정구	신흥동	신흥동제3투	3292	2278	1014	1	2277	1163	1105	0	1	6	2
경기도	부천시오정구	신흥동	신흥동제4투	2691	1791	900	7	1784	899	873	3	2	4	3
경기도	부천시오정구	신흥동	신흥동제5투	2641	1818	823	3	1815	893	917	1	1	2	1
경기도	광명시	계	계	278075	216922	61153	683	216239	94631	120851	60	132	354	211
경기도	광명시	재외투표	재외투표	1447	1033	414	4	1029	402	621	0	1	2	3
경기도	광명시	국내부재자투표	국내부재자투표	5767	5439	328	83	5356	2471	2834	5	14	13	19
경기도	광명시	광명1동	소계	12745	9223	3522	39	9184	4225	4924	3	2	20	10
경기도	광명시	광명1동	광명1동제1투	4684	3346	1338	13	3333	1555	1762	1	0	8	7
경기도	광명시	광명1동	광명1동제2투	3973	2854	1119	7	2847	1366	1471	1	1	7	1
경기도	광명시	광명1동	광명1동제3투	4088	3023	1065	19	3004	1304	1691	1	1	5	2
경기도	광명시	광명2동	소계	10149	7385	2764	40	7345	3484	3833	1	5	10	12
경기도	광명시	광명2동	광명2동제1투	3374	2342	1032	16	2326	1145	1173	0	2	2	4
경기도	광명시	광명2동	광명2동제2투	3670	2712	958	11	2701	1264	1428	0	0	4	5
경기도	광명시	광명2동	광명2동제3투	3105	2331	774	13	2318	1075	1232	1	3	4	3
경기도	광명시	광명3동	소계	9588	6872	2716	19	6853	3030	3811	0	3	3	6
경기도	광명시	광명3동	광명3동제1투	3551	2479	1072	4	2475	1141	1331	0	0	1	2
경기도	광명시	광명3동	광명3동제2투	2915	2080	835	10	2070	902	1164	0	1	0	3
경기도	광명시	광명3동	광명3동제3투	3122	2313	809	5	2308	987	1316	0	2	2	1
경기도	광명시	광명4동	소계	13435	10245	3190	24	10221	4709	5473	4	2	26	7
경기도	광명시	광명4동	광명4동제1투	4306	3025	1281	12	3013	1392	1611	0	1	6	3
경기도	광명시	광명4동	광명4동제2투	3652	2707	945	3	2704	1180	1512	1	0	9	2
경기도	광명시	광명4동	광명4동제3투	5477	4513	964	9	4504	2137	2350	3	1	11	2
경기도	광명시	광명5동	소계	13215	9689	3526	23	9666	4284	5349	3	7	12	11
경기도	광명시	광명5동	광명5동제1투	4483	3151	1332	8	3143	1411	1721	0	3	2	6
경기도	광명시	광명5동	광명5동제2투	4543	3556	987	4	3552	1504	2037	2	4	3	2
경기도	광명시	광명5동	광명5동제3투	4189	2982	1207	11	2971	1369	1591	1	0	7	3
경기도	광명시	광명6동	소계	12540	9594	2946	26	9568	4458	5090	1	1	8	10
경기도	광명시	광명6동	광명6동제1투	3261	2604	657	5	2599	1126	1468	0	1	2	2
경기도	광명시	광명6동	광명6동제2투	5149	3878	1271	9	3869	1751	2113	1	0	2	2
경기도	광명시	광명6동	광명6동제3투	3379	2540	839	11	2529	1219	1301	0	0	4	5
경기도	광명시	광명6동	광명6동제4투	751	572	179	1	571	362	208	0	0	0	1
경기도	광명시	광명7동	소계	20749	15433	5316	40	15393	6984	8357	5	11	22	14
경기도	광명시	광명7동	광명7동제1투	3848	2753	1095	13	2740	1207	1520	3	2	6	2
경기도	광명시	광명7동	광명7동제2투	3007	2059	948	4	2055	941	1109	0	1	0	4
경기도	광명시	광명7동	광명7동제3투	3384	2551	833	2	2549	1127	1418	0	2	2	0
경기도	광명시	광명7동	광명7동제4투	3230	2365	865	13	2352	1073	1269	1	0	3	6
경기도	광명시	광명7동	광명7동제5투	3517	2836	681	3	2833	1302	1519	0	4	8	0
경기도	광명시	광명7동	광명7동제6투	3763	2869	894	5	2864	1334	1522	1	2	3	2
경기도	광명시	철산1동	소계	10586	8484	2102	14	8470	3584	4862	2	4	15	3
경기도	광명시	철산1동	철산1동제1투	4117	3342	775	4	3338	1369	1958	2	2	6	1
경기도	광명시	철산1동	철산1동제2투	2075	1554	521	6	1548	753	793	0	0	2	0
경기도	광명시	철산1동	철산1동제3투	4394	3588	806	4	3584	1462	2111	0	2	7	2
경기도	광명시	철산2동	소계	14206	10487	3719	31	10456	4591	5836	4	4	13	8
경기도	광명시	철산2동	철산2동제1투	4449	3588	861	10	3578	1506	2062	1	2	5	2
경기도	광명시	철산2동	철산2동제2투	3302	2383	919	8	2375	991	1378	0	1	3	2
경기도	광명시	철산2동	철산2동제3투	2747	1936	811	7	1929	919	1004	1	0	3	2
경기도	광명시	철산2동	철산2동제4투	3708	2580	1128	6	2574	1175	1392	2	1	2	2
경기도	광명시	철산3동	소계	28333	23614	4719	48	23566	10786	12696	9	10	45	20
경기도	광명시	철산3동	철산3동제1투	3275	2615	660	8	2607	1203	1392	0	1	9	2
경기도	광명시	철산3동	철산3동제2투	3177	2670	507	4	2666	1282	1372	3	2	5	2
경기도	광명시	철산3동	철산3동제3투	2622	2024	598	3	2021	833	1185	0	0	2	1
경기도	광명시	철산3동	철산3동제4투	4293	3563	730	10	3553	1583	1956	2	2	7	3
경기도	광명시	철산3동	철산3동제5투	2703	2211	492	5	2206	995	1198	0	1	8	4
경기도	광명시	철산3동	철산3동제6투	4193	3597	596	7	3590	1712	1867	2	2	5	2
경기도	광명시	철산3동	철산3동제7투	2238	1955	283	5	1950	837	1107	2	0	3	1
경기도	광명시	철산3동	철산3동제8투	2798	2415	383	3	2412	1150	1256	0	0	4	2
경기도	광명시	철산3동	철산3동제9투	3034	2564	470	3	2561	1191	1363	0	2	2	3
경기도	광명시	철산4동	소계	12207	9481	2726	29	9452	3719	5701	0	2	23	7
경기도	광명시	철산4동	철산4동제1투	3607	2413	1194	10	2403	1085	1310	0	1	5	2
경기도	광명시	철산4동	철산4동제2투	2438	1942	496	8	1934	608	1320	0	0	5	1
경기도	광명시	철산4동	철산4동제3투	2803	2398	405	8	2390	958	1421	0	1	8	2
경기도	광명시	철산4동	철산4동제4투	3359	2728	631	3	2725	1068	1650	0	0	5	2
경기도	광명시	하안1동	소계	20911	16758	4153	46	16712	7131	9516	4	6	38	17
경기도	광명시	하안1동	하안1동제1투	2996	2228	768	4	2224	874	1340	0	0	4	6
경기도	광명시	하안1동	하안1동제2투	3528	2929	599	7	2922	1155	1756	0	0	7	4
경기도	광명시	하안1동	하안1동제3투	4132	2912	1220	12	2900	1370	1516	1	3	7	3
경기도	광명시	하안1동	하안1동제4투	3563	3006	557	7	2999	1322	1667	1	0	9	0
경기도	광명시	하안1동	하안1동제5투	3246	2772	474	7	2765	1175	1579	1	1	6	3
경기도	광명시	하안1동	하안1동제6투	3446	2911	535	9	2902	1235	1658	1	2	5	1
경기도	광명시	하안2동	소계	12628	9939	2689	28	9911	3731	6151	2	9	8	10
경기도	광명시	하안2동	하안2동제1투	2820	2120	700	6	2114	828	1273	0	4	4	5
경기도	광명시	하안2동	하안2동제2투	3000	2476	524	6	2470	915	1547	2	3	2	1
경기도	광명시	하안2동	하안2동제3투	3288	2559	729	7	2552	1006	1544	0	1	0	1
경기도	광명시	하안2동	하안2동제4투	3520	2784	736	9	2775	982	1787	0	1	2	3
경기도	광명시	하안3동	소계	18278	14439	3839	42	14397	6080	8267	4	6	25	15
경기도	광명시	하안3동	하안3동제1투	3938	3138	800	11	3127	1271	1850	0	2	2	2
경기도	광명시	하안3동	하안3동제2투	2230	1709	521	2	1707	641	1064	1	0	1	0
경기도	광명시	하안3동	하안3동제3투	2946	2415	531	7	2408	910	1494	1	0	1	2
경기도	광명시	하안3동	하안3동제4투	3035	2460	575	3	2457	1014	1435	0	0	7	1
경기도	광명시	하안3동	하안3동제5투	2494	2065	429	4	2061	806	1249	0	2	3	1
경기도	광명시	하안3동	하안3동제6투	1885	1352	533	6	1346	760	575	0	1	4	6
경기도	광명시	하안3동	하안3동제7투	1750	1300	450	9	1291	678	600	2	1	7	3
경기도	광명시	하안4동	소계	10274	8401	1873	19	8382	3173	5178	2	9	13	7
경기도	광명시	하안4동	하안4동제1투	3442	2812	630	5	2807	1059	1739	2	2	5	0
경기도	광명시	하안4동	하안4동제2투	3303	2762	541	9	2753	1015	1726	0	3	5	4
경기도	광명시	하안4동	하안4동제3투	3529	2827	702	5	2822	1099	1713	0	4	3	3
경기도	광명시	소하1동	소계	23547	19000	4547	49	18951	7881	11013	6	10	31	10
경기도	광명시	소하1동	소하1동제1투	3741	2880	861	5	2875	1106	1758	0	2	9	0
경기도	광명시	소하1동	소하1동제2투	2525	2099	426	7	2092	866	1222	0	3	1	0
경기도	광명시	소하1동	소하1동제3투	3336	2741	595	4	2737	1149	1579	0	3	3	3
경기도	광명시	소하1동	소하1동제4투	3506	2675	831	9	2666	1015	1642	2	0	4	3
경기도	광명시	소하1동	소하1동제5투	3897	3133	764	6	3127	1456	1663	2	1	3	2
경기도	광명시	소하1동	소하1동제6투	2518	2128	390	5	2123	903	1216	1	0	3	0
경기도	광명시	소하1동	소하1동제7투	4024	3344	680	13	3331	1386	1933	1	1	8	2
경기도	광명시	소하2동	소계	25059	19610	5449	74	19536	8745	10721	4	25	21	20
경기도	광명시	소하2동	소하2동제1투	2135	1508	627	3	1505	768	732	0	1	2	2
경기도	광명시	소하2동	소하2동제2투	2746	2108	638	11	2097	856	1229	1	4	4	3
경기도	광명시	소하2동	소하2동제3투	2705	2035	670	5	2030	931	1094	0	1	2	2
경기도	광명시	소하2동	소하2동제4투	4017	3212	805	15	3197	1524	1666	0	0	3	4
경기도	광명시	소하2동	소하2동제5투	426	315	111	1	314	184	128	0	0	1	1
경기도	광명시	소하2동	소하2동제6투	3496	2702	794	8	2694	1253	1429	1	6	2	3
경기도	광명시	소하2동	소하2동제7투	3377	2753	624	7	2746	1078	1654	1	7	3	3
경기도	광명시	소하2동	소하2동제8투	3095	2642	453	12	2630	1114	1507	1	5	2	1
경기도	광명시	소하2동	소하2동제9투	3062	2335	727	12	2323	1037	1282	0	1	2	1
경기도	광명시	학온동	소계	2411	1796	615	5	1791	1163	618	1	1	6	2
경기도	광명시	학온동	학온동제1투	1253	927	326	3	924	635	284	1	0	2	2
경기도	광명시	학온동	학온동제2투	1158	869	289	2	867	528	334	0	1	4	0
경기도	평택시	계	계	333774	239544	94230	773	238771	135781	101951	83	181	424	351
경기도	평택시	재외투표	재외투표	1162	780	382	4	776	331	437	0	2	5	1
경기도	평택시	국내부재자투표	국내부재자투표	8414	7915	499	124	7791	4223	3477	11	17	25	38
경기도	평택시	팽성읍	소계	24820	16257	8563	57	16200	10382	5755	9	7	26	21
경기도	평택시	팽성읍	팽성읍제1투	3458	2467	991	10	2457	1557	889	1	3	5	2
경기도	평택시	팽성읍	팽성읍제2투	3662	2612	1050	9	2603	1466	1130	0	2	5	0
경기도	평택시	팽성읍	팽성읍제3투	4683	2316	2367	9	2307	1440	861	1	1	1	3
경기도	평택시	팽성읍	팽성읍제4투	1978	1333	645	10	1323	876	437	2	1	3	4
경기도	평택시	팽성읍	팽성읍제5투	2474	1864	610	7	1857	1297	551	3	0	2	4
경기도	평택시	팽성읍	팽성읍제6투	1847	1267	580	0	1267	856	405	1	0	3	2
경기도	평택시	팽성읍	팽성읍제7투	3345	2182	1163	6	2176	1451	717	0	0	3	5
경기도	평택시	팽성읍	팽성읍제8투	3373	2216	1157	6	2210	1439	765	1	0	4	1
경기도	평택시	안중읍	소계	27231	20090	7141	75	20015	9930	9992	10	20	44	19
경기도	평택시	안중읍	안중읍제1투	2963	1883	1080	4	1879	1180	697	1	0	0	1
경기도	평택시	안중읍	안중읍제2투	3401	2334	1067	13	2321	1526	788	0	2	4	1
경기도	평택시	안중읍	안중읍제3투	1990	1399	591	7	1392	756	628	1	0	4	3
경기도	평택시	안중읍	안중읍제4투	2591	1794	797	5	1789	883	895	2	1	5	3
경기도	평택시	안중읍	안중읍제5투	2469	1839	630	8	1831	780	1043	1	2	4	1
경기도	평택시	안중읍	안중읍제6투	2448	1694	754	8	1686	1015	664	0	0	4	3
경기도	평택시	안중읍	안중읍제7투	4725	3817	908	10	3807	1610	2177	2	4	11	3
경기도	평택시	안중읍	안중읍제8투	2960	2358	602	10	2348	948	1385	2	4	7	2
경기도	평택시	안중읍	안중읍제9투	3684	2972	712	10	2962	1232	1715	1	7	5	2
경기도	평택시	포승읍	소계	19338	12610	6728	33	12577	6999	5522	3	8	18	27
경기도	평택시	포승읍	포승읍제1투	2801	1789	1012	4	1785	1054	723	0	2	3	3
경기도	평택시	포승읍	포승읍제2투	1407	1004	403	6	998	667	325	0	0	2	4
경기도	평택시	포승읍	포승읍제3투	5029	3223	1806	6	3217	1854	1350	1	1	2	9
경기도	평택시	포승읍	포승읍제4투	2602	1775	827	7	1768	1010	748	2	0	4	4
경기도	평택시	포승읍	포승읍제5투	4840	2936	1904	4	2932	1261	1665	0	4	2	0
경기도	평택시	포승읍	포승읍제6투	2659	1883	776	6	1877	1153	711	0	1	5	7
경기도	평택시	진위면	소계	10754	7594	3160	13	7581	4361	3191	3	3	11	12
경기도	평택시	진위면	진위면제1투	3386	2366	1020	4	2362	1450	894	3	0	7	8
경기도	평택시	진위면	진위면제2투	1783	1289	494	3	1286	822	461	0	1	1	1
경기도	평택시	진위면	진위면제3투	3095	2254	841	3	2251	1233	1013	0	2	3	0
경기도	평택시	진위면	진위면제4투	2490	1685	805	3	1682	856	823	0	0	0	3
경기도	평택시	서탄면	소계	3427	2546	881	15	2531	1707	812	0	2	6	4
경기도	평택시	서탄면	서탄면제1투	1545	1174	371	7	1167	783	380	0	1	3	0
경기도	평택시	서탄면	서탄면제2투	1430	1045	385	3	1042	712	323	0	1	2	4
경기도	평택시	서탄면	서탄면제3투	452	327	125	5	322	212	109	0	0	1	0
경기도	평택시	고덕면	소계	11735	8376	3359	27	8349	4982	3326	2	9	12	18
경기도	평택시	고덕면	고덕면제1투	2928	2042	886	11	2031	1348	671	0	4	5	3
경기도	평택시	고덕면	고덕면제2투	2245	1649	596	6	1643	1125	507	1	1	2	7
경기도	평택시	고덕면	고덕면제3투	4778	3428	1350	6	3422	1703	1707	1	4	3	4
경기도	평택시	고덕면	고덕면제4투	1784	1257	527	4	1253	806	441	0	0	2	4
경기도	평택시	오성면	소계	5523	4010	1513	20	3990	2689	1271	3	5	7	15
경기도	평택시	오성면	오성면제1투	2893	2076	817	12	2064	1338	706	0	4	5	11
경기도	평택시	오성면	오성면제2투	1898	1384	514	5	1379	966	406	3	0	1	3
경기도	평택시	오성면	오성면제3투	732	550	182	3	547	385	159	0	1	1	1
경기도	평택시	청북면	소계	11625	8231	3394	28	8203	4323	3836	3	6	17	18
경기도	평택시	청북면	청북면제1투	2426	1649	777	4	1645	1073	559	1	1	7	4
경기도	평택시	청북면	청북면제2투	1847	1243	604	8	1235	780	447	1	0	2	5
경기도	평택시	청북면	청북면제3투	1511	1087	424	5	1082	772	308	0	0	1	1
경기도	평택시	청북면	청북면제4투	3840	2669	1171	7	2662	1045	1603	1	2	5	6
경기도	평택시	청북면	청북면제5투	2001	1583	418	4	1579	653	919	0	3	2	2
경기도	평택시	현덕면	소계	5520	3902	1618	18	3884	2686	1176	1	1	9	11
경기도	평택시	현덕면	현덕면제1투	2458	1725	733	7	1718	1138	573	0	1	2	4
경기도	평택시	현덕면	현덕면제2투	1273	940	333	7	933	684	242	0	0	2	5
경기도	평택시	현덕면	현덕면제3투	1789	1237	552	4	1233	864	361	1	0	5	2
경기도	평택시	중앙동	소계	34577	25983	8594	61	25922	13814	12005	8	14	51	30
경기도	평택시	중앙동	중앙동제1투	3148	2001	1147	7	1994	1152	830	0	2	4	6
경기도	평택시	중앙동	중앙동제2투	2343	1664	679	5	1659	1046	605	0	0	5	3
경기도	평택시	중앙동	중앙동제3투	4010	2997	1013	6	2991	1668	1311	0	2	6	4
경기도	평택시	중앙동	중앙동제4투	3804	3014	790	7	3007	1758	1236	2	2	7	2
경기도	평택시	중앙동	중앙동제5투	3841	2979	862	8	2971	1477	1487	1	1	4	1
경기도	평택시	중앙동	중앙동제6투	3470	2670	800	8	2662	1265	1389	1	0	4	3
경기도	평택시	중앙동	중앙동제7투	3420	2786	634	3	2783	1405	1365	1	3	6	3
경기도	평택시	중앙동	중앙동제8투	3390	2615	775	5	2610	1298	1305	1	0	5	1
경기도	평택시	중앙동	중앙동제9투	3324	2504	820	3	2501	1251	1237	0	1	7	5
경기도	평택시	중앙동	중앙동제10투	3827	2753	1074	9	2744	1494	1240	2	3	3	2
경기도	평택시	서정동	소계	24770	16220	8550	43	16177	9258	6853	4	13	31	18
경기도	평택시	서정동	서정동제1투	4721	2783	1938	6	2777	1529	1240	0	3	4	1
경기도	평택시	서정동	서정동제2투	3960	2807	1153	5	2802	1531	1257	1	1	6	6
경기도	평택시	서정동	서정동제3투	2847	1856	991	5	1851	1100	749	0	1	0	1
경기도	평택시	서정동	서정동제4투	2356	1581	775	6	1575	980	584	0	2	6	3
경기도	평택시	서정동	서정동제5투	4130	2639	1491	8	2631	1505	1117	2	3	1	3
경기도	평택시	서정동	서정동제6투	3186	1941	1245	9	1932	1118	807	0	1	4	2
경기도	평택시	서정동	서정동제7투	3570	2613	957	4	2609	1495	1099	1	2	10	2
경기도	평택시	송탄동	소계	7338	5295	2043	12	5283	3034	2229	0	3	11	6
경기도	평택시	송탄동	송탄동제1투	3421	2333	1088	6	2327	1405	914	0	1	4	3
경기도	평택시	송탄동	송탄동제2투	3917	2962	955	6	2956	1629	1315	0	2	7	3
경기도	평택시	지산동	소계	8087	5479	2608	11	5468	3084	2362	2	4	11	5
경기도	평택시	지산동	지산동제1투	4314	2625	1689	8	2617	1594	1016	2	2	3	0
경기도	평택시	지산동	지산동제2투	3773	2854	919	3	2851	1490	1346	0	2	8	5
경기도	평택시	송북동	소계	16980	12256	4724	25	12231	7039	5162	2	7	9	12
경기도	평택시	송북동	송북동제1투	2707	1746	961	5	1741	1012	726	0	1	1	1
경기도	평택시	송북동	송북동제2투	3906	2715	1191	6	2709	1754	950	1	1	0	3
경기도	평택시	송북동	송북동제3투	3893	2985	908	4	2981	1737	1237	0	1	2	4
경기도	평택시	송북동	송북동제4투	2983	2209	774	6	2203	1212	983	0	1	4	3
경기도	평택시	송북동	송북동제5투	3491	2601	890	4	2597	1324	1266	1	3	2	1
경기도	평택시	신장1동	소계	4499	2655	1844	11	2644	1747	886	1	2	3	5
경기도	평택시	신장1동	신장1동제1투	2606	1426	1180	6	1420	959	458	1	0	0	2
경기도	평택시	신장1동	신장1동제2투	1893	1229	664	5	1224	788	428	0	2	3	3
경기도	평택시	신장2동	소계	6407	4027	2380	14	4013	2715	1283	1	3	5	6
경기도	평택시	신장2동	신장2동제1투	3573	2150	1423	7	2143	1487	647	0	1	4	4
경기도	평택시	신장2동	신장2동제2투	2834	1877	957	7	1870	1228	636	1	2	1	2
경기도	평택시	신평동	소계	18277	12725	5552	31	12694	7471	5182	3	5	21	12
경기도	평택시	신평동	신평동제1투	2930	1953	977	9	1944	1121	810	1	1	7	4
경기도	평택시	신평동	신평동제2투	2216	1368	848	3	1365	907	456	0	2	0	0
경기도	평택시	신평동	신평동제3투	2814	1972	842	3	1969	1244	721	0	0	1	3
경기도	평택시	신평동	신평동제4투	4461	2998	1463	7	2991	1743	1243	0	1	3	1
경기도	평택시	신평동	신평동제5투	2400	1653	747	5	1648	911	730	1	1	2	3
경기도	평택시	신평동	신평동제6투	687	520	167	2	518	355	161	1	0	0	1
경기도	평택시	신평동	신평동제7투	2769	2261	508	2	2259	1190	1061	0	0	8	0
경기도	평택시	원평동	소계	10367	7360	3007	21	7339	4156	3151	2	4	12	14
경기도	평택시	원평동	원평동제1투	3971	2480	1491	12	2468	1493	968	0	0	7	0
경기도	평택시	원평동	원평동제2투	3590	2676	914	4	2672	1298	1363	2	1	1	7
경기도	평택시	원평동	원평동제3투	2104	1679	425	4	1675	1007	659	0	2	3	4
경기도	평택시	원평동	원평동제4투	702	525	177	1	524	358	161	0	1	1	3
경기도	평택시	통복동	소계	4085	2831	1254	15	2816	1761	1046	0	0	3	6
경기도	평택시	통복동	통복동제1투	2435	1731	704	8	1723	1020	698	0	0	2	3
경기도	평택시	통복동	통복동제2투	1650	1100	550	7	1093	741	348	0	0	1	3
경기도	평택시	비전1동	소계	17136	12762	4374	34	12728	7284	5391	3	13	26	11
경기도	평택시	비전1동	비전1동제1투	3700	2618	1082	4	2614	1535	1069	1	1	5	3
경기도	평택시	비전1동	비전1동제2투	2118	1469	649	2	1467	972	493	0	1	1	0
경기도	평택시	비전1동	비전1동제3투	3840	3064	776	8	3056	1658	1383	0	2	9	4
경기도	평택시	비전1동	비전1동제4투	1949	1574	375	6	1568	877	689	0	0	1	1
경기도	평택시	비전1동	비전1동제5투	1398	1067	331	2	1065	731	326	0	2	4	2
경기도	평택시	비전1동	비전1동제6투	4131	2970	1161	12	2958	1511	1431	2	7	6	1
경기도	평택시	비전2동	소계	34360	26421	7939	57	26364	14472	11806	8	14	43	21
경기도	평택시	비전2동	비전2동제1투	3006	2186	820	3	2183	1255	923	0	2	2	1
경기도	평택시	비전2동	비전2동제2투	2702	2021	681	4	2017	1207	803	0	0	3	4
경기도	평택시	비전2동	비전2동제3투	3186	2211	975	9	2202	1357	830	1	2	8	4
경기도	평택시	비전2동	비전2동제4투	4278	3284	994	3	3281	1861	1416	2	0	2	0
경기도	평택시	비전2동	비전2동제5투	2698	1869	829	3	1866	917	945	1	0	2	1
경기도	평택시	비전2동	비전2동제6투	2773	2243	530	3	2240	1195	1037	0	2	4	2
경기도	평택시	비전2동	비전2동제7투	2364	1934	430	5	1929	996	921	1	2	7	2
경기도	평택시	비전2동	비전2동제8투	3717	2851	866	2	2849	1594	1250	0	2	3	0
경기도	평택시	비전2동	비전2동제9투	3623	2837	786	10	2827	1436	1382	0	2	4	3
경기도	평택시	비전2동	비전2동제10투	2422	2024	398	9	2015	1203	804	2	0	5	1
경기도	평택시	비전2동	비전2동제11투	3591	2961	630	6	2955	1451	1495	1	2	3	3
경기도	평택시	세교동	소계	17342	13219	4123	24	13195	7333	5800	4	19	18	21
경기도	평택시	세교동	세교동제1투	4453	3487	966	6	3481	1904	1556	3	9	4	5
경기도	평택시	세교동	세교동제2투	1955	1373	582	0	1373	881	482	0	4	1	5
경기도	평택시	세교동	세교동제3투	753	583	170	5	578	398	177	0	0	0	3
경기도	평택시	세교동	세교동제4투	2092	1382	710	2	1380	903	471	0	0	4	2
경기도	평택시	세교동	세교동제5투	3639	2967	672	7	2960	1480	1473	0	4	3	0
경기도	평택시	세교동	세교동제6투	4450	3427	1023	4	3423	1767	1641	1	2	6	6
경기도	양주시	계	계	154363	111883	42480	387	111496	61889	49201	42	60	165	139
경기도	양주시	재외투표	재외투표	602	409	193	0	409	145	262	0	2	0	0
경기도	양주시	국내부재자투표	국내부재자투표	3942	3663	279	87	3576	1832	1689	13	8	13	21
경기도	양주시	백석읍	소계	22439	16047	6392	46	16001	9487	6466	4	9	24	11
경기도	양주시	백석읍	백석읍제1투	4052	2761	1291	11	2750	1705	1038	1	2	3	1
경기도	양주시	백석읍	백석읍제2투	3089	2186	903	9	2177	1383	786	0	3	1	4
경기도	양주시	백석읍	백석읍제3투	2501	1769	732	7	1762	1173	581	0	0	7	1
경기도	양주시	백석읍	백석읍제4투	4375	3206	1169	5	3201	1841	1347	0	3	8	2
경기도	양주시	백석읍	백석읍제5투	2821	1961	860	4	1957	1128	828	0	1	0	0
경기도	양주시	백석읍	백석읍제6투	2863	2083	780	7	2076	1108	963	1	0	3	1
경기도	양주시	백석읍	백석읍제7투	2738	2081	657	3	2078	1149	923	2	0	2	2
경기도	양주시	은현면	소계	6211	4362	1849	21	4341	2910	1413	1	4	5	8
경기도	양주시	은현면	은현면제1투	1623	1101	522	7	1094	725	363	1	1	2	2
경기도	양주시	은현면	은현면제2투	2435	1677	758	6	1671	1106	559	0	3	2	1
경기도	양주시	은현면	은현면제3투	1064	771	293	2	769	526	239	0	0	1	3
경기도	양주시	은현면	은현면제4투	1089	813	276	6	807	553	252	0	0	0	2
경기도	양주시	남면	소계	6402	4383	2019	28	4355	3021	1320	3	1	2	8
경기도	양주시	남면	남면제1투	2407	1584	823	9	1575	1072	500	0	0	0	3
경기도	양주시	남면	남면제2투	987	703	284	4	699	519	177	0	0	1	2
경기도	양주시	남면	남면제3투	2131	1448	683	9	1439	988	446	2	0	1	2
경기도	양주시	남면	남면제4투	877	648	229	6	642	442	197	1	1	0	1
경기도	양주시	광적면	소계	9533	6591	2942	17	6574	4183	2365	3	3	12	8
경기도	양주시	광적면	광적면제1투	4767	3182	1585	9	3173	1977	1185	1	0	7	3
경기도	양주시	광적면	광적면제2투	2817	1982	835	4	1978	1248	719	2	2	3	4
경기도	양주시	광적면	광적면제3투	358	270	88	1	269	191	77	0	0	1	0
경기도	양주시	광적면	광적면제4투	1591	1157	434	3	1154	767	384	0	1	1	1
경기도	양주시	장흥면	소계	8703	6333	2370	18	6315	3939	2357	3	2	10	4
경기도	양주시	장흥면	장흥면제1투	4052	2959	1093	9	2950	1901	1036	2	1	6	4
경기도	양주시	장흥면	장흥면제2투	1544	1178	366	5	1173	754	416	1	0	2	0
경기도	양주시	장흥면	장흥면제3투	3107	2196	911	4	2192	1284	905	0	1	2	0
경기도	양주시	양주1동	소계	5781	4144	1637	16	4128	2550	1559	1	1	6	11
경기도	양주시	양주1동	양주1동제1투	1928	1384	544	8	1376	923	446	0	1	3	3
경기도	양주시	양주1동	양주1동제2투	1114	812	302	0	812	566	240	0	0	2	4
경기도	양주시	양주1동	양주1동제3투	2739	1948	791	8	1940	1061	873	1	0	1	4
경기도	양주시	양주2동	소계	37353	27893	9460	59	27834	13498	14258	6	15	30	27
경기도	양주시	양주2동	양주2동제1투	4826	3515	1311	6	3509	1784	1711	1	2	7	4
경기도	양주시	양주2동	양주2동제2투	4158	3151	1007	5	3146	1580	1558	2	2	4	0
경기도	양주시	양주2동	양주2동제3투	3916	2949	967	5	2944	1422	1511	1	2	3	5
경기도	양주시	양주2동	양주2동제4투	3186	2399	787	6	2393	1139	1247	0	2	0	5
경기도	양주시	양주2동	양주2동제5투	4653	3579	1074	9	3570	1525	2039	1	1	2	2
경기도	양주시	양주2동	양주2동제6투	3726	2796	930	5	2791	1452	1333	0	1	1	4
경기도	양주시	양주2동	양주2동제7투	3774	2826	948	5	2821	1364	1450	0	0	3	4
경기도	양주시	양주2동	양주2동제8투	3848	2601	1247	10	2591	1415	1166	1	1	5	3
경기도	양주시	양주2동	양주2동제9투	2687	2047	640	5	2042	976	1063	0	2	1	0
경기도	양주시	양주2동	양주2동제10투	2579	2030	549	3	2027	841	1180	0	2	4	0
경기도	양주시	회천1동	소계	6287	4388	1899	21	4367	2674	1677	1	3	8	4
경기도	양주시	회천1동	회천1동제1투	2984	2069	915	9	2060	1218	837	0	0	4	1
경기도	양주시	회천1동	회천1동제2투	1962	1368	594	6	1362	808	549	0	1	2	2
경기도	양주시	회천1동	회천1동제3투	1341	951	390	6	945	648	291	1	2	2	1
경기도	양주시	회천2동	소계	22412	15656	6756	39	15617	8223	7343	3	3	22	23
경기도	양주시	회천2동	회천2동제1투	4275	2738	1537	9	2729	1433	1286	0	0	5	5
경기도	양주시	회천2동	회천2동제2투	3758	2584	1174	9	2575	1362	1203	1	1	5	3
경기도	양주시	회천2동	회천2동제3투	2617	1843	774	4	1839	982	849	0	1	1	6
경기도	양주시	회천2동	회천2동제4투	3571	2606	965	2	2604	1373	1223	1	1	3	3
경기도	양주시	회천2동	회천2동제5투	3545	2672	873	3	2669	1342	1320	1	0	6	0
경기도	양주시	회천2동	회천2동제6투	4646	3213	1433	12	3201	1731	1462	0	0	2	6
경기도	양주시	회천3동	소계	20750	15319	5431	28	15291	7833	7411	3	8	27	9
경기도	양주시	회천3동	회천3동제1투	2832	2075	757	3	2072	1108	960	0	0	3	1
경기도	양주시	회천3동	회천3동제2투	3928	2868	1060	9	2859	1366	1486	0	0	5	2
경기도	양주시	회천3동	회천3동제3투	4175	2928	1247	3	2925	1469	1447	1	1	6	1
경기도	양주시	회천3동	회천3동제4투	2742	2163	579	3	2160	1229	923	0	2	4	2
경기도	양주시	회천3동	회천3동제5투	3474	2610	864	7	2603	1364	1228	1	4	5	1
경기도	양주시	회천3동	회천3동제6투	3599	2675	924	3	2672	1297	1367	1	1	4	2
경기도	양주시	회천4동	소계	3948	2695	1253	7	2688	1594	1081	1	1	6	5
경기도	양주시	회천4동	회천4동투표소	3948	2695	1253	7	2688	1594	1081	1	1	6	5
경기도	동두천시	계	계	77102	52984	24118	291	52693	31188	21296	25	27	92	65
경기도	동두천시	재외투표	재외투표	264	190	74	1	189	102	86	1	0	0	0
경기도	동두천시	국내부재자투표	국내부재자투표	1771	1666	105	25	1641	834	781	2	8	6	10
경기도	동두천시	생연1동	소계	5781	3728	2053	18	3710	2350	1348	1	2	6	3
경기도	동두천시	생연1동	생연1동제1투	3462	2194	1268	10	2184	1410	771	0	0	2	1
경기도	동두천시	생연1동	생연1동제2투	2319	1534	785	8	1526	940	577	1	2	4	2
경기도	동두천시	생연2동	소계	9892	6981	2911	34	6947	4055	2867	3	2	15	5
경기도	동두천시	생연2동	생연2동제1투	1536	970	566	5	965	590	370	0	1	1	3
경기도	동두천시	생연2동	생연2동제2투	2082	1494	588	13	1481	910	562	2	0	5	2
경기도	동두천시	생연2동	생연2동제3투	1506	1041	465	7	1034	640	394	0	0	0	0
경기도	동두천시	생연2동	생연2동제4투	2738	1947	791	4	1943	1051	886	0	1	5	0
경기도	동두천시	생연2동	생연2동제5투	2030	1529	501	5	1524	864	655	1	0	4	0
경기도	동두천시	중앙동	소계	5330	3361	1969	23	3338	2231	1095	0	2	6	4
경기도	동두천시	중앙동	중앙동제1투	3024	1869	1155	16	1853	1224	620	0	2	3	4
경기도	동두천시	중앙동	중앙동제2투	2306	1492	814	7	1485	1007	475	0	0	3	0
경기도	동두천시	보산동	소계	2802	1663	1139	5	1658	1060	593	1	0	2	2
경기도	동두천시	보산동	보산동투표소	2802	1663	1139	5	1658	1060	593	1	0	2	2
경기도	동두천시	불현동	소계	20207	13662	6545	62	13600	8051	5494	8	3	25	19
경기도	동두천시	불현동	불현동제1투	4796	3465	1331	16	3449	1974	1458	1	1	8	7
경기도	동두천시	불현동	불현동제2투	2890	1650	1240	6	1644	1022	618	0	0	3	1
경기도	동두천시	불현동	불현동제3투	2541	1613	928	10	1603	960	638	2	0	1	2
경기도	동두천시	불현동	불현동제4투	4206	2912	1294	11	2901	1635	1253	3	2	6	2
경기도	동두천시	불현동	불현동제5투	3396	2425	971	7	2418	1414	998	1	0	3	2
경기도	동두천시	불현동	불현동제6투	1528	996	532	4	992	651	336	0	0	2	3
경기도	동두천시	불현동	불현동제7투	850	601	249	8	593	395	193	1	0	2	2
경기도	동두천시	송내동	소계	18318	13200	5118	47	13153	7034	6085	2	5	14	13
경기도	동두천시	송내동	송내동제1투	5115	3593	1522	10	3583	1882	1692	0	2	4	3
경기도	동두천시	송내동	송내동제2투	3821	2867	954	9	2858	1510	1338	1	2	4	3
경기도	동두천시	송내동	송내동제3투	4456	3135	1321	15	3120	1609	1504	0	0	4	3
경기도	동두천시	송내동	송내동제4투	4198	3086	1112	11	3075	1666	1403	1	1	2	2
경기도	동두천시	송내동	송내동제5투	728	519	209	2	517	367	148	0	0	0	2
경기도	동두천시	소요동	소계	7625	5141	2484	57	5084	3320	1735	6	5	14	4
경기도	동두천시	소요동	소요동제1투	1459	856	603	3	853	535	316	1	0	1	0
경기도	동두천시	소요동	소요동제2투	2095	1401	694	5	1396	859	534	0	0	3	0
경기도	동두천시	소요동	소요동제3투	719	523	196	4	519	359	153	0	0	4	3
경기도	동두천시	소요동	소요동제4투	1886	1359	527	4	1355	917	434	1	0	2	1
경기도	동두천시	소요동	소요동제5투	1466	1002	464	41	961	650	298	4	5	4	0
경기도	동두천시	상패동	소계	5112	3391	1721	19	3372	2151	1211	1	0	4	5
경기도	동두천시	상패동	상패동제1투	3286	2151	1135	9	2142	1376	758	1	0	3	4
경기도	동두천시	상패동	상패동제2투	1053	716	337	6	710	426	282	0	0	1	1
경기도	동두천시	상패동	상패동제3투	773	524	249	4	520	349	171	0	0	0	0
경기도	동두천시	잘못 투입·구분된 투표지	잘못 투입·구분된 투표지	0	1	-1	0	1	0	1	0	0	0	0
경기도	안산시상록구	계	계	292424	211371	81053	628	210743	97913	112075	61	140	345	209
경기도	안산시상록구	재외투표	재외투표	1123	781	342	6	775	263	506	1	1	3	1
경기도	안산시상록구	국내부재자투표	국내부재자투표	6652	6265	387	112	6153	2884	3192	13	16	17	31
경기도	안산시상록구	일동	소계	20396	13711	6685	26	13685	6293	7355	3	7	16	11
경기도	안산시상록구	일동	일동제1투	4844	3165	1679	3	3162	1540	1610	1	3	3	5
경기도	안산시상록구	일동	일동제2투	4787	3158	1629	8	3150	1454	1691	0	0	4	1
경기도	안산시상록구	일동	일동제3투	5987	4131	1856	13	4118	1852	2254	2	1	6	3
경기도	안산시상록구	일동	일동제4투	4778	3257	1521	2	3255	1447	1800	0	3	3	2
경기도	안산시상록구	이동	소계	23358	15578	7780	37	15541	6911	8577	4	10	26	13
경기도	안산시상록구	이동	이동제1투	3419	2327	1092	4	2323	983	1338	0	0	1	1
경기도	안산시상록구	이동	이동제2투	4252	2660	1592	7	2653	1183	1458	1	0	7	4
경기도	안산시상록구	이동	이동제3투	4559	2832	1727	11	2821	1260	1551	0	2	7	1
경기도	안산시상록구	이동	이동제4투	3532	2247	1285	2	2245	981	1259	0	1	2	2
경기도	안산시상록구	이동	이동제5투	5043	3426	1617	6	3420	1433	1975	1	3	4	4
경기도	안산시상록구	이동	이동제6투	2553	2086	467	7	2079	1071	996	2	4	5	1
경기도	안산시상록구	사1동	소계	28815	19754	9061	72	19682	8643	10980	2	13	30	14
경기도	안산시상록구	사1동	사1동제1투	3675	2265	1410	5	2260	947	1307	0	0	4	2
경기도	안산시상록구	사1동	사1동제2투	4761	3248	1513	16	3232	1411	1810	0	4	4	3
경기도	안산시상록구	사1동	사1동제3투	5592	3410	2182	9	3401	1483	1904	2	4	5	3
경기도	안산시상록구	사1동	사1동제4투	4058	3272	786	22	3250	1611	1632	0	2	3	2
경기도	안산시상록구	사1동	사1동제5투	2878	2403	475	3	2400	867	1525	0	1	5	2
경기도	안산시상록구	사1동	사1동제6투	4470	2845	1625	6	2839	1257	1579	0	1	1	1
경기도	안산시상록구	사1동	사1동제7투	3381	2311	1070	11	2300	1067	1223	0	1	8	1
경기도	안산시상록구	사2동	소계	25895	19050	6845	46	19004	8942	9997	4	13	31	17
경기도	안산시상록구	사2동	사2동제1투	3031	2541	490	6	2535	1319	1203	1	2	8	2
경기도	안산시상록구	사2동	사2동제2투	4317	3372	945	5	3367	1725	1617	1	4	15	5
경기도	안산시상록구	사2동	사2동제3투	3024	2491	533	3	2488	1258	1226	0	1	2	1
경기도	안산시상록구	사2동	사2동제4투	5363	3674	1689	10	3664	1584	2068	1	5	2	4
경기도	안산시상록구	사2동	사2동제5투	5238	3552	1686	12	3540	1627	1904	1	1	3	4
경기도	안산시상록구	사2동	사2동제6투	4922	3420	1502	10	3410	1429	1979	0	0	1	1
경기도	안산시상록구	사3동	소계	14855	11772	3083	20	11752	5921	5806	0	3	15	7
경기도	안산시상록구	사3동	사3동제1투	2851	1912	939	5	1907	841	1060	0	1	2	3
경기도	안산시상록구	사3동	사3동제2투	2470	2003	467	2	2001	1020	979	0	0	1	1
경기도	안산시상록구	사3동	사3동제3투	4310	3600	710	5	3595	1801	1787	0	1	5	1
경기도	안산시상록구	사3동	사3동제4투	5224	4257	967	8	4249	2259	1980	0	1	7	2
경기도	안산시상록구	본오1동	소계	31561	21083	10478	72	21011	9689	11239	6	11	40	26
경기도	안산시상록구	본오1동	본오1동제1투	4545	3138	1407	11	3127	1439	1669	1	3	10	5
경기도	안산시상록구	본오1동	본오1동제2투	4062	2645	1417	12	2633	1174	1452	0	2	3	2
경기도	안산시상록구	본오1동	본오1동제3투	4249	2756	1493	7	2749	1276	1462	1	2	4	4
경기도	안산시상록구	본오1동	본오1동제4투	3977	2604	1373	5	2599	1190	1399	0	2	6	2
경기도	안산시상록구	본오1동	본오1동제5투	4360	2982	1378	15	2967	1331	1629	2	1	4	0
경기도	안산시상록구	본오1동	본오1동제6투	4080	2544	1536	9	2535	1219	1304	0	1	6	5
경기도	안산시상록구	본오1동	본오1동제7투	3866	2618	1248	4	2614	1134	1473	1	0	3	3
경기도	안산시상록구	본오1동	본오1동제8투	2422	1796	626	9	1787	926	851	1	0	4	5
경기도	안산시상록구	본오2동	소계	23709	17399	6310	47	17352	8100	9200	1	17	23	11
경기도	안산시상록구	본오2동	본오2동제1투	4008	2576	1432	6	2570	1164	1398	0	0	7	1
경기도	안산시상록구	본오2동	본오2동제2투	3284	2191	1093	5	2186	1019	1161	0	2	2	2
경기도	안산시상록구	본오2동	본오2동제3투	5103	3461	1642	8	3453	1612	1835	0	3	1	2
경기도	안산시상록구	본오2동	본오2동제4투	3095	2499	596	7	2492	1249	1235	0	5	2	1
경기도	안산시상록구	본오2동	본오2동제5투	5003	4009	994	11	3998	1840	2142	1	5	7	3
경기도	안산시상록구	본오2동	본오2동제6투	3216	2663	553	10	2653	1216	1429	0	2	4	2
경기도	안산시상록구	본오3동	소계	18955	13854	5101	27	13827	6325	7460	3	8	18	13
경기도	안산시상록구	본오3동	본오3동제1투	3532	2528	1004	3	2525	1098	1422	1	0	2	2
경기도	안산시상록구	본오3동	본오3동제2투	2997	2473	524	8	2465	1164	1290	0	2	4	5
경기도	안산시상록구	본오3동	본오3동제3투	5494	3982	1512	8	3974	1829	2134	2	3	4	2
경기도	안산시상록구	본오3동	본오3동제4투	4862	3178	1684	6	3172	1369	1795	0	2	4	2
경기도	안산시상록구	본오3동	본오3동제5투	2070	1693	377	2	1691	865	819	0	1	4	2
경기도	안산시상록구	부곡동	소계	16836	11752	5084	27	11725	5551	6132	4	6	22	10
경기도	안산시상록구	부곡동	부곡동제1투	4549	3166	1383	6	3160	1510	1638	0	1	7	4
경기도	안산시상록구	부곡동	부곡동제2투	4633	3084	1549	8	3076	1512	1556	1	0	4	3
경기도	안산시상록구	부곡동	부곡동제3투	3279	2370	909	8	2362	1097	1256	1	3	4	1
경기도	안산시상록구	부곡동	부곡동제4투	4375	3132	1243	5	3127	1432	1682	2	2	7	2
경기도	안산시상록구	월피동	소계	33866	24340	9526	59	24281	11007	13179	8	16	47	24
경기도	안산시상록구	월피동	월피동제1투	5113	3354	1759	7	3347	1558	1773	1	2	10	3
경기도	안산시상록구	월피동	월피동제2투	5233	3674	1559	18	3656	1804	1838	2	0	9	3
경기도	안산시상록구	월피동	월피동제3투	4468	3345	1123	12	3333	1491	1829	1	4	6	2
경기도	안산시상록구	월피동	월피동제4투	3860	2830	1030	3	2827	1173	1642	2	1	6	3
경기도	안산시상록구	월피동	월피동제5투	3333	2695	638	5	2690	1207	1476	0	3	2	2
경기도	안산시상록구	월피동	월피동제6투	3534	2850	684	4	2846	1196	1638	1	2	4	5
경기도	안산시상록구	월피동	월피동제7투	4297	2959	1338	4	2955	1365	1579	1	2	7	1
경기도	안산시상록구	월피동	월피동제8투	4028	2633	1395	6	2627	1213	1404	0	2	3	5
경기도	안산시상록구	성포동	소계	22172	17808	4364	42	17766	8495	9216	5	8	31	11
경기도	안산시상록구	성포동	성포동제1투	4708	3680	1028	9	3671	1870	1786	2	4	6	3
경기도	안산시상록구	성포동	성포동제2투	4229	3336	893	7	3329	1583	1739	0	0	6	1
경기도	안산시상록구	성포동	성포동제3투	3820	3110	710	8	3102	1551	1544	1	1	3	2
경기도	안산시상록구	성포동	성포동제4투	4723	3879	844	8	3871	1940	1920	1	2	5	3
경기도	안산시상록구	성포동	성포동제5투	4692	3803	889	10	3793	1551	2227	1	1	11	2
경기도	안산시상록구	반월동	소계	16362	12535	3827	28	12507	5985	6481	1	10	18	12
경기도	안산시상록구	반월동	반월동제1투	4589	3466	1123	9	3457	1748	1701	1	1	4	2
경기도	안산시상록구	반월동	반월동제2투	4275	3488	787	5	3483	1450	2023	0	2	6	2
경기도	안산시상록구	반월동	반월동제3투	4128	2999	1129	4	2995	1485	1498	0	2	6	4
경기도	안산시상록구	반월동	반월동제4투	2183	1703	480	6	1697	869	820	0	3	2	3
경기도	안산시상록구	반월동	반월동제5투	1187	879	308	4	875	433	439	0	2	0	1
경기도	안산시상록구	안산동	소계	7869	5689	2180	7	5682	2904	2755	6	1	8	8
경기도	안산시상록구	안산동	안산동제1투	3634	2633	1001	4	2629	1365	1257	2	0	2	3
경기도	안산시상록구	안산동	안산동제2투	4235	3056	1179	3	3053	1539	1498	4	1	6	5
경기도	안산시단원구	계	계	256246	184903	71343	533	184370	87893	95849	48	104	308	168
경기도	안산시단원구	재외투표	재외투표	886	600	286	4	596	241	351	0	0	3	1
경기도	안산시단원구	국내부재자투표	국내부재자투표	5757	5471	286	86	5385	2555	2778	6	16	15	15
경기도	안산시단원구	와동	소계	34050	21794	12256	57	21737	10059	11620	5	8	28	17
경기도	안산시단원구	와동	와동제1투	3797	2555	1242	5	2550	1223	1319	0	1	4	3
경기도	안산시단원구	와동	와동제2투	4772	3382	1390	5	3377	1552	1810	2	3	8	2
경기도	안산시단원구	와동	와동제3투	4344	3078	1266	7	3071	1382	1682	1	0	2	4
경기도	안산시단원구	와동	와동제4투	4649	2994	1655	12	2982	1400	1574	0	1	5	2
경기도	안산시단원구	와동	와동제5투	4199	2243	1956	4	2239	1034	1203	0	0	2	0
경기도	안산시단원구	와동	와동제6투	3280	1963	1317	3	1960	900	1056	0	0	1	3
경기도	안산시단원구	와동	와동제7투	4858	3057	1801	14	3043	1403	1629	2	2	5	2
경기도	안산시단원구	와동	와동제8투	4151	2522	1629	7	2515	1165	1347	0	1	1	1
경기도	안산시단원구	고잔1동	소계	17936	12883	5053	31	12852	6023	6773	6	12	25	13
경기도	안산시단원구	고잔1동	고잔1동제1투	3675	2581	1094	6	2575	1206	1357	1	2	6	3
경기도	안산시단원구	고잔1동	고잔1동제2투	2808	2082	726	3	2079	959	1115	2	1	1	1
경기도	안산시단원구	고잔1동	고잔1동제3투	4170	2973	1197	7	2966	1351	1603	0	3	5	4
경기도	안산시단원구	고잔1동	고잔1동제4투	3686	2730	956	8	2722	1272	1434	3	3	8	2
경기도	안산시단원구	고잔1동	고잔1동제5투	3597	2517	1080	7	2510	1235	1264	0	3	5	3
경기도	안산시단원구	고잔2동	소계	18989	14216	4773	37	14179	6508	7634	5	3	19	10
경기도	안산시단원구	고잔2동	고잔2동제1투	4981	3837	1144	17	3820	1693	2118	0	1	7	1
경기도	안산시단원구	고잔2동	고잔2동제2투	5193	3669	1524	6	3663	1734	1923	0	0	4	2
경기도	안산시단원구	고잔2동	고잔2동제3투	4296	3385	911	8	3377	1505	1862	2	1	4	3
경기도	안산시단원구	고잔2동	고잔2동제4투	4519	3325	1194	6	3319	1576	1731	3	1	4	4
경기도	안산시단원구	호수동	소계	32481	26033	6448	48	25985	12357	13548	4	14	54	8
경기도	안산시단원구	호수동	호수동제1투	3704	2971	733	4	2967	1272	1684	1	1	8	1
경기도	안산시단원구	호수동	호수동제2투	2817	2384	433	3	2381	1281	1094	0	0	5	1
경기도	안산시단원구	호수동	호수동제3투	3700	2595	1105	3	2592	1118	1467	0	0	4	3
경기도	안산시단원구	호수동	호수동제4투	3648	2858	790	6	2852	1432	1405	0	3	12	0
경기도	안산시단원구	호수동	호수동제5투	4066	3373	693	8	3365	1497	1862	2	0	3	1
경기도	안산시단원구	호수동	호수동제6투	4436	3686	750	5	3681	1783	1882	1	3	12	0
경기도	안산시단원구	호수동	호수동제7투	3556	2729	827	3	2726	1194	1525	0	4	3	0
경기도	안산시단원구	호수동	호수동제8투	3916	3290	626	10	3280	1625	1646	0	2	5	2
경기도	안산시단원구	호수동	호수동제9투	2638	2147	491	6	2141	1155	983	0	1	2	0
경기도	안산시단원구	원곡본동	소계	25394	17097	8297	36	17061	8371	8642	9	9	13	17
경기도	안산시단원구	원곡본동	원곡본동제1투	2603	1219	1384	6	1213	703	504	3	2	0	1
경기도	안산시단원구	원곡본동	원곡본동제2투	2392	1253	1139	4	1249	730	516	0	1	1	1
경기도	안산시단원구	원곡본동	원곡본동제3투	3201	1748	1453	6	1742	897	835	2	1	5	2
경기도	안산시단원구	원곡본동	원곡본동제4투	2832	2264	568	5	2259	1188	1069	0	0	0	2
경기도	안산시단원구	원곡본동	원곡본동제5투	2985	2399	586	5	2394	1127	1265	0	0	2	0
경기도	안산시단원구	원곡본동	원곡본동제6투	2846	1581	1265	2	1579	728	846	1	1	1	2
경기도	안산시단원구	원곡본동	원곡본동제7투	2828	2174	654	1	2173	1049	1120	0	0	1	3
경기도	안산시단원구	원곡본동	원곡본동제8투	2401	1824	577	4	1820	828	986	0	3	0	3
경기도	안산시단원구	원곡본동	원곡본동제9투	3306	2635	671	3	2632	1121	1501	3	1	3	3
경기도	안산시단원구	원곡1동	소계	7902	5264	2638	18	5246	2767	2460	5	3	7	4
경기도	안산시단원구	원곡1동	원곡1동제1투	1473	756	717	5	751	402	348	0	0	1	0
경기도	안산시단원구	원곡1동	원곡1동제2투	3721	2528	1193	6	2522	1307	1206	4	2	0	3
경기도	안산시단원구	원곡1동	원곡1동제3투	2708	1980	728	7	1973	1058	906	1	1	6	1
경기도	안산시단원구	원곡2동	소계	12378	9912	2466	24	9888	4772	5081	0	6	20	9
경기도	안산시단원구	원곡2동	원곡2동제1투	3341	2652	689	3	2649	1229	1412	0	1	5	2
경기도	안산시단원구	원곡2동	원곡2동제2투	5221	4209	1012	11	4198	2036	2144	0	5	8	5
경기도	안산시단원구	원곡2동	원곡2동제3투	3816	3051	765	10	3041	1507	1525	0	0	7	2
경기도	안산시단원구	초지동	소계	34680	26353	8327	62	26291	11881	14335	0	8	44	23
경기도	안산시단원구	초지동	초지동제1투	2707	1965	742	8	1957	1014	932	0	1	4	6
경기도	안산시단원구	초지동	초지동제2투	3003	1961	1042	5	1956	1054	896	0	3	1	2
경기도	안산시단원구	초지동	초지동제3투	5308	4351	957	11	4340	2063	2270	0	1	6	0
경기도	안산시단원구	초지동	초지동제4투	4808	3840	968	6	3834	1757	2065	0	0	9	3
경기도	안산시단원구	초지동	초지동제5투	3384	2535	849	5	2530	1114	1410	0	0	4	2
경기도	안산시단원구	초지동	초지동제6투	4028	2984	1044	7	2977	1337	1627	0	2	7	4
경기도	안산시단원구	초지동	초지동제7투	4128	3305	823	9	3296	1315	1976	0	0	2	3
경기도	안산시단원구	초지동	초지동제8투	4125	3252	873	4	3248	1361	1876	0	0	9	2
경기도	안산시단원구	초지동	초지동제9투	3189	2160	1029	7	2153	866	1283	0	1	2	1
경기도	안산시단원구	선부1동	소계	13966	9949	4017	36	9913	4493	5377	1	8	21	13
경기도	안산시단원구	선부1동	선부1동제1투	2954	2060	894	9	2051	945	1099	0	0	2	5
경기도	안산시단원구	선부1동	선부1동제2투	3065	2180	885	6	2174	997	1165	0	2	9	1
경기도	안산시단원구	선부1동	선부1동제3투	2365	1740	625	8	1732	756	966	0	3	5	2
경기도	안산시단원구	선부1동	선부1동제4투	2776	1996	780	5	1991	818	1167	1	1	2	2
경기도	안산시단원구	선부1동	선부1동제5투	2806	1973	833	8	1965	977	980	0	2	3	3
경기도	안산시단원구	선부2동	소계	18815	11807	7008	35	11772	5718	6010	2	5	24	13
경기도	안산시단원구	선부2동	선부2동제1투	3925	2365	1560	7	2358	1166	1178	0	0	9	5
경기도	안산시단원구	선부2동	선부2동제2투	3042	2071	971	7	2064	993	1063	0	1	6	1
경기도	안산시단원구	선부2동	선부2동제3투	4275	2684	1591	9	2675	1322	1344	0	3	4	2
경기도	안산시단원구	선부2동	선부2동제4투	4065	2604	1461	6	2598	1186	1407	0	1	3	1
경기도	안산시단원구	선부2동	선부2동제5투	3508	2083	1425	6	2077	1051	1018	2	0	2	4
경기도	안산시단원구	선부3동	소계	26927	19304	7623	40	19264	9118	10085	4	12	32	13
경기도	안산시단원구	선부3동	선부3동제1투	3677	2357	1320	7	2350	1092	1251	0	0	5	2
경기도	안산시단원구	선부3동	선부3동제2투	3725	2345	1380	4	2341	1154	1181	0	3	2	1
경기도	안산시단원구	선부3동	선부3동제3투	3447	2120	1327	4	2116	948	1164	0	0	3	1
경기도	안산시단원구	선부3동	선부3동제4투	4853	3874	979	5	3869	1978	1878	1	2	9	1
경기도	안산시단원구	선부3동	선부3동제5투	3769	2738	1031	12	2726	1201	1514	2	2	5	2
경기도	안산시단원구	선부3동	선부3동제6투	4893	3884	1009	7	3877	1871	1997	0	3	2	4
경기도	안산시단원구	선부3동	선부3동제7투	2563	1986	577	1	1985	874	1100	1	2	6	2
경기도	안산시단원구	대부동	소계	6085	4220	1865	19	4201	3030	1155	1	0	3	12
경기도	안산시단원구	대부동	대부동제1투	2153	1442	711	5	1437	967	466	0	0	1	3
경기도	안산시단원구	대부동	대부동제2투	1666	1168	498	6	1162	903	254	1	0	1	3
경기도	안산시단원구	대부동	대부동제3투	2266	1610	656	8	1602	1160	435	0	0	1	6
경기도	고양시덕양구	계	계	310405	235041	75364	768	234273	114871	118515	63	120	477	227
경기도	고양시덕양구	재외투표	재외투표	2163	1535	628	5	1530	584	937	0	2	6	1
경기도	고양시덕양구	국내부재자투표	국내부재자투표	7270	6760	510	126	6634	3228	3322	13	19	21	31
경기도	고양시덕양구	주교동	소계	15407	10804	4603	41	10763	5645	5082	2	6	16	12
경기도	고양시덕양구	주교동	주교동제1투	3274	2302	972	10	2292	1300	982	0	3	4	3
경기도	고양시덕양구	주교동	주교동제2투	3987	2744	1243	8	2736	1416	1310	1	2	5	2
경기도	고양시덕양구	주교동	주교동제3투	4636	3151	1485	8	3143	1586	1546	1	1	6	3
경기도	고양시덕양구	주교동	주교동제4투	3510	2607	903	15	2592	1343	1244	0	0	1	4
경기도	고양시덕양구	원신동	소계	2818	2149	669	8	2141	1218	915	1	0	6	1
경기도	고양시덕양구	원신동	원신동제1투	1754	1355	399	5	1350	670	674	1	0	5	0
경기도	고양시덕양구	원신동	원신동제2투	1064	794	270	3	791	548	241	0	0	1	1
경기도	고양시덕양구	흥도동	소계	2734	1920	814	14	1906	1256	644	0	0	5	1
경기도	고양시덕양구	흥도동	흥도동제1투	1043	701	342	5	696	469	224	0	0	2	1
경기도	고양시덕양구	흥도동	흥도동제2투	775	545	230	4	541	352	187	0	0	2	0
경기도	고양시덕양구	흥도동	흥도동제3투	916	674	242	5	669	435	233	0	0	1	0
경기도	고양시덕양구	성사1동	소계	20603	15326	5277	44	15282	7453	7784	6	4	26	9
경기도	고양시덕양구	성사1동	성사1동제1투	4494	3129	1365	10	3119	1481	1632	3	1	2	0
경기도	고양시덕양구	성사1동	성사1동제2투	4439	3158	1281	13	3145	1610	1525	1	0	7	2
경기도	고양시덕양구	성사1동	성사1동제3투	4539	3141	1398	13	3128	1633	1482	1	0	9	3
경기도	고양시덕양구	성사1동	성사1동제4투	3701	3101	600	3	3098	1379	1711	0	2	5	1
경기도	고양시덕양구	성사1동	성사1동제5투	3430	2797	633	5	2792	1350	1434	1	1	3	3
경기도	고양시덕양구	성사2동	소계	10031	7984	2047	21	7963	3947	3989	4	3	16	4
경기도	고양시덕양구	성사2동	성사2동제1투	3293	2522	771	8	2514	1169	1340	1	0	4	0
경기도	고양시덕양구	성사2동	성사2동제2투	3498	2797	701	6	2791	1505	1276	1	0	5	4
경기도	고양시덕양구	성사2동	성사2동제3투	3240	2665	575	7	2658	1273	1373	2	3	7	0
경기도	고양시덕양구	효자동	소계	2536	1666	870	5	1661	1062	590	0	1	4	4
경기도	고양시덕양구	효자동	효자동제1투	1058	537	521	2	535	322	209	0	0	3	1
경기도	고양시덕양구	효자동	효자동제2투	1478	1129	349	3	1126	740	381	0	1	1	3
경기도	고양시덕양구	신도동	소계	5482	4039	1443	15	4024	2320	1684	0	1	12	7
경기도	고양시덕양구	신도동	신도동제1투	2218	1634	584	4	1630	911	709	0	0	8	2
경기도	고양시덕양구	신도동	신도동제2투	2527	1870	657	9	1861	1101	751	0	1	3	5
경기도	고양시덕양구	신도동	신도동제3투	737	535	202	2	533	308	224	0	0	1	0
경기도	고양시덕양구	창릉동	소계	5534	4127	1407	11	4116	2320	1786	0	2	5	3
경기도	고양시덕양구	창릉동	창릉동제1투	3586	2672	914	6	2666	1361	1296	0	2	5	2
경기도	고양시덕양구	창릉동	창릉동제2투	1948	1455	493	5	1450	959	490	0	0	0	1
경기도	고양시덕양구	고양동	소계	24958	18166	6792	53	18113	9372	8675	5	9	35	17
경기도	고양시덕양구	고양동	고양동제1투	3369	2347	1022	6	2341	1291	1040	2	1	4	3
경기도	고양시덕양구	고양동	고양동제2투	3902	2715	1187	7	2708	1407	1291	1	5	3	1
경기도	고양시덕양구	고양동	고양동제3투	3836	2894	942	5	2889	1495	1384	1	0	8	1
경기도	고양시덕양구	고양동	고양동제4투	4495	3076	1419	15	3061	1609	1438	1	3	4	6
경기도	고양시덕양구	고양동	고양동제5투	1896	1378	518	3	1375	854	514	0	0	4	3
경기도	고양시덕양구	고양동	고양동제6투	3839	2969	870	6	2963	1411	1545	0	0	6	1
경기도	고양시덕양구	고양동	고양동제7투	3621	2787	834	11	2776	1305	1463	0	0	6	2
경기도	고양시덕양구	관산동	소계	23187	16482	6705	55	16427	9135	7225	5	10	42	10
경기도	고양시덕양구	관산동	관산동제1투	2920	1923	997	8	1915	1009	895	0	3	5	3
경기도	고양시덕양구	관산동	관산동제2투	3299	2533	766	6	2527	1404	1115	0	2	6	0
경기도	고양시덕양구	관산동	관산동제3투	2740	2231	509	0	2231	1123	1096	0	1	10	1
경기도	고양시덕양구	관산동	관산동제4투	1765	1223	542	7	1216	680	528	1	0	7	0
경기도	고양시덕양구	관산동	관산동제5투	3483	2430	1053	15	2415	1456	954	0	0	3	2
경기도	고양시덕양구	관산동	관산동제6투	3843	2530	1313	12	2518	1496	1015	3	0	4	0
경기도	고양시덕양구	관산동	관산동제7투	5137	3612	1525	7	3605	1967	1622	1	4	7	4
경기도	고양시덕양구	능곡동	소계	15922	11758	4164	27	11731	6012	5681	1	3	19	15
경기도	고양시덕양구	능곡동	능곡동제1투	4739	3561	1178	8	3553	1799	1744	0	1	5	4
경기도	고양시덕양구	능곡동	능곡동제2투	2501	1768	733	4	1764	883	879	0	0	0	2
경기도	고양시덕양구	능곡동	능곡동제3투	4195	3040	1155	5	3035	1549	1471	0	1	10	4
경기도	고양시덕양구	능곡동	능곡동제4투	1818	1380	438	5	1375	828	540	1	1	1	4
경기도	고양시덕양구	능곡동	능곡동제5투	2669	2009	660	5	2004	953	1047	0	0	3	1
경기도	고양시덕양구	화정1동	소계	33023	25426	7597	59	25367	12537	12729	5	15	56	25
경기도	고양시덕양구	화정1동	화정1동제1투	3350	2795	555	8	2787	1349	1432	0	0	6	0
경기도	고양시덕양구	화정1동	화정1동제2투	3579	2837	742	3	2834	1344	1478	0	1	10	1
경기도	고양시덕양구	화정1동	화정1동제3투	3962	3104	858	10	3094	1326	1756	1	3	4	4
경기도	고양시덕양구	화정1동	화정1동제4투	3288	2616	672	3	2613	1264	1338	0	1	8	2
경기도	고양시덕양구	화정1동	화정1동제5투	4231	3457	774	2	3455	2040	1395	1	3	10	6
경기도	고양시덕양구	화정1동	화정1동제6투	3743	2497	1246	7	2490	1213	1265	0	1	6	5
경기도	고양시덕양구	화정1동	화정1동제7투	3289	2140	1149	7	2133	966	1157	2	2	3	3
경기도	고양시덕양구	화정1동	화정1동제8투	3775	3131	644	10	3121	1810	1304	0	1	5	1
경기도	고양시덕양구	화정1동	화정1동제9투	3806	2849	957	9	2840	1225	1604	1	3	4	3
경기도	고양시덕양구	화정2동	소계	26111	21184	4927	47	21137	8965	12104	3	11	38	16
경기도	고양시덕양구	화정2동	화정2동제1투	4015	3083	932	8	3075	1273	1786	0	1	12	3
경기도	고양시덕양구	화정2동	화정2동제2투	4605	3644	961	8	3636	1337	2283	1	3	9	3
경기도	고양시덕양구	화정2동	화정2동제3투	3933	3260	673	5	3255	1366	1882	1	1	5	0
경기도	고양시덕양구	화정2동	화정2동제4투	3469	2882	587	4	2878	1305	1564	0	2	4	3
경기도	고양시덕양구	화정2동	화정2동제5투	3688	3050	638	4	3046	1356	1681	0	2	5	2
경기도	고양시덕양구	화정2동	화정2동제6투	2712	2293	419	7	2286	1118	1163	0	0	2	3
경기도	고양시덕양구	화정2동	화정2동제7투	3689	2972	717	11	2961	1210	1745	1	2	1	2
경기도	고양시덕양구	행주동	소계	18630	12747	5883	38	12709	6410	6252	1	5	27	14
경기도	고양시덕양구	행주동	행주동제1투	3303	2054	1249	6	2048	986	1058	0	0	3	1
경기도	고양시덕양구	행주동	행주동제2투	3677	2486	1191	4	2482	1246	1229	0	1	3	3
경기도	고양시덕양구	행주동	행주동제3투	3371	2169	1202	6	2163	1048	1108	0	0	4	3
경기도	고양시덕양구	행주동	행주동제4투	3684	2532	1152	11	2521	1225	1285	0	3	6	2
경기도	고양시덕양구	행주동	행주동제5투	1250	966	284	6	960	602	348	0	1	7	2
경기도	고양시덕양구	행주동	행주동제6투	3345	2540	805	5	2535	1303	1224	1	0	4	3
경기도	고양시덕양구	행신1동	소계	19296	15302	3994	34	15268	6973	8251	7	3	27	7
경기도	고양시덕양구	행신1동	행신1동제1투	3786	2865	921	8	2857	1209	1641	2	0	5	0
경기도	고양시덕양구	행신1동	행신1동제2투	3913	3138	775	7	3131	1455	1669	3	0	2	2
경기도	고양시덕양구	행신1동	행신1동제3투	3616	2788	828	8	2780	1309	1460	1	1	8	1
경기도	고양시덕양구	행신1동	행신1동제4투	4077	3301	776	5	3296	1415	1870	1	2	6	2
경기도	고양시덕양구	행신1동	행신1동제5투	3904	3210	694	6	3204	1585	1611	0	0	6	2
경기도	고양시덕양구	행신2동	소계	27743	21869	5874	50	21819	9756	11984	4	11	44	20
경기도	고양시덕양구	행신2동	행신2동제1투	4394	3295	1099	7	3288	1639	1641	1	1	4	2
경기도	고양시덕양구	행신2동	행신2동제2투	3446	2849	597	4	2845	1287	1546	1	2	5	4
경기도	고양시덕양구	행신2동	행신2동제3투	4335	3369	966	5	3364	1715	1634	1	2	8	4
경기도	고양시덕양구	행신2동	행신2동제4투	3968	3166	802	10	3156	1302	1839	0	2	9	4
경기도	고양시덕양구	행신2동	행신2동제5투	4011	3124	887	9	3115	1224	1877	1	1	10	2
경기도	고양시덕양구	행신2동	행신2동제6투	3403	2797	606	7	2790	1119	1668	0	0	3	0
경기도	고양시덕양구	행신2동	행신2동제7투	3703	2896	807	5	2891	1223	1656	0	3	5	4
경기도	고양시덕양구	행신2동	행신2동제8투	483	373	110	3	370	247	123	0	0	0	0
경기도	고양시덕양구	행신3동	소계	38560	30081	8479	81	30000	13337	16561	3	14	61	24
경기도	고양시덕양구	행신3동	행신3동제1투	4747	3690	1057	12	3678	1523	2146	0	3	5	1
경기도	고양시덕양구	행신3동	행신3동제2투	4448	3702	746	9	3693	1553	2129	1	0	9	1
경기도	고양시덕양구	행신3동	행신3동제3투	4529	3774	755	11	3763	1842	1909	1	5	6	0
경기도	고양시덕양구	행신3동	행신3동제4투	3878	3192	686	7	3185	1302	1872	0	2	5	4
경기도	고양시덕양구	행신3동	행신3동제5투	4169	3120	1049	7	3113	1630	1472	0	0	4	7
경기도	고양시덕양구	행신3동	행신3동제6투	4638	3294	1344	7	3287	1468	1808	0	2	8	1
경기도	고양시덕양구	행신3동	행신3동제7투	3327	2154	1173	11	2143	998	1136	0	1	7	1
경기도	고양시덕양구	행신3동	행신3동제8투	4857	3943	914	8	3935	1722	2195	1	1	10	6
경기도	고양시덕양구	행신3동	행신3동제9투	3967	3212	755	9	3203	1299	1894	0	0	7	3
경기도	고양시덕양구	화전동	소계	4469	2887	1582	22	2865	1671	1183	2	1	6	2
경기도	고양시덕양구	화전동	화전동제1투	3192	2007	1185	18	1989	1174	807	1	0	5	2
경기도	고양시덕양구	화전동	화전동제2투	1277	880	397	4	876	497	376	1	1	1	0
경기도	고양시덕양구	대덕동	소계	3928	2829	1099	12	2817	1670	1137	1	0	5	4
경기도	고양시덕양구	대덕동	대덕동제1투	2546	1819	727	6	1813	1059	746	1	0	3	4
경기도	고양시덕양구	대덕동	대덕동제2투	1382	1010	372	6	1004	611	391	0	0	2	0
경기도	고양시일산동구	계	계	219923	167095	52828	448	166647	80535	85504	41	104	336	127
경기도	고양시일산동구	재외투표	재외투표	1957	1424	533	7	1417	546	869	0	1	1	0
경기도	고양시일산동구	국내부재자투표	국내부재자투표	5513	5143	370	79	5064	2334	2686	7	10	9	18
경기도	고양시일산동구	식사동	소계	18970	14924	4046	36	14888	7835	7016	2	5	20	10
경기도	고양시일산동구	식사동	식사동제1투	3797	2827	970	9	2818	1370	1438	0	2	4	4
경기도	고양시일산동구	식사동	식사동제2투	3230	2584	646	10	2574	1420	1146	1	0	4	3
경기도	고양시일산동구	식사동	식사동제3투	4969	3859	1110	8	3851	2055	1792	0	0	3	1
경기도	고양시일산동구	식사동	식사동제4투	3047	2459	588	5	2454	1356	1090	1	1	6	0
경기도	고양시일산동구	식사동	식사동제5투	3927	3195	732	4	3191	1634	1550	0	2	3	2
경기도	고양시일산동구	중산동	소계	33637	25247	8390	55	25192	12169	12941	7	17	47	11
경기도	고양시일산동구	중산동	중산동제1투	3812	2738	1074	6	2732	1294	1430	0	0	6	2
경기도	고양시일산동구	중산동	중산동제2투	4114	3065	1049	4	3061	1469	1579	1	2	9	1
경기도	고양시일산동구	중산동	중산동제3투	4255	3460	795	9	3451	1819	1615	1	5	9	2
경기도	고양시일산동구	중산동	중산동제4투	3883	2818	1065	7	2811	1496	1308	1	2	3	1
경기도	고양시일산동구	중산동	중산동제5투	3592	2567	1025	6	2561	1405	1146	1	3	6	0
경기도	고양시일산동구	중산동	중산동제6투	3472	2592	880	6	2586	1301	1277	1	1	4	2
경기도	고양시일산동구	중산동	중산동제7투	5234	3963	1271	6	3957	1672	2276	0	2	5	2
경기도	고양시일산동구	중산동	중산동제8투	5275	4044	1231	11	4033	1713	2310	2	2	5	1
경기도	고양시일산동구	정발산동	소계	21806	16260	5546	33	16227	7680	8482	3	13	37	12
경기도	고양시일산동구	정발산동	정발산동제1투	4074	2895	1179	3	2892	1308	1571	0	5	7	1
경기도	고양시일산동구	정발산동	정발산동제2투	3522	2586	936	4	2582	1242	1332	0	2	5	1
경기도	고양시일산동구	정발산동	정발산동제3투	4026	3027	999	9	3018	1394	1613	2	3	6	0
경기도	고양시일산동구	정발산동	정발산동제4투	2245	1741	504	3	1738	838	895	0	0	2	3
경기도	고양시일산동구	정발산동	정발산동제5투	4057	3051	1006	7	3044	1396	1638	0	2	5	3
경기도	고양시일산동구	정발산동	정발산동제6투	3882	2960	922	7	2953	1502	1433	1	1	12	4
경기도	고양시일산동구	풍산동	소계	28242	21892	6350	41	21851	10116	11662	2	11	47	13
경기도	고양시일산동구	풍산동	풍산동제1투	4859	3569	1290	9	3560	1734	1817	0	2	3	4
경기도	고양시일산동구	풍산동	풍산동제2투	3552	2800	752	7	2793	1274	1512	0	2	4	1
경기도	고양시일산동구	풍산동	풍산동제3투	3419	2708	711	4	2704	1340	1354	0	2	6	2
경기도	고양시일산동구	풍산동	풍산동제4투	4842	3625	1217	4	3621	1517	2086	0	3	12	3
경기도	고양시일산동구	풍산동	풍산동제5투	3462	2802	660	5	2797	1239	1553	0	0	5	0
경기도	고양시일산동구	풍산동	풍산동제6투	3777	2997	780	5	2992	1324	1657	0	1	9	1
경기도	고양시일산동구	풍산동	풍산동제7투	4331	3391	940	7	3384	1688	1683	2	1	8	2
경기도	고양시일산동구	백석1동	소계	21562	16615	4947	29	16586	7327	9203	4	5	32	15
경기도	고양시일산동구	백석1동	백석1동제1투	2929	2038	891	6	2032	896	1127	2	1	4	2
경기도	고양시일산동구	백석1동	백석1동제2투	3646	2858	788	6	2852	1224	1618	1	2	6	1
경기도	고양시일산동구	백석1동	백석1동제3투	3666	3017	649	5	3012	1257	1750	0	0	2	3
경기도	고양시일산동구	백석1동	백석1동제4투	4190	3390	800	6	3384	1611	1759	1	0	8	5
경기도	고양시일산동구	백석1동	백석1동제5투	4155	2994	1161	4	2990	1304	1677	0	2	5	2
경기도	고양시일산동구	백석1동	백석1동제6투	2976	2318	658	2	2316	1035	1272	0	0	7	2
경기도	고양시일산동구	백석2동	소계	18142	13151	4991	35	13116	5746	7333	6	7	16	8
경기도	고양시일산동구	백석2동	백석2동제1투	4007	3101	906	3	3098	1422	1670	0	1	4	1
경기도	고양시일산동구	백석2동	백석2동제2투	3952	2944	1008	7	2937	1293	1635	2	1	5	1
경기도	고양시일산동구	백석2동	백석2동제3투	4992	3507	1485	19	3488	1663	1812	4	2	4	3
경기도	고양시일산동구	백석2동	백석2동제4투	5191	3599	1592	6	3593	1368	2216	0	3	3	3
경기도	고양시일산동구	마두1동	소계	20329	16318	4011	41	16277	8049	8169	1	12	37	9
경기도	고양시일산동구	마두1동	마두1동제1투	4466	3638	828	10	3628	1745	1869	0	2	10	2
경기도	고양시일산동구	마두1동	마두1동제2투	4136	3517	619	11	3506	1869	1627	1	2	7	0
경기도	고양시일산동구	마두1동	마두1동제3투	4179	3152	1027	5	3147	1522	1620	0	1	4	0
경기도	고양시일산동구	마두1동	마두1동제4투	3958	3255	703	7	3248	1454	1777	0	5	9	3
경기도	고양시일산동구	마두1동	마두1동제5투	3590	2756	834	8	2748	1459	1276	0	2	7	4
경기도	고양시일산동구	마두2동	소계	13106	10699	2407	28	10671	5689	4940	5	5	28	4
경기도	고양시일산동구	마두2동	마두2동제1투	3491	2871	620	8	2863	1555	1295	1	2	8	2
경기도	고양시일산동구	마두2동	마두2동제2투	3656	3052	604	8	3044	1628	1403	2	0	11	0
경기도	고양시일산동구	마두2동	마두2동제3투	2283	1700	583	6	1694	747	939	1	2	3	2
경기도	고양시일산동구	마두2동	마두2동제4투	3676	3076	600	6	3070	1759	1303	1	1	6	0
경기도	고양시일산동구	장항1동	소계	2697	1898	799	9	1889	1224	661	1	0	3	0
경기도	고양시일산동구	장항1동	장항1동투표소	2697	1898	799	9	1889	1224	661	1	0	3	0
경기도	고양시일산동구	장항2동	소계	21616	14989	6627	22	14967	6811	8096	1	9	35	15
경기도	고양시일산동구	장항2동	장항2동제1투	4968	3903	1065	8	3895	1772	2103	0	2	11	7
경기도	고양시일산동구	장항2동	장항2동제2투	3687	3089	598	5	3084	1856	1210	1	3	12	2
경기도	고양시일산동구	장항2동	장항2동제3투	4060	2648	1412	5	2643	1187	1448	0	0	7	1
경기도	고양시일산동구	장항2동	장항2동제4투	4107	2527	1580	3	2524	992	1524	0	1	5	2
경기도	고양시일산동구	장항2동	장항2동제5투	4794	2822	1972	1	2821	1004	1811	0	3	0	3
경기도	고양시일산동구	고봉동	소계	12346	8535	3811	33	8502	5009	3446	2	9	24	12
경기도	고양시일산동구	고봉동	고봉동제1투	4008	2711	1297	9	2702	1620	1064	0	2	16	0
경기도	고양시일산동구	고봉동	고봉동제2투	3947	2662	1285	18	2644	1641	988	2	6	2	5
경기도	고양시일산동구	고봉동	고봉동제3투	4391	3162	1229	6	3156	1748	1394	0	1	6	7
경기도	고양시일산서구	계	계	220417	171813	48604	418	171395	81992	88785	41	87	342	148
경기도	고양시일산서구	재외투표	재외투표	1953	1385	568	8	1377	529	844	0	0	4	0
경기도	고양시일산서구	국내부재자투표	국내부재자투표	5483	5141	342	65	5076	2372	2661	5	9	16	13
경기도	고양시일산서구	일산1동	소계	21365	16119	5246	27	16092	7604	8434	1	6	30	17
경기도	고양시일산서구	일산1동	일산1동제1투	3788	2787	1001	6	2781	1361	1411	1	0	5	3
경기도	고양시일산서구	일산1동	일산1동제2투	2713	1946	767	4	1942	991	939	0	3	6	3
경기도	고양시일산서구	일산1동	일산1동제3투	3405	2563	842	6	2557	1225	1325	0	1	4	2
경기도	고양시일산서구	일산1동	일산1동제4투	4158	3148	1010	4	3144	1368	1769	0	1	4	2
경기도	고양시일산서구	일산1동	일산1동제5투	3950	3087	863	5	3082	1472	1600	0	0	5	5
경기도	고양시일산서구	일산1동	일산1동제6투	3351	2588	763	2	2586	1187	1390	0	1	6	2
경기도	고양시일산서구	일산2동	소계	17316	12802	4514	36	12766	6574	6151	4	8	17	12
경기도	고양시일산서구	일산2동	일산2동제1투	3293	2346	947	7	2339	1149	1182	1	0	2	5
경기도	고양시일산서구	일산2동	일산2동제2투	4109	3423	686	10	3413	1663	1743	1	1	4	1
경기도	고양시일산서구	일산2동	일산2동제3투	3233	2445	788	6	2439	1309	1127	0	0	2	1
경기도	고양시일산서구	일산2동	일산2동제4투	2629	1772	857	3	1769	977	784	2	3	3	0
경기도	고양시일산서구	일산2동	일산2동제5투	4052	2816	1236	10	2806	1476	1315	0	4	6	5
경기도	고양시일산서구	일산3동	소계	28045	23125	4920	46	23079	10180	12821	5	5	48	20
경기도	고양시일산서구	일산3동	일산3동제1투	3392	2671	721	4	2667	1184	1468	0	1	6	8
경기도	고양시일산서구	일산3동	일산3동제2투	4112	3396	716	4	3392	1688	1690	0	0	10	4
경기도	고양시일산서구	일산3동	일산3동제3투	4210	3450	760	4	3446	1460	1975	1	0	9	1
경기도	고양시일산서구	일산3동	일산3동제4투	3067	2549	518	7	2542	1100	1436	3	0	1	2
경기도	고양시일산서구	일산3동	일산3동제5투	4068	3404	664	6	3398	1380	2010	1	1	4	2
경기도	고양시일산서구	일산3동	일산3동제6투	3078	2573	505	4	2569	1141	1422	0	1	4	1
경기도	고양시일산서구	일산3동	일산3동제7투	2782	2262	520	5	2257	920	1327	0	2	6	2
경기도	고양시일산서구	일산3동	일산3동제8투	3336	2820	516	12	2808	1307	1493	0	0	8	0
경기도	고양시일산서구	탄현동	소계	31286	23877	7409	59	23818	10972	12764	3	11	49	19
경기도	고양시일산서구	탄현동	탄현동제1투	3592	2535	1057	5	2530	1274	1242	1	4	5	4
경기도	고양시일산서구	탄현동	탄현동제2투	2945	2322	623	3	2319	1033	1274	1	2	7	2
경기도	고양시일산서구	탄현동	탄현동제3투	4186	3128	1058	16	3112	1450	1646	1	1	6	8
경기도	고양시일산서구	탄현동	탄현동제4투	4212	3302	910	6	3296	1623	1667	0	1	4	1
경기도	고양시일산서구	탄현동	탄현동제5투	4815	3770	1045	11	3759	1666	2084	0	0	9	0
경기도	고양시일산서구	탄현동	탄현동제6투	3970	3128	842	8	3120	1535	1576	0	1	6	2
경기도	고양시일산서구	탄현동	탄현동제7투	3941	2987	954	6	2981	1293	1679	0	2	7	0
경기도	고양시일산서구	탄현동	탄현동제8투	3625	2705	920	4	2701	1098	1596	0	0	5	2
경기도	고양시일산서구	주엽1동	소계	23449	18952	4497	39	18913	9044	9796	4	10	46	13
경기도	고양시일산서구	주엽1동	주엽1동제1투	3795	2887	908	9	2878	1305	1565	1	2	4	1
경기도	고양시일산서구	주엽1동	주엽1동제2투	2979	2470	509	3	2467	1269	1192	0	1	3	2
경기도	고양시일산서구	주엽1동	주엽1동제3투	2975	2466	509	11	2455	1170	1275	0	0	9	1
경기도	고양시일산서구	주엽1동	주엽1동제4투	3609	2965	644	4	2961	1305	1643	1	0	9	3
경기도	고양시일산서구	주엽1동	주엽1동제5투	1918	1462	456	4	1458	614	836	1	3	3	1
경기도	고양시일산서구	주엽1동	주엽1동제6투	2795	2293	502	2	2291	1346	938	1	2	4	0
경기도	고양시일산서구	주엽1동	주엽1동제7투	2990	2434	556	5	2429	1157	1259	0	2	7	4
경기도	고양시일산서구	주엽1동	주엽1동제8투	2388	1975	413	1	1974	878	1088	0	0	7	1
경기도	고양시일산서구	주엽2동	소계	24713	19705	5008	46	19659	9619	9951	9	12	51	17
경기도	고양시일산서구	주엽2동	주엽2동제1투	2829	2227	602	6	2221	1213	995	2	0	9	2
경기도	고양시일산서구	주엽2동	주엽2동제2투	2961	2441	520	6	2435	1096	1326	3	4	5	1
경기도	고양시일산서구	주엽2동	주엽2동제3투	2633	2180	453	4	2176	1081	1084	0	1	8	2
경기도	고양시일산서구	주엽2동	주엽2동제4투	3678	2904	774	12	2892	1387	1492	0	5	3	5
경기도	고양시일산서구	주엽2동	주엽2동제5투	2606	2106	500	5	2101	1081	1011	1	1	5	2
경기도	고양시일산서구	주엽2동	주엽2동제6투	2687	1991	696	5	1986	928	1051	0	0	4	3
경기도	고양시일산서구	주엽2동	주엽2동제7투	3582	2915	667	1	2914	1407	1495	1	0	9	2
경기도	고양시일산서구	주엽2동	주엽2동제8투	3737	2941	796	7	2934	1426	1497	2	1	8	0
경기도	고양시일산서구	대화동	소계	26277	19547	6730	39	19508	9205	10232	4	11	38	18
경기도	고양시일산서구	대화동	대화동제1투	4228	3030	1198	5	3025	1408	1605	1	2	5	4
경기도	고양시일산서구	대화동	대화동제2투	3589	2800	789	4	2796	1303	1476	1	4	6	6
경기도	고양시일산서구	대화동	대화동제3투	4492	3570	922	7	3563	1518	2033	1	0	9	2
경기도	고양시일산서구	대화동	대화동제4투	2650	1950	700	5	1945	972	967	0	1	5	0
경기도	고양시일산서구	대화동	대화동제5투	3406	2417	989	7	2410	1209	1193	0	0	5	3
경기도	고양시일산서구	대화동	대화동제6투	4241	3219	1022	8	3211	1564	1635	0	4	7	1
경기도	고양시일산서구	대화동	대화동제7투	3671	2561	1110	3	2558	1231	1323	1	0	1	2
경기도	고양시일산서구	송포동	소계	12731	10079	2652	14	10065	5227	4807	3	5	17	6
경기도	고양시일산서구	송포동	송포동제1투	4389	3319	1070	5	3314	2088	1219	2	0	3	2
경기도	고양시일산서구	송포동	송포동제2투	4630	3728	902	6	3722	1631	2077	0	3	9	2
경기도	고양시일산서구	송포동	송포동제3투	3712	3032	680	3	3029	1508	1511	1	2	5	2
경기도	고양시일산서구	송산동	소계	27799	21081	6718	39	21042	10666	10324	3	10	26	13
경기도	고양시일산서구	송산동	송산동제1투	3513	2468	1045	7	2461	1362	1093	0	0	3	3
경기도	고양시일산서구	송산동	송산동제2투	3674	2631	1043	10	2621	1422	1192	0	2	3	2
경기도	고양시일산서구	송산동	송산동제3투	4084	3114	970	4	3110	1725	1376	1	0	7	1
경기도	고양시일산서구	송산동	송산동제4투	3051	2136	915	4	2132	1373	750	0	4	3	2
경기도	고양시일산서구	송산동	송산동제5투	3642	2929	713	5	2924	1205	1713	2	1	1	2
경기도	고양시일산서구	송산동	송산동제6투	4392	3471	921	3	3468	1511	1950	0	2	4	1
경기도	고양시일산서구	송산동	송산동제7투	2246	1773	473	6	1767	858	907	0	0	2	0
경기도	고양시일산서구	송산동	송산동제8투	3197	2559	638	0	2559	1210	1343	0	1	3	2
경기도	과천시	계	계	55657	44853	10804	165	44688	22507	21923	10	37	165	46
경기도	과천시	재외투표	재외투표	815	613	202	4	609	232	371	0	0	3	3
경기도	과천시	국내부재자투표	국내부재자투표	1404	1305	99	18	1287	645	632	0	1	8	1
경기도	과천시	중앙동	소계	7873	6503	1370	25	6478	3468	2972	1	3	32	2
경기도	과천시	중앙동	중앙동제1투	2390	1890	500	6	1884	984	888	0	0	11	1
경기도	과천시	중앙동	중앙동제2투	1970	1677	293	5	1672	784	881	0	1	5	1
경기도	과천시	중앙동	중앙동제3투	3513	2936	577	14	2922	1700	1203	1	2	16	0
경기도	과천시	갈현동	소계	10830	8920	1910	31	8889	4504	4330	4	5	40	6
경기도	과천시	갈현동	갈현동제1투	1326	938	388	2	936	573	353	3	0	6	1
경기도	과천시	갈현동	갈현동제2투	2323	1873	450	10	1863	822	1027	0	1	11	2
경기도	과천시	갈현동	갈현동제3투	3389	2886	503	9	2877	1396	1463	0	3	14	1
경기도	과천시	갈현동	갈현동제4투	3792	3223	569	10	3213	1713	1487	1	1	9	2
경기도	과천시	별양동	소계	12158	9775	2383	33	9742	4862	4827	2	7	35	9
경기도	과천시	별양동	별양동제1투	1481	1108	373	5	1103	528	567	0	0	6	2
경기도	과천시	별양동	별양동제2투	2701	2078	623	4	2074	1027	1036	0	1	7	3
경기도	과천시	별양동	별양동제3투	2694	2163	531	5	2158	1026	1126	0	1	3	2
경기도	과천시	별양동	별양동제4투	2254	1907	347	10	1897	1106	777	0	1	13	0
경기도	과천시	별양동	별양동제5투	3028	2519	509	9	2510	1175	1321	2	4	6	2
경기도	과천시	부림동	소계	10407	8444	1963	24	8420	3926	4445	2	11	25	11
경기도	과천시	부림동	부림동제1투	2682	2150	532	8	2142	972	1150	1	4	12	3
경기도	과천시	부림동	부림동제2투	2614	2233	381	4	2229	1065	1152	1	3	5	3
경기도	과천시	부림동	부림동제3투	2494	2085	409	2	2083	931	1143	0	2	5	2
경기도	과천시	부림동	부림동제4투	2617	1976	641	10	1966	958	1000	0	2	3	3
경기도	과천시	과천동	소계	6807	5087	1720	18	5069	2727	2313	1	4	15	9
경기도	과천시	과천동	과천동제1투	1705	1256	449	4	1252	675	567	0	1	4	5
경기도	과천시	과천동	과천동제2투	2064	1524	540	5	1519	911	600	1	3	2	2
경기도	과천시	과천동	과천동제3투	979	732	247	5	727	406	318	0	0	2	1
경기도	과천시	과천동	과천동제4투	2059	1575	484	4	1571	735	828	0	0	7	1
경기도	과천시	문원동	소계	5363	4206	1157	12	4194	2143	2033	0	6	7	5
경기도	과천시	문원동	문원동제1투	2355	1842	513	5	1837	888	942	0	1	3	3
경기도	과천시	문원동	문원동제2투	3008	2364	644	7	2357	1255	1091	0	5	4	2
경기도	의왕시	계	계	119634	94567	25067	248	94319	45541	48412	13	53	218	82
경기도	의왕시	재외투표	재외투표	799	581	218	2	579	203	373	0	0	3	0
경기도	의왕시	국내부재자투표	국내부재자투표	2699	2538	161	46	2492	1224	1247	2	5	7	7
경기도	의왕시	고천동	소계	10529	8201	2328	14	8187	4336	3828	0	6	14	3
경기도	의왕시	고천동	고천동제1투	2446	1717	729	2	1715	927	784	0	2	1	1
경기도	의왕시	고천동	고천동제2투	3686	2857	829	7	2850	1502	1338	0	1	7	2
경기도	의왕시	고천동	고천동제3투	4397	3627	770	5	3622	1907	1706	0	3	6	0
경기도	의왕시	부곡동	소계	20666	15876	4790	41	15835	7803	7958	2	11	40	21
경기도	의왕시	부곡동	부곡동제1투	2860	2243	617	6	2237	1099	1128	0	1	7	2
경기도	의왕시	부곡동	부곡동제2투	2830	2217	613	8	2209	1115	1081	0	2	7	4
경기도	의왕시	부곡동	부곡동제3투	3381	2547	834	6	2541	1155	1377	0	1	3	5
경기도	의왕시	부곡동	부곡동제4투	3783	3034	749	3	3031	1383	1632	1	4	8	3
경기도	의왕시	부곡동	부곡동제5투	3715	2792	923	11	2781	1416	1354	0	1	6	4
경기도	의왕시	부곡동	부곡동제6투	4097	3043	1054	7	3036	1635	1386	1	2	9	3
경기도	의왕시	오전동	소계	33072	26429	6643	58	26371	12783	13505	3	6	56	18
경기도	의왕시	오전동	오전동제1투	3008	2169	839	8	2161	1062	1095	0	1	2	1
경기도	의왕시	오전동	오전동제2투	3423	2588	835	7	2581	1257	1314	1	1	5	3
경기도	의왕시	오전동	오전동제3투	3536	2787	749	5	2782	1407	1365	0	1	4	5
경기도	의왕시	오전동	오전동제4투	3000	2554	446	5	2549	1348	1196	1	0	3	1
경기도	의왕시	오전동	오전동제5투	3559	2972	587	2	2970	1379	1584	0	0	7	0
경기도	의왕시	오전동	오전동제6투	2697	2198	499	5	2193	1093	1087	0	1	10	2
경기도	의왕시	오전동	오전동제7투	3922	3310	612	2	3308	1572	1724	0	1	11	0
경기도	의왕시	오전동	오전동제8투	3664	3089	575	8	3081	1380	1698	0	0	3	0
경기도	의왕시	오전동	오전동제9투	3566	2681	885	11	2670	1311	1347	1	1	6	4
경기도	의왕시	오전동	오전동제10투	2697	2081	616	5	2076	974	1095	0	0	5	2
경기도	의왕시	내손1동	소계	17400	13997	3403	27	13970	6764	7150	2	6	43	5
경기도	의왕시	내손1동	내손1동제1투	3759	2820	939	9	2811	1210	1587	1	1	10	2
경기도	의왕시	내손1동	내손1동제2투	3447	2869	578	6	2863	1587	1268	1	1	5	1
경기도	의왕시	내손1동	내손1동제3투	2937	2290	647	4	2286	962	1317	0	1	6	0
경기도	의왕시	내손1동	내손1동제4투	3997	3249	748	3	3246	1583	1645	0	2	14	2
경기도	의왕시	내손1동	내손1동제5투	3260	2769	491	5	2764	1422	1333	0	1	8	0
경기도	의왕시	내손2동	소계	21462	16522	4940	38	16484	7484	8942	3	11	23	21
경기도	의왕시	내손2동	내손2동제1투	3589	3030	559	2	3028	1307	1714	0	0	3	4
경기도	의왕시	내손2동	내손2동제2투	3694	2988	706	6	2982	1260	1711	1	1	6	3
경기도	의왕시	내손2동	내손2동제3투	3625	2692	933	6	2686	1234	1442	0	4	2	4
경기도	의왕시	내손2동	내손2동제4투	3153	2210	943	8	2202	1080	1112	1	2	2	5
경기도	의왕시	내손2동	내손2동제5투	2300	1629	671	5	1624	751	868	0	2	1	2
경기도	의왕시	내손2동	내손2동제6투	2408	1722	686	4	1718	770	941	1	1	3	2
경기도	의왕시	내손2동	내손2동제7투	2693	2251	442	7	2244	1082	1154	0	1	6	1
경기도	의왕시	청계동	소계	13007	10423	2584	22	10401	4944	5409	1	8	32	7
경기도	의왕시	청계동	청계동제1투	2871	2181	690	4	2177	1261	904	0	4	8	0
경기도	의왕시	청계동	청계동제2투	2645	2190	455	8	2182	1062	1108	0	0	9	3
경기도	의왕시	청계동	청계동제3투	4237	3393	844	4	3389	1506	1867	1	3	10	2
경기도	의왕시	청계동	청계동제4투	3254	2659	595	6	2653	1115	1530	0	1	5	2
경기도	구리시	계	계	150179	113698	36481	336	113362	56748	56219	27	47	209	112
경기도	구리시	재외투표	재외투표	846	617	229	5	612	249	363	0	0	0	0
경기도	구리시	국내부재자투표	국내부재자투표	3492	3311	181	48	3263	1562	1667	2	11	12	9
경기도	구리시	갈매동	소계	1950	1285	665	7	1278	788	482	1	0	4	3
경기도	구리시	갈매동	갈매동제1투	1096	680	416	4	676	431	243	0	0	1	1
경기도	구리시	갈매동	갈매동제2투	854	605	249	3	602	357	239	1	0	3	2
경기도	구리시	동구동	소계	31360	25266	6094	64	25202	12075	13050	5	10	43	19
경기도	구리시	동구동	동구동제1투	2105	1470	635	3	1467	756	709	0	0	2	0
경기도	구리시	동구동	동구동제2투	1357	1004	353	4	1000	695	298	1	2	0	4
경기도	구리시	동구동	동구동제3투	3941	3031	910	6	3025	1494	1523	0	0	6	2
경기도	구리시	동구동	동구동제4투	2896	2404	492	8	2396	1085	1305	0	1	3	2
경기도	구리시	동구동	동구동제5투	2876	2311	565	4	2307	1087	1214	0	1	5	0
경기도	구리시	동구동	동구동제6투	3080	2493	587	10	2483	1065	1411	0	1	4	2
경기도	구리시	동구동	동구동제7투	2928	2388	540	10	2378	1113	1254	3	0	4	4
경기도	구리시	동구동	동구동제8투	2485	2138	347	5	2133	1151	977	0	1	4	0
경기도	구리시	동구동	동구동제9투	3141	2582	559	3	2579	1123	1447	1	1	7	0
경기도	구리시	동구동	동구동제10투	3749	3087	662	6	3081	1438	1632	0	2	8	1
경기도	구리시	동구동	동구동제11투	2802	2358	444	5	2353	1068	1280	0	1	0	4
경기도	구리시	인창동	소계	19522	14852	4670	43	14809	7342	7423	1	5	20	18
경기도	구리시	인창동	인창동제1투	3913	2712	1201	9	2703	1347	1347	1	2	4	2
경기도	구리시	인창동	인창동제2투	3055	2214	841	10	2204	1089	1110	0	0	3	2
경기도	구리시	인창동	인창동제3투	3380	2367	1013	8	2359	1297	1058	0	1	1	2
경기도	구리시	인창동	인창동제4투	3390	2790	600	7	2783	1252	1524	0	1	1	5
경기도	구리시	인창동	인창동제5투	2711	2245	466	4	2241	1062	1170	0	1	4	4
경기도	구리시	인창동	인창동제6투	3073	2524	549	5	2519	1295	1214	0	0	7	3
경기도	구리시	교문1동	소계	14700	10169	4531	35	10134	5481	4613	3	1	26	10
경기도	구리시	교문1동	교문1동제1투	3293	2094	1199	3	2091	1049	1033	2	0	6	1
경기도	구리시	교문1동	교문1동제2투	2439	1602	837	2	1600	874	722	1	0	2	1
경기도	구리시	교문1동	교문1동제3투	3039	2154	885	13	2141	1145	991	0	0	5	0
경기도	구리시	교문1동	교문1동제4투	3172	2187	985	8	2179	1230	938	0	0	5	6
경기도	구리시	교문1동	교문1동제5투	1761	1347	414	7	1340	761	574	0	1	3	1
경기도	구리시	교문1동	교문1동제6투	996	785	211	2	783	422	355	0	0	5	1
경기도	구리시	교문2동	소계	18337	14895	3442	27	14868	7450	7347	4	9	40	18
경기도	구리시	교문2동	교문2동제1투	3129	2557	572	3	2554	1167	1379	0	1	3	4
경기도	구리시	교문2동	교문2동제2투	2693	1901	792	5	1896	957	925	0	0	9	5
경기도	구리시	교문2동	교문2동제3투	2837	2295	542	7	2288	1123	1152	0	2	10	1
경기도	구리시	교문2동	교문2동제4투	2772	2358	414	5	2353	1246	1102	0	0	4	1
경기도	구리시	교문2동	교문2동제5투	3459	2879	580	4	2875	1494	1362	3	2	11	3
경기도	구리시	교문2동	교문2동제6투	3447	2905	542	3	2902	1463	1427	1	4	3	4
경기도	구리시	수택1동	소계	19511	13514	5997	36	13478	7038	6409	3	3	16	9
경기도	구리시	수택1동	수택1동제1투	4852	3206	1646	7	3199	1663	1530	0	0	4	2
경기도	구리시	수택1동	수택1동제2투	2663	1626	1037	2	1624	938	683	1	1	0	1
경기도	구리시	수택1동	수택1동제3투	3620	2351	1269	8	2343	1276	1061	1	0	3	2
경기도	구리시	수택1동	수택1동제4투	4360	3316	1044	8	3308	1759	1540	1	2	5	1
경기도	구리시	수택1동	수택1동제5투	4016	3015	1001	11	3004	1402	1595	0	0	4	3
경기도	구리시	수택2동	소계	22434	15826	6608	53	15773	8065	7651	8	6	26	17
경기도	구리시	수택2동	수택2동제1투	3765	2597	1168	8	2589	1333	1245	2	0	4	5
경기도	구리시	수택2동	수택2동제2투	3436	2506	930	9	2497	1248	1239	0	1	7	2
경기도	구리시	수택2동	수택2동제3투	3626	2513	1113	15	2498	1355	1137	2	1	1	2
경기도	구리시	수택2동	수택2동제4투	2793	1910	883	6	1904	1047	848	2	1	3	3
경기도	구리시	수택2동	수택2동제5투	3634	2598	1036	6	2592	1190	1394	2	2	3	1
경기도	구리시	수택2동	수택2동제6투	2131	1471	660	3	1468	768	695	0	1	3	1
경기도	구리시	수택2동	수택2동제7투	3049	2231	818	6	2225	1124	1093	0	0	5	3
경기도	구리시	수택3동	소계	18027	13963	4064	18	13945	6698	7214	0	2	22	9
경기도	구리시	수택3동	수택3동제1투	4047	3097	950	1	3096	1379	1709	0	0	7	1
경기도	구리시	수택3동	수택3동제2투	3523	2901	622	5	2896	1505	1387	0	0	2	2
경기도	구리시	수택3동	수택3동제3투	4480	3766	714	6	3760	1851	1899	0	2	4	4
경기도	구리시	수택3동	수택3동제4투	3360	2183	1177	4	2179	1073	1102	0	0	3	1
경기도	구리시	수택3동	수택3동제5투	2617	2016	601	2	2014	890	1117	0	0	6	1
경기도	남양주시	계	계	454216	335323	118893	1099	334224	171230	161920	85	142	524	323
경기도	남양주시	재외투표	재외투표	2243	1569	674	9	1560	631	921	2	2	4	0
경기도	남양주시	국내부재자투표	국내부재자투표	9567	8967	600	168	8799	4278	4410	18	17	27	49
경기도	남양주시	와부읍	소계	52785	41485	11300	119	41366	21243	19982	6	23	75	37
경기도	남양주시	와부읍	와부읍제1투	4928	3819	1109	13	3806	1821	1977	1	1	5	1
경기도	남양주시	와부읍	와부읍제2투	4339	2868	1471	8	2860	1641	1205	2	1	6	5
경기도	남양주시	와부읍	와부읍제3투	3788	3098	690	8	3090	1442	1634	1	1	8	4
경기도	남양주시	와부읍	와부읍제4투	4527	3537	990	17	3520	1793	1722	0	1	4	0
경기도	남양주시	와부읍	와부읍제5투	1151	863	288	4	859	558	293	0	2	3	3
경기도	남양주시	와부읍	와부읍제6투	799	616	183	1	615	410	201	0	1	2	1
경기도	남양주시	와부읍	와부읍제7투	4262	3429	833	7	3422	1673	1731	1	2	12	3
경기도	남양주시	와부읍	와부읍제8투	3461	2796	665	8	2788	1415	1362	1	3	7	0
경기도	남양주시	와부읍	와부읍제9투	2509	1821	688	1	1820	1106	708	0	2	1	3
경기도	남양주시	와부읍	와부읍제10투	3192	2510	682	2	2508	1223	1278	0	2	2	3
경기도	남양주시	와부읍	와부읍제11투	4196	3439	757	10	3429	1544	1869	0	3	9	4
경기도	남양주시	와부읍	와부읍제12투	855	630	225	4	626	422	203	0	0	0	1
경기도	남양주시	와부읍	와부읍제13투	2985	2459	526	5	2454	1433	1017	0	0	4	0
경기도	남양주시	와부읍	와부읍제14투	3393	2709	684	5	2704	1442	1255	0	2	3	2
경기도	남양주시	와부읍	와부읍제15투	2834	2413	421	10	2403	1179	1217	0	1	1	5
경기도	남양주시	와부읍	와부읍제16투	3273	2609	664	7	2602	1326	1270	0	0	4	2
경기도	남양주시	와부읍	와부읍제17투	2293	1869	424	9	1860	815	1040	0	1	4	0
경기도	남양주시	진접읍	소계	69492	49186	20306	122	49064	24721	24223	9	14	64	33
경기도	남양주시	진접읍	진접읍제1투	5573	3720	1853	3	3717	1881	1823	2	2	6	3
경기도	남양주시	진접읍	진접읍제2투	4422	3184	1238	11	3173	1638	1526	1	1	6	1
경기도	남양주시	진접읍	진접읍제3투	4106	3007	1099	8	2999	1514	1480	1	0	3	1
경기도	남양주시	진접읍	진접읍제4투	3839	2568	1271	9	2559	1510	1041	0	3	3	2
경기도	남양주시	진접읍	진접읍제5투	3418	2298	1120	2	2296	1303	988	1	0	2	2
경기도	남양주시	진접읍	진접읍제6투	4624	3253	1371	5	3248	1777	1465	0	1	2	3
경기도	남양주시	진접읍	진접읍제7투	5492	3981	1511	11	3970	2088	1875	1	0	2	4
경기도	남양주시	진접읍	진접읍제8투	4885	3394	1491	8	3386	1833	1547	0	1	1	4
경기도	남양주시	진접읍	진접읍제9투	3897	2727	1170	13	2714	1604	1099	1	0	5	5
경기도	남양주시	진접읍	진접읍제10투	4188	3129	1059	7	3122	1365	1750	0	2	5	0
경기도	남양주시	진접읍	진접읍제11투	4140	3011	1129	7	3004	1515	1482	0	1	4	2
경기도	남양주시	진접읍	진접읍제12투	6300	4354	1946	10	4344	2012	2321	1	2	8	0
경기도	남양주시	진접읍	진접읍제13투	4596	3571	1025	9	3562	1430	2125	0	0	4	3
경기도	남양주시	진접읍	진접읍제14투	4702	3480	1222	8	3472	1426	2036	1	1	7	1
경기도	남양주시	진접읍	진접읍제15투	5310	3509	1801	11	3498	1825	1665	0	0	6	2
경기도	남양주시	화도읍	소계	70739	49389	21350	120	49269	25664	23441	16	23	75	50
경기도	남양주시	화도읍	화도읍제1투	3930	2863	1067	10	2853	1504	1343	1	2	2	1
경기도	남양주시	화도읍	화도읍제2투	3840	2541	1299	8	2533	1200	1324	0	2	4	3
경기도	남양주시	화도읍	화도읍제3투	3897	2701	1196	5	2696	1527	1156	2	1	5	5
경기도	남양주시	화도읍	화도읍제4투	4571	3262	1309	11	3251	1709	1528	0	5	8	1
경기도	남양주시	화도읍	화도읍제5투	5605	3770	1835	6	3764	2052	1699	3	0	3	7
경기도	남양주시	화도읍	화도읍제6투	4243	2970	1273	10	2960	1600	1349	1	1	7	2
경기도	남양주시	화도읍	화도읍제7투	6004	4052	1952	10	4042	2184	1849	1	0	1	7
경기도	남양주시	화도읍	화도읍제8투	3974	2898	1076	5	2893	1362	1524	0	0	4	3
경기도	남양주시	화도읍	화도읍제9투	3472	2470	1002	3	2467	1269	1191	1	1	3	2
경기도	남양주시	화도읍	화도읍제10투	4211	3303	908	13	3290	1587	1695	0	0	8	0
경기도	남양주시	화도읍	화도읍제11투	3401	2587	814	3	2584	1157	1417	1	3	5	1
경기도	남양주시	화도읍	화도읍제12투	3326	2226	1100	2	2224	1459	756	1	1	4	3
경기도	남양주시	화도읍	화도읍제13투	1338	909	429	3	906	573	330	0	0	3	0
경기도	남양주시	화도읍	화도읍제14투	3864	2892	972	5	2887	1314	1562	1	0	5	5
경기도	남양주시	화도읍	화도읍제15투	5302	3173	2129	11	3162	1663	1488	3	2	5	1
경기도	남양주시	화도읍	화도읍제16투	3087	2098	989	4	2094	1085	1001	0	2	1	5
경기도	남양주시	화도읍	화도읍제17투	3059	2205	854	6	2199	1199	992	1	2	5	0
경기도	남양주시	화도읍	화도읍제18투	3615	2469	1146	5	2464	1220	1237	0	1	2	4
경기도	남양주시	진건읍	소계	22755	16209	6546	67	16142	8933	7163	3	4	20	19
경기도	남양주시	진건읍	진건읍제1투	4015	2547	1468	9	2538	1416	1113	1	1	5	2
경기도	남양주시	진건읍	진건읍제2투	1169	860	309	4	856	559	293	0	0	1	3
경기도	남양주시	진건읍	진건읍제3투	2207	1553	654	7	1546	987	551	0	2	4	2
경기도	남양주시	진건읍	진건읍제4투	3444	2538	906	14	2524	1247	1271	0	0	3	3
경기도	남양주시	진건읍	진건읍제5투	4420	3204	1216	13	3191	1780	1403	0	1	3	4
경기도	남양주시	진건읍	진건읍제6투	4869	3713	1156	13	3700	1896	1797	1	0	3	3
경기도	남양주시	진건읍	진건읍제7투	2631	1794	837	7	1787	1048	735	1	0	1	2
경기도	남양주시	오남읍	소계	40236	28462	11774	64	28398	13683	14656	3	8	33	15
경기도	남양주시	오남읍	오남읍제1투	4393	2750	1643	6	2744	1462	1274	0	1	3	4
경기도	남양주시	오남읍	오남읍제2투	4474	3313	1161	7	3306	1548	1752	0	0	3	3
경기도	남양주시	오남읍	오남읍제3투	5566	3795	1771	14	3781	2014	1762	1	1	3	0
경기도	남양주시	오남읍	오남읍제4투	4430	2887	1543	8	2879	1553	1318	1	0	5	2
경기도	남양주시	오남읍	오남읍제5투	4578	3166	1412	3	3163	1543	1615	0	1	2	2
경기도	남양주시	오남읍	오남읍제6투	4054	2960	1094	5	2955	1377	1571	0	0	5	2
경기도	남양주시	오남읍	오남읍제7투	2905	2152	753	6	2146	968	1177	0	0	1	0
경기도	남양주시	오남읍	오남읍제8투	4725	3342	1383	8	3334	1513	1814	0	2	4	1
경기도	남양주시	오남읍	오남읍제9투	5111	4097	1014	7	4090	1705	2373	1	3	7	1
경기도	남양주시	별내면	소계	16811	12628	4183	48	12580	6268	6271	4	1	27	9
경기도	남양주시	별내면	별내면제1투	1684	1063	621	7	1056	701	354	0	0	1	0
경기도	남양주시	별내면	별내면제2투	3634	2859	775	5	2854	1329	1510	2	0	10	3
경기도	남양주시	별내면	별내면제3투	4019	2940	1079	16	2924	1542	1377	1	1	2	1
경기도	남양주시	별내면	별내면제4투	3607	2824	783	9	2815	1288	1515	1	0	8	3
경기도	남양주시	별내면	별내면제5투	3867	2942	925	11	2931	1408	1515	0	0	6	2
경기도	남양주시	퇴계원면	소계	22185	16523	5662	46	16477	8458	7985	2	2	17	13
경기도	남양주시	퇴계원면	퇴계원면제1투	4902	3802	1100	9	3793	1948	1841	1	0	3	0
경기도	남양주시	퇴계원면	퇴계원면제2투	4337	2967	1370	7	2960	1547	1408	0	1	2	2
경기도	남양주시	퇴계원면	퇴계원면제3투	4716	3430	1286	11	3419	1805	1605	0	1	3	5
경기도	남양주시	퇴계원면	퇴계원면제4투	4212	3135	1077	9	3126	1617	1502	0	0	3	4
경기도	남양주시	퇴계원면	퇴계원면제5투	4018	3189	829	10	3179	1541	1629	1	0	6	2
경기도	남양주시	수동면	소계	7019	4762	2257	48	4714	3086	1596	1	2	10	19
경기도	남양주시	수동면	수동면제1투	4238	2840	1398	36	2804	1837	946	0	2	5	14
경기도	남양주시	수동면	수동면제2투	2781	1922	859	12	1910	1249	650	1	0	5	5
경기도	남양주시	조안면	소계	3552	2681	871	6	2675	1773	893	1	0	6	2
경기도	남양주시	조안면	조안면제1투	1793	1342	451	2	1340	928	408	1	0	3	0
경기도	남양주시	조안면	조안면제2투	1759	1339	420	4	1335	845	485	0	0	3	2
경기도	남양주시	호평동	소계	29092	22024	7068	60	21964	9975	11929	1	13	33	13
경기도	남양주시	호평동	호평동제1투	3580	2399	1181	6	2393	1133	1249	0	2	6	3
경기도	남양주시	호평동	호평동제2투	5379	3991	1388	9	3982	1765	2208	0	1	5	3
경기도	남양주시	호평동	호평동제3투	3760	2919	841	6	2913	1290	1619	0	2	2	0
경기도	남양주시	호평동	호평동제4투	3541	2750	791	7	2743	1171	1566	0	1	4	1
경기도	남양주시	호평동	호평동제5투	4418	3383	1035	10	3373	1574	1792	0	2	3	2
경기도	남양주시	호평동	호평동제6투	3313	2691	622	4	2687	1163	1515	0	2	6	1
경기도	남양주시	호평동	호평동제7투	5101	3891	1210	18	3873	1879	1980	1	3	7	3
경기도	남양주시	평내동	소계	29612	22244	7368	51	22193	10379	11750	6	9	38	11
경기도	남양주시	평내동	평내동제1투	4611	3312	1299	16	3296	1720	1568	3	1	3	1
경기도	남양주시	평내동	평내동제2투	5293	3635	1658	8	3627	1852	1762	0	0	8	5
경기도	남양주시	평내동	평내동제3투	4420	3474	946	7	3467	1420	2039	1	0	7	0
경기도	남양주시	평내동	평내동제4투	3295	2590	705	4	2586	1195	1383	0	2	6	0
경기도	남양주시	평내동	평내동제5투	5680	4289	1391	7	4282	2022	2254	0	2	3	1
경기도	남양주시	평내동	평내동제6투	3260	2466	794	6	2460	1021	1427	1	3	5	3
경기도	남양주시	평내동	평내동제7투	3053	2478	575	3	2475	1149	1317	1	1	6	1
경기도	남양주시	금곡동	소계	18367	13071	5296	46	13025	7319	5675	2	8	11	10
경기도	남양주시	금곡동	금곡동제1투	4477	2936	1541	12	2924	1697	1220	1	4	1	1
경기도	남양주시	금곡동	금곡동제2투	3112	2227	885	2	2225	1262	957	1	0	2	3
경기도	남양주시	금곡동	금곡동제3투	3498	2489	1009	9	2480	1339	1141	0	0	0	0
경기도	남양주시	금곡동	금곡동제4투	3068	2154	914	6	2148	1229	912	0	1	4	2
경기도	남양주시	금곡동	금곡동제5투	4212	3265	947	17	3248	1792	1445	0	3	4	4
경기도	남양주시	양정동	소계	4828	3436	1392	8	3428	2159	1250	3	2	7	7
경기도	남양주시	양정동	양정동제1투	2911	2052	859	3	2049	1284	751	2	1	6	5
경기도	남양주시	양정동	양정동제2투	1917	1384	533	5	1379	875	499	1	1	1	2
경기도	남양주시	지금동	소계	14109	10734	3375	27	10707	5527	5147	3	4	13	13
경기도	남양주시	지금동	지금동제1투	2358	1689	669	5	1684	946	732	0	1	3	2
경기도	남양주시	지금동	지금동제2투	2801	2125	676	3	2122	1057	1061	0	1	2	1
경기도	남양주시	지금동	지금동제3투	987	737	250	2	735	500	233	0	0	2	0
경기도	남양주시	지금동	지금동제4투	4333	3229	1104	11	3218	1687	1520	0	2	3	6
경기도	남양주시	지금동	지금동제5투	3630	2954	676	6	2948	1337	1601	3	0	3	4
경기도	남양주시	도농동	소계	28969	22669	6300	65	22604	12304	10225	1	8	49	17
경기도	남양주시	도농동	도농동제1투	4459	2964	1495	17	2947	1607	1331	0	1	2	6
경기도	남양주시	도농동	도농동제2투	4301	3268	1033	7	3261	1606	1647	0	2	5	1
경기도	남양주시	도농동	도농동제3투	4736	3619	1117	14	3605	1770	1824	0	1	9	1
경기도	남양주시	도농동	도농동제4투	3045	2513	532	8	2505	1471	1021	0	0	10	3
경기도	남양주시	도농동	도농동제5투	3737	3132	605	5	3127	1732	1386	0	0	6	3
경기도	남양주시	도농동	도농동제6투	4690	3893	797	11	3882	2141	1727	1	2	9	2
경기도	남양주시	도농동	도농동제7투	4001	3280	721	3	3277	1977	1289	0	2	8	1
경기도	남양주시	별내동	소계	11855	9284	2571	25	9259	4829	4403	4	2	15	6
경기도	남양주시	별내동	별내동제1투	2178	1675	503	2	1673	890	778	1	1	1	2
경기도	남양주시	별내동	별내동제2투	3080	2481	599	6	2475	1222	1244	1	0	7	1
경기도	남양주시	별내동	별내동제3투	3420	2535	885	10	2525	1372	1145	1	1	3	3
경기도	남양주시	별내동	별내동제4투	3177	2593	584	7	2586	1345	1236	1	0	4	0
경기도	오산시	계	계	147979	106486	41493	290	106196	52301	53507	26	67	166	129
경기도	오산시	재외투표	재외투표	468	299	169	2	297	109	186	0	1	1	0
경기도	오산시	국내부재자투표	국내부재자투표	2784	2603	181	44	2559	1298	1231	4	6	9	11
경기도	오산시	중앙동	소계	21512	15952	5560	33	15919	8123	7740	3	11	23	19
경기도	오산시	중앙동	중앙동제1투	2040	1363	677	6	1357	863	486	0	2	4	2
경기도	오산시	중앙동	중앙동제2투	3904	2586	1318	6	2580	1527	1043	1	4	2	3
경기도	오산시	중앙동	중앙동제3투	4675	3423	1252	6	3417	1444	1960	0	2	5	6
경기도	오산시	중앙동	중앙동제4투	3162	2473	689	1	2472	1248	1216	0	1	2	5
경기도	오산시	중앙동	중앙동제5투	4428	3487	941	12	3475	1965	1502	0	1	5	2
경기도	오산시	중앙동	중앙동제6투	3303	2620	683	2	2618	1076	1533	2	1	5	1
경기도	오산시	대원동	소계	45840	34826	11014	67	34759	17049	17607	10	12	56	25
경기도	오산시	대원동	대원동제1투	4051	2631	1420	4	2627	1628	992	1	0	4	2
경기도	오산시	대원동	대원동제2투	2516	1947	569	3	1944	945	993	1	2	2	1
경기도	오산시	대원동	대원동제3투	2780	2059	721	6	2053	934	1115	0	1	3	0
경기도	오산시	대원동	대원동제4투	4421	3115	1306	9	3106	1640	1454	1	1	5	5
경기도	오산시	대원동	대원동제5투	2348	1992	356	4	1988	979	1002	0	2	4	1
경기도	오산시	대원동	대원동제6투	3104	2607	497	5	2602	1242	1355	0	1	3	1
경기도	오산시	대원동	대원동제7투	3379	2673	706	6	2667	1363	1295	1	0	6	2
경기도	오산시	대원동	대원동제8투	4732	3647	1085	5	3642	1625	2005	0	1	8	3
경기도	오산시	대원동	대원동제9투	4046	3057	989	5	3052	1569	1470	1	1	5	6
경기도	오산시	대원동	대원동제10투	2597	2012	585	5	2007	876	1128	0	0	3	0
경기도	오산시	대원동	대원동제11투	4522	3691	831	2	3689	1655	2026	2	0	4	2
경기도	오산시	대원동	대원동제12투	2636	1989	647	2	1987	946	1031	2	2	4	2
경기도	오산시	대원동	대원동제13투	2392	1784	608	6	1778	866	910	0	0	2	0
경기도	오산시	대원동	대원동제14투	2316	1622	694	5	1617	781	831	1	1	3	0
경기도	오산시	남촌동	소계	19295	10619	8676	34	10585	4967	5561	4	14	14	25
경기도	오산시	남촌동	남촌동제1투	2759	1912	847	4	1908	1108	784	2	2	5	7
경기도	오산시	남촌동	남촌동제2투	2210	1433	777	11	1422	837	577	1	1	0	6
경기도	오산시	남촌동	남촌동제3투	3151	1503	1648	5	1498	616	877	0	3	2	0
경기도	오산시	남촌동	남촌동제4투	3082	2433	649	4	2429	1116	1303	1	1	4	4
경기도	오산시	남촌동	남촌동제5투	4580	1910	2670	8	1902	743	1150	0	3	2	4
경기도	오산시	남촌동	남촌동제6투	3513	1428	2085	2	1426	547	870	0	4	1	4
경기도	오산시	신장동	소계	34871	24807	10064	56	24751	12286	12393	2	11	34	25
경기도	오산시	신장동	신장동제1투	3303	2304	999	7	2297	1386	904	0	2	1	4
경기도	오산시	신장동	신장동제2투	2328	1691	637	4	1687	963	717	0	2	1	4
경기도	오산시	신장동	신장동제3투	3111	2284	827	17	2267	1227	1035	0	0	4	1
경기도	오산시	신장동	신장동제4투	4636	3330	1306	7	3323	1865	1448	0	0	7	3
경기도	오산시	신장동	신장동제5투	5013	3548	1465	7	3541	1643	1888	0	2	5	3
경기도	오산시	신장동	신장동제6투	3944	2653	1291	4	2649	1272	1369	1	1	5	1
경기도	오산시	신장동	신장동제7투	4450	2959	1491	2	2957	1301	1649	1	1	2	3
경기도	오산시	신장동	신장동제8투	4926	3597	1329	6	3591	1569	2012	0	0	6	4
경기도	오산시	신장동	신장동제9투	3160	2441	719	2	2439	1060	1371	0	3	3	2
경기도	오산시	세마동	소계	10883	8479	2404	30	8449	4069	4343	1	8	17	11
경기도	오산시	세마동	세마동제1투	3844	2771	1073	19	2752	1526	1211	0	1	7	7
경기도	오산시	세마동	세마동제2투	3326	2590	736	7	2583	1170	1402	0	5	5	1
경기도	오산시	세마동	세마동제3투	3713	3118	595	4	3114	1373	1730	1	2	5	3
경기도	오산시	초평동	소계	12326	8901	3425	24	8877	4400	4446	2	4	12	13
경기도	오산시	초평동	초평동제1투	2610	1743	867	7	1736	1041	690	1	0	2	2
경기도	오산시	초평동	초평동제2투	2882	2098	784	6	2092	1053	1029	1	1	5	3
경기도	오산시	초평동	초평동제3투	2107	1493	614	3	1490	699	785	0	1	1	4
경기도	오산시	초평동	초평동제4투	1996	1606	390	3	1603	711	888	0	1	2	1
경기도	오산시	초평동	초평동제5투	2731	1961	770	5	1956	896	1054	0	1	2	3
경기도	화성시	계	계	385169	288704	96465	785	287919	140538	146338	75	167	472	329
경기도	화성시	재외투표	재외투표	1621	1133	488	8	1125	423	700	0	1	1	0
경기도	화성시	국내부재자투표	국내부재자투표	7655	7116	539	140	6976	3457	3455	8	10	17	29
경기도	화성시	봉담읍	소계	46951	34920	12031	76	34844	16795	17936	8	26	50	29
경기도	화성시	봉담읍	봉담읍제1투	3835	2833	1002	4	2829	1365	1456	0	2	5	1
경기도	화성시	봉담읍	봉담읍제2투	3148	2249	899	4	2245	1136	1101	0	1	3	4
경기도	화성시	봉담읍	봉담읍제3투	3615	2613	1002	5	2608	1642	955	2	2	4	3
경기도	화성시	봉담읍	봉담읍제4투	3956	2783	1173	7	2776	1557	1209	0	0	6	4
경기도	화성시	봉담읍	봉담읍제5투	3286	2504	782	9	2495	1363	1125	0	0	5	2
경기도	화성시	봉담읍	봉담읍제6투	4791	3450	1341	11	3439	1519	1912	0	3	2	3
경기도	화성시	봉담읍	봉담읍제7투	1813	1358	455	3	1355	614	739	1	0	1	0
경기도	화성시	봉담읍	봉담읍제8투	4110	2822	1288	6	2816	1261	1541	0	7	7	0
경기도	화성시	봉담읍	봉담읍제9투	4012	3257	755	6	3251	1259	1982	1	2	6	1
경기도	화성시	봉담읍	봉담읍제10투	4237	3385	852	5	3380	1667	1703	1	3	3	3
경기도	화성시	봉담읍	봉담읍제11투	4934	3719	1215	8	3711	1687	2008	1	3	7	5
경기도	화성시	봉담읍	봉담읍제12투	5214	3947	1267	8	3939	1725	2205	2	3	1	3
경기도	화성시	우정읍	소계	13364	9392	3972	36	9356	5714	3586	4	11	21	20
경기도	화성시	우정읍	우정읍제1투	2519	1740	779	6	1734	1092	631	0	3	5	3
경기도	화성시	우정읍	우정읍제2투	2326	1666	660	7	1659	1194	458	0	0	3	4
경기도	화성시	우정읍	우정읍제3투	3253	2220	1033	9	2211	1330	871	2	1	3	4
경기도	화성시	우정읍	우정읍제4투	1944	1423	521	3	1420	583	829	0	2	6	0
경기도	화성시	우정읍	우정읍제5투	1779	1279	500	5	1274	780	485	1	3	3	2
경기도	화성시	우정읍	우정읍제6투	1543	1064	479	6	1058	735	312	1	2	1	7
경기도	화성시	향남읍	소계	39334	28503	10831	69	28434	13718	14598	8	28	53	29
경기도	화성시	향남읍	향남읍제1투	3254	2046	1208	8	2038	1121	912	0	1	2	2
경기도	화성시	향남읍	향남읍제2투	3355	2145	1210	4	2141	1211	920	2	3	2	3
경기도	화성시	향남읍	향남읍제3투	1208	873	335	1	872	575	290	0	0	5	2
경기도	화성시	향남읍	향남읍제4투	1617	1133	484	10	1123	755	361	1	1	3	2
경기도	화성시	향남읍	향남읍제5투	3343	2353	990	3	2350	1309	1031	0	3	4	3
경기도	화성시	향남읍	향남읍제6투	3504	2402	1102	5	2397	1180	1209	1	2	2	3
경기도	화성시	향남읍	향남읍제7투	2184	1712	472	4	1708	829	871	1	1	3	3
경기도	화성시	향남읍	향남읍제8투	2895	2270	625	4	2266	1099	1161	0	0	4	2
경기도	화성시	향남읍	향남읍제9투	4432	3316	1116	4	3312	1341	1957	0	2	11	1
경기도	화성시	향남읍	향남읍제10투	5332	4082	1250	10	4072	1715	2345	0	5	6	1
경기도	화성시	향남읍	향남읍제11투	2114	1726	388	3	1723	640	1075	1	3	2	2
경기도	화성시	향남읍	향남읍제12투	3888	2648	1240	10	2638	1192	1430	2	3	7	4
경기도	화성시	향남읍	향남읍제13투	2208	1797	411	3	1794	751	1036	0	4	2	1
경기도	화성시	매송면	소계	7093	5140	1953	15	5125	3130	1970	1	0	13	11
경기도	화성시	매송면	매송면제1투	2837	2011	826	6	2005	1214	780	1	0	5	5
경기도	화성시	매송면	매송면제2투	1898	1404	494	2	1402	838	557	0	0	5	2
경기도	화성시	매송면	매송면제3투	2358	1725	633	7	1718	1078	633	0	0	3	4
경기도	화성시	비봉면	소계	5190	3783	1407	5	3778	2562	1202	1	0	6	7
경기도	화성시	비봉면	비봉면제1투	2816	2011	805	2	2009	1327	674	0	0	4	4
경기도	화성시	비봉면	비봉면제2투	1559	1185	374	3	1182	832	345	0	0	2	3
경기도	화성시	비봉면	비봉면제3투	815	587	228	0	587	403	183	1	0	0	0
경기도	화성시	마도면	소계	5179	3713	1466	11	3702	2515	1170	3	1	6	7
경기도	화성시	마도면	마도면제1투	3336	2364	972	6	2358	1576	772	2	0	4	4
경기도	화성시	마도면	마도면제2투	1843	1349	494	5	1344	939	398	1	1	2	3
경기도	화성시	송산면	소계	9307	6422	2885	25	6397	4643	1720	2	4	9	19
경기도	화성시	송산면	송산면제1투	5101	3419	1682	9	3410	2369	1026	1	2	4	8
경기도	화성시	송산면	송산면제2투	1705	1230	475	9	1221	940	275	0	0	2	4
경기도	화성시	송산면	송산면제3투	2501	1773	728	7	1766	1334	419	1	2	3	7
경기도	화성시	서신면	소계	5863	4008	1855	25	3983	2802	1162	1	3	2	13
경기도	화성시	서신면	서신면제1투	2048	1408	640	10	1398	1024	370	0	2	0	2
경기도	화성시	서신면	서신면제2투	2315	1560	755	8	1552	1052	494	1	0	1	4
경기도	화성시	서신면	서신면제3투	1500	1040	460	7	1033	726	298	0	1	1	7
경기도	화성시	팔탄면	소계	8898	6016	2882	23	5993	3714	2250	5	1	7	16
경기도	화성시	팔탄면	팔탄면제1투	4540	3062	1478	12	3050	1823	1211	3	1	5	7
경기도	화성시	팔탄면	팔탄면제2투	1903	1304	599	4	1300	860	432	2	0	2	4
경기도	화성시	팔탄면	팔탄면제3투	2455	1650	805	7	1643	1031	607	0	0	0	5
경기도	화성시	장안면	소계	9152	6287	2865	50	6237	3846	2335	5	7	15	29
경기도	화성시	장안면	장안면제1투	4421	2923	1498	9	2914	1705	1197	0	0	6	6
경기도	화성시	장안면	장안면제2투	2474	1741	733	35	1706	1112	566	5	4	3	16
경기도	화성시	장안면	장안면제3투	1273	910	363	3	907	568	330	0	1	2	6
경기도	화성시	장안면	장안면제4투	984	713	271	3	710	461	242	0	2	4	1
경기도	화성시	양감면	소계	3770	2742	1028	7	2735	1786	937	0	2	4	6
경기도	화성시	양감면	양감면제1투	1872	1339	533	2	1337	862	468	0	1	2	4
경기도	화성시	양감면	양감면제2투	1898	1403	495	5	1398	924	469	0	1	2	2
경기도	화성시	정남면	소계	10433	7300	3133	20	7280	4522	2735	1	5	9	8
경기도	화성시	정남면	정남면제1투	2938	2065	873	4	2061	1341	715	1	2	1	1
경기도	화성시	정남면	정남면제2투	2298	1521	777	4	1517	1026	486	0	1	3	1
경기도	화성시	정남면	정남면제3투	2967	2112	855	8	2104	1324	773	0	2	2	3
경기도	화성시	정남면	정남면제4투	2230	1602	628	4	1598	831	761	0	0	3	3
경기도	화성시	동탄면	소계	3409	2431	978	8	2423	1431	988	0	0	1	3
경기도	화성시	동탄면	동탄면제1투	2812	1980	832	8	1972	1103	865	0	0	1	3
경기도	화성시	동탄면	동탄면제2투	597	451	146	0	451	328	123	0	0	0	0
경기도	화성시	남양동	소계	18528	12898	5630	28	12870	7142	5684	3	4	18	19
경기도	화성시	남양동	남양동제1투	3180	2172	1008	8	2164	1185	966	1	2	6	4
경기도	화성시	남양동	남양동제2투	5133	3659	1474	7	3652	2060	1582	1	1	4	4
경기도	화성시	남양동	남양동제3투	4122	2793	1329	10	2783	1720	1054	0	0	2	7
경기도	화성시	남양동	남양동제4투	1271	914	357	1	913	651	255	1	0	2	4
경기도	화성시	남양동	남양동제5투	4822	3360	1462	2	3358	1526	1827	0	1	4	0
경기도	화성시	진안동	소계	26693	19253	7440	25	19228	8043	11132	4	9	26	14
경기도	화성시	진안동	진안동제1투	4263	2785	1478	5	2780	1269	1500	0	2	2	7
경기도	화성시	진안동	진안동제2투	6629	4398	2231	5	4393	1489	2893	3	1	3	4
경기도	화성시	진안동	진안동제3투	2781	2289	492	5	2284	1074	1197	1	2	9	1
경기도	화성시	진안동	진안동제4투	5549	3885	1664	1	3884	1556	2323	0	2	3	0
경기도	화성시	진안동	진안동제5투	4453	3451	1002	6	3445	1654	1782	0	1	6	2
경기도	화성시	진안동	진안동제6투	3018	2445	573	3	2442	1001	1437	0	1	3	0
경기도	화성시	병점1동	소계	19317	15053	4264	37	15016	6608	8360	3	5	32	8
경기도	화성시	병점1동	병점1동제1투	3928	3115	813	6	3109	1370	1727	0	2	8	2
경기도	화성시	병점1동	병점1동제2투	3790	2988	802	8	2980	1352	1620	0	1	6	1
경기도	화성시	병점1동	병점1동제3투	3628	2723	905	7	2716	1195	1510	1	2	5	3
경기도	화성시	병점1동	병점1동제4투	4661	3745	916	10	3735	1527	2202	0	0	5	1
경기도	화성시	병점1동	병점1동제5투	3310	2482	828	6	2476	1164	1301	2	0	8	1
경기도	화성시	병점2동	소계	17997	14000	3997	28	13972	5691	8244	2	6	18	11
경기도	화성시	병점2동	병점2동제1투	4419	3397	1022	6	3391	1400	1983	0	2	6	0
경기도	화성시	병점2동	병점2동제2투	4758	3982	776	6	3976	1700	2268	1	1	5	1
경기도	화성시	병점2동	병점2동제3투	4942	3701	1241	6	3695	1375	2307	1	0	6	6
경기도	화성시	병점2동	병점2동제4투	3878	2920	958	10	2910	1216	1686	0	3	1	4
경기도	화성시	반월동	소계	13716	11113	2603	15	11098	5213	5857	1	4	18	5
경기도	화성시	반월동	반월동제1투	5041	4048	993	4	4044	1936	2094	0	2	9	3
경기도	화성시	반월동	반월동제2투	4958	3964	994	5	3959	1884	2064	0	1	8	2
경기도	화성시	반월동	반월동제3투	3717	3101	616	6	3095	1393	1699	1	1	1	0
경기도	화성시	기배동	소계	10468	8008	2460	11	7997	3880	4098	2	4	6	7
경기도	화성시	기배동	기배동제1투	3857	2894	963	6	2888	1420	1462	0	2	2	2
경기도	화성시	기배동	기배동제2투	3191	2488	703	3	2485	1183	1295	2	2	2	1
경기도	화성시	기배동	기배동제3투	3420	2626	794	2	2624	1277	1341	0	0	2	4
경기도	화성시	화산동	소계	17889	12751	5138	25	12726	6421	6258	4	5	26	12
경기도	화성시	화산동	화산동제1투	3525	2474	1051	5	2469	1356	1102	2	1	3	5
경기도	화성시	화산동	화산동제2투	4585	3203	1382	5	3198	1571	1614	1	2	7	3
경기도	화성시	화산동	화산동제3투	4845	3560	1285	11	3549	1744	1795	0	1	5	4
경기도	화성시	화산동	화산동제4투	4934	3514	1420	4	3510	1750	1747	1	1	11	0
경기도	화성시	동탄1동	소계	33561	27498	6063	47	27451	11117	16248	4	17	56	9
경기도	화성시	동탄1동	동탄1동제1투	3286	2739	547	5	2734	1175	1553	0	1	4	1
경기도	화성시	동탄1동	동탄1동제2투	3951	3174	777	5	3169	1250	1907	1	4	6	1
경기도	화성시	동탄1동	동탄1동제3투	2707	2166	541	4	2162	722	1434	1	1	3	1
경기도	화성시	동탄1동	동탄1동제4투	4319	3629	690	4	3625	1201	2406	0	2	14	2
경기도	화성시	동탄1동	동탄1동제5투	3315	2770	545	6	2764	1201	1554	0	3	4	2
경기도	화성시	동탄1동	동탄1동제6투	3196	2625	571	3	2622	1081	1536	0	1	4	0
경기도	화성시	동탄1동	동탄1동제7투	3449	2922	527	7	2915	1119	1792	0	2	2	0
경기도	화성시	동탄1동	동탄1동제8투	3853	3114	739	4	3110	1413	1687	1	0	8	1
경기도	화성시	동탄1동	동탄1동제9투	2783	2365	418	5	2360	1027	1325	1	2	5	0
경기도	화성시	동탄1동	동탄1동제10투	2702	1994	708	4	1990	928	1054	0	1	6	1
경기도	화성시	동탄2동	소계	22761	18133	4628	17	18116	7801	10266	3	8	31	7
경기도	화성시	동탄2동	동탄2동제1투	4565	3908	657	3	3905	1714	2180	1	2	8	0
경기도	화성시	동탄2동	동탄2동제2투	3057	2453	604	2	2451	931	1513	0	1	4	2
경기도	화성시	동탄2동	동탄2동제3투	3786	3104	682	1	3103	1177	1916	0	3	7	0
경기도	화성시	동탄2동	동탄2동제4투	3851	3215	636	5	3210	1662	1539	1	0	4	4
경기도	화성시	동탄2동	동탄2동제5투	4337	2896	1441	4	2892	1164	1723	1	1	3	0
경기도	화성시	동탄2동	동탄2동제6투	3165	2557	608	2	2555	1153	1395	0	1	5	1
경기도	화성시	동탄3동	소계	27020	21091	5929	34	21057	7564	13447	2	6	27	11
경기도	화성시	동탄3동	동탄3동제1투	4989	3858	1131	4	3854	1242	2605	0	2	4	1
경기도	화성시	동탄3동	동탄3동제2투	4807	3513	1294	4	3509	1353	2147	0	1	5	3
경기도	화성시	동탄3동	동탄3동제3투	3304	2437	867	10	2427	1031	1393	0	0	2	1
경기도	화성시	동탄3동	동탄3동제4투	4916	3961	955	6	3955	1488	2462	0	0	5	0
경기도	화성시	동탄3동	동탄3동제5투	4432	3599	833	9	3590	1247	2338	1	0	0	4
경기도	화성시	동탄3동	동탄3동제6투	4572	3723	849	1	3722	1203	2502	1	3	11	2
경기도	시흥시	계	계	301719	215665	86054	638	215027	102267	112012	69	102	360	217
경기도	시흥시	재외투표	재외투표	938	606	332	7	599	223	370	0	0	5	1
경기도	시흥시	국내부재자투표	국내부재자투표	6525	6162	363	125	6037	2902	3062	11	13	18	31
경기도	시흥시	대야동	소계	27294	20255	7039	47	20208	10040	10101	4	12	37	14
경기도	시흥시	대야동	대야동제1투	5446	3760	1686	16	3744	1868	1866	1	1	8	0
경기도	시흥시	대야동	대야동제2투	3264	2332	932	5	2327	1150	1172	0	0	5	0
경기도	시흥시	대야동	대야동제3투	4373	3120	1253	5	3115	1590	1517	0	1	1	6
경기도	시흥시	대야동	대야동제4투	4292	3456	836	7	3449	1583	1854	1	2	7	2
경기도	시흥시	대야동	대야동제5투	657	487	170	2	485	342	136	0	2	2	3
경기도	시흥시	대야동	대야동제6투	2427	1890	537	1	1889	881	1002	0	3	3	0
경기도	시흥시	대야동	대야동제7투	4787	3734	1053	8	3726	1788	1921	2	3	10	2
경기도	시흥시	대야동	대야동제8투	2048	1476	572	3	1473	838	633	0	0	1	1
경기도	시흥시	신천동	소계	33117	23400	9717	74	23326	11637	11614	10	7	33	25
경기도	시흥시	신천동	신천동제1투	3323	2135	1188	12	2123	1035	1081	0	0	5	2
경기도	시흥시	신천동	신천동제2투	5217	3695	1522	11	3684	1848	1823	1	2	4	6
경기도	시흥시	신천동	신천동제3투	2946	1969	977	5	1964	1093	868	0	1	1	1
경기도	시흥시	신천동	신천동제4투	4405	3125	1280	11	3114	1634	1469	1	1	6	3
경기도	시흥시	신천동	신천동제5투	3847	2728	1119	9	2719	1352	1359	1	1	2	4
경기도	시흥시	신천동	신천동제6투	3757	2635	1122	7	2628	1274	1349	0	0	3	2
경기도	시흥시	신천동	신천동제7투	4487	3497	990	6	3491	1660	1814	2	2	8	5
경기도	시흥시	신천동	신천동제8투	5135	3616	1519	13	3603	1741	1851	5	0	4	2
경기도	시흥시	신현동	소계	9707	7226	2481	16	7210	4034	3144	3	2	15	12
경기도	시흥시	신현동	신현동제1투	2561	1958	603	7	1951	1025	916	2	1	2	5
경기도	시흥시	신현동	신현동제2투	3026	2260	766	4	2256	1172	1070	1	1	8	4
경기도	시흥시	신현동	신현동제3투	3540	2557	983	5	2552	1500	1044	0	0	5	3
경기도	시흥시	신현동	신현동제4투	580	451	129	0	451	337	114	0	0	0	0
경기도	시흥시	은행동	소계	22974	17824	5150	32	17792	8205	9529	3	9	34	12
경기도	시흥시	은행동	은행동제1투	4554	3296	1258	5	3291	1716	1561	1	2	7	4
경기도	시흥시	은행동	은행동제2투	4835	3510	1325	6	3504	1671	1818	1	2	11	1
경기도	시흥시	은행동	은행동제3투	4015	3280	735	5	3275	1416	1854	0	0	2	3
경기도	시흥시	은행동	은행동제4투	5150	4133	1017	9	4124	1704	2405	0	2	12	1
경기도	시흥시	은행동	은행동제5투	4420	3605	815	7	3598	1698	1891	1	3	2	3
경기도	시흥시	매화동	소계	10186	7553	2633	23	7530	3819	3686	1	4	12	8
경기도	시흥시	매화동	매화동제1투	3602	2705	897	11	2694	1329	1360	0	1	2	2
경기도	시흥시	매화동	매화동제2투	3272	2453	819	5	2448	1296	1139	0	2	8	3
경기도	시흥시	매화동	매화동제3투	3312	2395	917	7	2388	1194	1187	1	1	2	3
경기도	시흥시	목감동	소계	9021	6636	2385	22	6614	3665	2930	1	0	11	7
경기도	시흥시	목감동	목감동제1투	3827	2799	1028	10	2789	1621	1159	0	0	3	6
경기도	시흥시	목감동	목감동제2투	1520	1143	377	3	1140	649	490	0	0	1	0
경기도	시흥시	목감동	목감동제3투	3674	2694	980	9	2685	1395	1281	1	0	7	1
경기도	시흥시	군자동	소계	31725	22230	9495	57	22173	10979	11135	6	8	20	25
경기도	시흥시	군자동	군자동제1투	4828	3193	1635	7	3186	1672	1506	1	0	4	3
경기도	시흥시	군자동	군자동제2투	3129	2132	997	2	2130	1101	1021	1	2	0	5
경기도	시흥시	군자동	군자동제3투	4134	2968	1166	11	2957	1525	1426	1	1	2	2
경기도	시흥시	군자동	군자동제4투	602	424	178	1	423	301	121	0	0	1	0
경기도	시흥시	군자동	군자동제5투	4339	3095	1244	10	3085	1557	1512	1	2	5	8
경기도	시흥시	군자동	군자동제6투	3043	2150	893	9	2141	1083	1051	1	1	1	4
경기도	시흥시	군자동	군자동제7투	4130	2810	1320	6	2804	1336	1464	1	0	2	1
경기도	시흥시	군자동	군자동제8투	3205	2308	897	6	2302	897	1400	0	1	3	1
경기도	시흥시	군자동	군자동제9투	4315	3150	1165	5	3145	1507	1634	0	1	2	1
경기도	시흥시	정왕본동	소계	19987	9260	10727	30	9230	4080	5119	2	6	15	8
경기도	시흥시	정왕본동	정왕본동제1투	3486	1744	1742	3	1741	923	812	1	0	2	3
경기도	시흥시	정왕본동	정왕본동제2투	6383	3005	3378	10	2995	1130	1855	0	3	6	1
경기도	시흥시	정왕본동	정왕본동제3투	3215	1449	1766	5	1444	691	749	0	0	2	2
경기도	시흥시	정왕본동	정왕본동제4투	3865	1710	2155	7	1703	767	931	1	1	2	1
경기도	시흥시	정왕본동	정왕본동제5투	3038	1352	1686	5	1347	569	772	0	2	3	1
경기도	시흥시	정왕1동	소계	24216	14569	9647	32	14537	6598	7895	6	10	16	12
경기도	시흥시	정왕1동	정왕1동제1투	3963	2723	1240	7	2716	1189	1519	0	2	3	3
경기도	시흥시	정왕1동	정왕1동제2투	3900	2367	1533	5	2362	1090	1264	2	1	2	3
경기도	시흥시	정왕1동	정왕1동제3투	4897	2403	2494	5	2398	1061	1329	2	3	2	1
경기도	시흥시	정왕1동	정왕1동제4투	4033	1924	2109	4	1920	899	1015	1	2	3	0
경기도	시흥시	정왕1동	정왕1동제5투	2717	1934	783	3	1931	912	1013	0	1	1	4
경기도	시흥시	정왕1동	정왕1동제6투	4706	3218	1488	8	3210	1447	1755	1	1	5	1
경기도	시흥시	정왕2동	소계	25483	18734	6749	40	18694	8338	10288	4	9	35	20
경기도	시흥시	정왕2동	정왕2동제1투	4166	3161	1005	4	3157	1387	1754	2	3	5	6
경기도	시흥시	정왕2동	정왕2동제2투	4270	3331	939	8	3323	1488	1825	0	1	7	2
경기도	시흥시	정왕2동	정왕2동제3투	5530	3917	1613	5	3912	1742	2156	1	2	8	3
경기도	시흥시	정왕2동	정왕2동제4투	3750	2882	868	9	2873	1298	1574	0	1	0	0
경기도	시흥시	정왕2동	정왕2동제5투	4130	2989	1141	8	2981	1346	1619	0	1	10	5
경기도	시흥시	정왕2동	정왕2동제6투	3637	2454	1183	6	2448	1077	1360	1	1	5	4
경기도	시흥시	정왕3동	소계	19635	13589	6046	37	13552	6205	7304	2	3	25	13
경기도	시흥시	정왕3동	정왕3동제1투	4287	3282	1005	11	3271	1480	1778	0	0	9	4
경기도	시흥시	정왕3동	정왕3동제2투	4217	3180	1037	9	3171	1423	1739	1	1	6	1
경기도	시흥시	정왕3동	정왕3동제3투	4806	3323	1483	10	3313	1443	1859	1	1	5	4
경기도	시흥시	정왕3동	정왕3동제4투	6325	3804	2521	7	3797	1859	1928	0	1	5	4
경기도	시흥시	정왕4동	소계	17118	13256	3862	29	13227	5798	7382	5	5	30	7
경기도	시흥시	정왕4동	정왕4동제1투	4218	3253	965	7	3246	1386	1851	1	3	4	1
경기도	시흥시	정왕4동	정왕4동제2투	2750	2141	609	3	2138	1062	1071	0	0	4	1
경기도	시흥시	정왕4동	정왕4동제3투	3695	2946	749	6	2940	1286	1637	2	0	11	4
경기도	시흥시	정왕4동	정왕4동제4투	3504	2650	854	8	2642	1115	1522	0	0	5	0
경기도	시흥시	정왕4동	정왕4동제5투	2951	2266	685	5	2261	949	1301	2	2	6	1
경기도	시흥시	과림동	소계	2297	1721	576	7	1714	1114	597	1	1	1	0
경기도	시흥시	과림동	과림동투표소	2297	1721	576	7	1714	1114	597	1	1	1	0
경기도	시흥시	연성동	소계	30188	23845	6343	41	23804	10685	13047	8	10	39	15
경기도	시흥시	연성동	연성동제1투	4349	3315	1034	5	3310	1475	1828	1	0	3	3
경기도	시흥시	연성동	연성동제2투	4185	3281	904	6	3275	1627	1639	0	2	6	1
경기도	시흥시	연성동	연성동제3투	4244	3391	853	4	3387	1431	1946	2	1	5	2
경기도	시흥시	연성동	연성동제4투	5047	4096	951	8	4088	1894	2185	0	1	4	4
경기도	시흥시	연성동	연성동제5투	4311	3355	956	5	3350	1335	2004	2	0	8	1
경기도	시흥시	연성동	연성동제6투	3076	2493	583	4	2489	1009	1469	2	3	5	1
경기도	시흥시	연성동	연성동제7투	2972	2315	657	6	2309	1076	1225	1	2	5	0
경기도	시흥시	연성동	연성동제8투	2004	1599	405	3	1596	838	751	0	1	3	3
경기도	시흥시	능곡동	소계	11308	8799	2509	19	8780	3945	4809	2	3	14	7
경기도	시흥시	능곡동	능곡동제1투	4379	3384	995	6	3378	1678	1691	0	0	5	4
경기도	시흥시	능곡동	능곡동제2투	3434	2687	747	6	2681	1131	1543	1	2	3	1
경기도	시흥시	능곡동	능곡동제3투	3495	2728	767	7	2721	1136	1575	1	1	6	2
경기도	군포시	계	계	222840	176080	46760	467	175613	80722	94255	44	100	336	156
경기도	군포시	재외투표	재외투표	1316	925	391	5	920	311	600	0	2	5	2
경기도	군포시	국내부재자투표	국내부재자투표	5204	4868	336	75	4793	2251	2498	6	5	10	23
경기도	군포시	군포1동	소계	28311	20816	7495	58	20758	10119	10578	5	11	32	13
경기도	군포시	군포1동	군포1동제1투	4648	3290	1358	9	3281	1696	1573	0	3	6	3
경기도	군포시	군포1동	군포1동제2투	4672	3034	1638	11	3023	1504	1510	0	1	7	1
경기도	군포시	군포1동	군포1동제3투	4421	3161	1260	8	3153	1569	1575	0	2	5	2
경기도	군포시	군포1동	군포1동제4투	4360	3079	1281	7	3072	1574	1493	1	0	1	3
경기도	군포시	군포1동	군포1동제5투	392	238	154	2	236	133	103	0	0	0	0
경기도	군포시	군포1동	군포1동제6투	262	175	87	1	174	97	73	0	1	1	2
경기도	군포시	군포1동	군포1동제7투	4361	3592	769	8	3584	1740	1835	3	1	4	1
경기도	군포시	군포1동	군포1동제8투	5195	4247	948	12	4235	1806	2416	1	3	8	1
경기도	군포시	군포2동	소계	35487	28699	6788	63	28636	13168	15376	6	17	48	21
경기도	군포시	군포2동	군포2동제1투	4692	3703	989	8	3695	1768	1909	0	2	12	4
경기도	군포시	군포2동	군포2동제2투	3606	2748	858	8	2740	1311	1421	2	2	0	4
경기도	군포시	군포2동	군포2동제3투	3893	3111	782	4	3107	1472	1624	2	4	5	0
경기도	군포시	군포2동	군포2동제4투	4929	4070	859	10	4060	1799	2244	1	2	10	4
경기도	군포시	군포2동	군포2동제5투	3235	2737	498	1	2736	1190	1537	1	2	5	1
경기도	군포시	군포2동	군포2동제6투	3139	2498	641	7	2491	1173	1313	0	0	2	3
경기도	군포시	군포2동	군포2동제7투	4292	3634	658	11	3623	1733	1879	0	2	8	1
경기도	군포시	군포2동	군포2동제8투	4524	3474	1050	9	3465	1501	1955	0	3	3	3
경기도	군포시	군포2동	군포2동제9투	2142	1806	336	4	1802	745	1055	0	0	1	1
경기도	군포시	군포2동	군포2동제10투	1035	918	117	1	917	476	439	0	0	2	0
경기도	군포시	산본1동	소계	16793	12274	4519	47	12227	5769	6401	5	12	29	11
경기도	군포시	산본1동	산본1동제1투	3788	2671	1117	10	2661	1247	1399	2	5	5	3
경기도	군포시	산본1동	산본1동제2투	2774	1973	801	11	1962	931	1020	1	1	6	3
경기도	군포시	산본1동	산본1동제3투	3263	2354	909	7	2347	1145	1193	1	2	6	0
경기도	군포시	산본1동	산본1동제4투	3031	2329	702	10	2319	1120	1188	0	4	6	1
경기도	군포시	산본1동	산본1동제5투	3937	2947	990	9	2938	1326	1601	1	0	6	4
경기도	군포시	산본2동	소계	22711	18989	3722	38	18951	8855	10028	3	5	43	17
경기도	군포시	산본2동	산본2동제1투	3695	3091	604	2	3089	1499	1579	0	1	5	5
경기도	군포시	산본2동	산본2동제2투	2698	2131	567	4	2127	894	1219	1	0	11	2
경기도	군포시	산본2동	산본2동제3투	3515	2926	589	6	2920	1198	1713	1	1	5	2
경기도	군포시	산본2동	산본2동제4투	2947	2445	502	6	2439	1160	1267	0	1	8	3
경기도	군포시	산본2동	산본2동제5투	2804	2284	520	4	2280	945	1331	0	0	2	2
경기도	군포시	산본2동	산본2동제6투	3488	3027	461	11	3016	1465	1546	1	0	3	1
경기도	군포시	산본2동	산본2동제7투	3564	3085	479	5	3080	1694	1373	0	2	9	2
경기도	군포시	금정동	소계	16237	11576	4661	43	11533	5498	5996	5	8	19	7
경기도	군포시	금정동	금정동제1투	4493	3308	1185	11	3297	1524	1757	0	4	9	3
경기도	군포시	금정동	금정동제2투	4367	3068	1299	14	3054	1396	1650	2	0	4	2
경기도	군포시	금정동	금정동제3투	4212	2984	1228	8	2976	1494	1472	2	3	5	0
경기도	군포시	금정동	금정동제4투	3165	2216	949	10	2206	1084	1117	1	1	1	2
경기도	군포시	재궁동	소계	18060	13968	4092	26	13942	6197	7690	4	5	31	15
경기도	군포시	재궁동	재궁동제1투	3764	2878	886	5	2873	1387	1473	2	1	8	2
경기도	군포시	재궁동	재궁동제2투	3646	2763	883	10	2753	1282	1457	1	3	6	4
경기도	군포시	재궁동	재궁동제3투	3995	3141	854	5	3136	1506	1621	0	0	6	3
경기도	군포시	재궁동	재궁동제4투	3526	2780	746	2	2778	1114	1652	1	0	7	4
경기도	군포시	재궁동	재궁동제5투	3129	2406	723	4	2402	908	1487	0	1	4	2
경기도	군포시	오금동	소계	18820	15446	3374	26	15420	6388	8976	3	10	29	14
경기도	군포시	오금동	오금동제1투	4368	3593	775	9	3584	1763	1806	2	1	9	3
경기도	군포시	오금동	오금동제2투	4419	3687	732	8	3679	1443	2228	1	2	4	1
경기도	군포시	오금동	오금동제3투	3667	2865	802	3	2862	1136	1714	0	2	6	4
경기도	군포시	오금동	오금동제4투	2499	2064	435	3	2061	848	1203	0	3	5	2
경기도	군포시	오금동	오금동제5투	3867	3237	630	3	3234	1198	2025	0	2	5	4
경기도	군포시	수리동	소계	15602	12441	3161	30	12411	5606	6764	2	7	25	7
경기도	군포시	수리동	수리동제1투	3140	2551	589	6	2545	1324	1209	1	2	8	1
경기도	군포시	수리동	수리동제2투	2963	2480	483	2	2478	1266	1203	1	1	6	1
경기도	군포시	수리동	수리동제3투	2956	2443	513	9	2434	950	1480	0	1	3	0
경기도	군포시	수리동	수리동제4투	3213	2581	632	4	2577	993	1576	0	1	4	3
경기도	군포시	수리동	수리동제5투	3330	2386	944	9	2377	1073	1296	0	2	4	2
경기도	군포시	궁내동	소계	16284	13514	2770	15	13499	6212	7246	3	5	25	8
경기도	군포시	궁내동	궁내동제1투	2608	2071	537	3	2068	828	1233	1	1	4	1
경기도	군포시	궁내동	궁내동제2투	3363	2833	530	3	2830	1444	1378	1	1	4	2
경기도	군포시	궁내동	궁내동제3투	3713	3109	604	3	3106	1564	1535	0	2	5	0
경기도	군포시	궁내동	궁내동제4투	3828	3186	642	2	3184	1552	1618	0	1	9	4
경기도	군포시	궁내동	궁내동제5투	2772	2315	457	4	2311	824	1482	1	0	3	1
경기도	군포시	광정동	소계	20667	16646	4021	29	16617	7692	8880	0	4	30	11
경기도	군포시	광정동	광정동제1투	4107	2949	1158	8	2941	1373	1558	0	1	5	4
경기도	군포시	광정동	광정동제2투	3467	2619	848	9	2610	1067	1536	0	2	4	1
경기도	군포시	광정동	광정동제3투	4847	4042	805	3	4039	2084	1945	0	0	7	3
경기도	군포시	광정동	광정동제4투	2212	1903	309	5	1898	1050	842	0	0	5	1
경기도	군포시	광정동	광정동제5투	2144	1852	292	1	1851	975	873	0	0	2	1
경기도	군포시	광정동	광정동제6투	3890	3281	609	3	3278	1143	2126	0	1	7	1
경기도	군포시	대야동	소계	7348	5918	1430	12	5906	2656	3222	2	9	10	7
경기도	군포시	대야동	대야동제1투	4545	3604	941	5	3599	1577	2000	2	8	8	4
경기도	군포시	대야동	대야동제2투	2803	2314	489	7	2307	1079	1222	0	1	2	3
경기도	하남시	계	계	118494	88508	29986	322	88186	47676	40221	23	22	154	90
경기도	하남시	재외투표	재외투표	628	423	205	3	420	151	268	0	1	0	0
경기도	하남시	국내부재자투표	국내부재자투표	2493	2357	136	37	2320	1154	1144	3	2	3	14
경기도	하남시	천현동	소계	6927	4830	2097	19	4811	3001	1796	5	1	6	2
경기도	하남시	천현동	천현동제1투	2807	1933	874	6	1927	1265	657	1	1	2	1
경기도	하남시	천현동	천현동제2투	2515	1735	780	5	1730	964	762	2	0	2	0
경기도	하남시	천현동	천현동제3투	1605	1162	443	8	1154	772	377	2	0	2	1
경기도	하남시	신장1동	소계	6056	4220	1836	11	4209	2281	1911	2	0	9	6
경기도	하남시	신장1동	신장1동제1투	2634	1844	790	5	1839	973	860	0	0	4	2
경기도	하남시	신장1동	신장1동제2투	3422	2376	1046	6	2370	1308	1051	2	0	5	4
경기도	하남시	신장2동	소계	34839	27279	7560	74	27205	14374	12733	6	4	59	29
경기도	하남시	신장2동	신장2동제1투	3302	2298	1004	8	2290	1198	1082	1	1	6	2
경기도	하남시	신장2동	신장2동제2투	3223	2270	953	9	2261	1340	913	0	1	5	2
경기도	하남시	신장2동	신장2동제3투	3489	2608	881	7	2601	1308	1282	2	0	5	4
경기도	하남시	신장2동	신장2동제4투	2318	1841	477	6	1835	910	918	0	0	4	3
경기도	하남시	신장2동	신장2동제5투	3086	2558	528	6	2552	1525	1021	0	0	4	2
경기도	하남시	신장2동	신장2동제6투	3037	2518	519	4	2514	1368	1133	0	0	10	3
경기도	하남시	신장2동	신장2동제7투	2945	2395	550	6	2389	1226	1158	0	0	3	2
경기도	하남시	신장2동	신장2동제8투	4504	3611	893	9	3602	1697	1895	0	1	8	1
경기도	하남시	신장2동	신장2동제9투	4877	3908	969	12	3896	2063	1814	2	0	9	8
경기도	하남시	신장2동	신장2동제10투	4058	3272	786	7	3265	1739	1517	1	1	5	2
경기도	하남시	덕풍1동	소계	14818	10885	3933	25	10860	5611	5227	1	2	14	5
경기도	하남시	덕풍1동	덕풍1동제1투	4069	2930	1139	5	2925	1528	1391	0	0	5	1
경기도	하남시	덕풍1동	덕풍1동제2투	3069	2428	641	4	2424	1168	1253	0	0	3	0
경기도	하남시	덕풍1동	덕풍1동제3투	3546	2305	1241	5	2300	1289	1003	1	1	3	3
경기도	하남시	덕풍1동	덕풍1동제4투	4134	3222	912	11	3211	1626	1580	0	1	3	1
경기도	하남시	덕풍2동	소계	18051	13190	4861	50	13140	7062	6046	2	3	19	8
경기도	하남시	덕풍2동	덕풍2동제1투	3174	2324	850	11	2313	1188	1114	1	0	5	5
경기도	하남시	덕풍2동	덕풍2동제2투	3152	2183	969	12	2171	1217	951	0	0	3	0
경기도	하남시	덕풍2동	덕풍2동제3투	2503	1728	775	6	1722	960	758	0	2	2	0
경기도	하남시	덕풍2동	덕풍2동제4투	3053	2153	900	5	2148	1171	974	0	1	2	0
경기도	하남시	덕풍2동	덕풍2동제5투	3428	2561	867	11	2550	1384	1161	1	0	2	2
경기도	하남시	덕풍2동	덕풍2동제6투	2741	2241	500	5	2236	1142	1088	0	0	5	1
경기도	하남시	덕풍3동	소계	19618	14827	4791	47	14780	7595	7142	2	4	28	9
경기도	하남시	덕풍3동	덕풍3동제1투	3989	2880	1109	7	2873	1454	1406	0	0	11	2
경기도	하남시	덕풍3동	덕풍3동제2투	4655	3666	989	9	3657	1781	1866	0	1	9	0
경기도	하남시	덕풍3동	덕풍3동제3투	3475	2425	1050	7	2418	1324	1089	0	0	3	2
경기도	하남시	덕풍3동	덕풍3동제4투	3776	3014	762	10	3004	1548	1451	0	1	4	0
경기도	하남시	덕풍3동	덕풍3동제5투	3723	2842	881	14	2828	1488	1330	2	2	1	5
경기도	하남시	풍산동	소계	2963	1838	1125	8	1830	1049	778	0	0	1	2
경기도	하남시	풍산동	풍산동제1투	1440	832	608	5	827	471	354	0	0	1	1
경기도	하남시	풍산동	풍산동제2투	1523	1006	517	3	1003	578	424	0	0	0	1
경기도	하남시	감북동	소계	5326	3749	1577	21	3728	2298	1416	1	2	6	5
경기도	하남시	감북동	감북동제1투	2567	1813	754	13	1800	1124	665	1	1	5	4
경기도	하남시	감북동	감북동제2투	2759	1936	823	8	1928	1174	751	0	1	1	1
경기도	하남시	춘궁동	소계	3470	2559	911	15	2544	1713	818	1	1	3	8
경기도	하남시	춘궁동	춘궁동투표소	3470	2559	911	15	2544	1713	818	1	1	3	8
경기도	하남시	초이동	소계	3305	2351	954	12	2339	1387	942	0	2	6	2
경기도	하남시	초이동	초이동제1투	1592	1124	468	7	1117	663	451	0	0	3	0
경기도	하남시	초이동	초이동제2투	1713	1227	486	5	1222	724	491	0	2	3	2
경기도	파주시	계	계	302153	222553	79600	702	221851	114672	106323	68	114	348	326
경기도	파주시	재외투표	재외투표	1433	996	437	5	991	401	583	0	0	7	0
경기도	파주시	국내부재자투표	국내부재자투표	6955	6517	438	127	6390	3162	3141	13	13	21	40
경기도	파주시	문산읍	소계	34777	24429	10348	57	24372	13815	10488	5	5	34	25
경기도	파주시	문산읍	문산읍제1투	4154	2793	1361	3	2790	1691	1090	1	1	4	3
경기도	파주시	문산읍	문산읍제2투	5398	3978	1420	10	3968	1940	2020	0	0	5	3
경기도	파주시	문산읍	문산읍제3투	3891	2619	1272	6	2613	1522	1080	2	1	5	3
경기도	파주시	문산읍	문산읍제4투	2919	2100	819	3	2097	1129	963	0	1	2	2
경기도	파주시	문산읍	문산읍제5투	3804	2543	1261	8	2535	1508	1023	0	0	3	1
경기도	파주시	문산읍	문산읍제6투	1105	784	321	1	783	510	272	0	0	1	0
경기도	파주시	문산읍	문산읍제7투	1263	945	318	4	941	648	286	0	0	3	4
경기도	파주시	문산읍	문산읍제8투	921	624	297	7	617	426	188	1	0	1	1
경기도	파주시	문산읍	문산읍제9투	5157	3798	1359	5	3793	2094	1686	1	1	7	4
경기도	파주시	문산읍	문산읍제10투	1999	1445	554	2	1443	928	512	0	0	1	2
경기도	파주시	문산읍	문산읍제11투	4166	2800	1366	8	2792	1419	1368	0	1	2	2
경기도	파주시	조리읍	소계	24230	17677	6553	47	17630	10119	7457	5	12	21	16
경기도	파주시	조리읍	조리읍제1투	4483	3385	1098	10	3375	1919	1448	1	1	2	4
경기도	파주시	조리읍	조리읍제2투	2675	2025	650	3	2022	1125	889	0	1	4	3
경기도	파주시	조리읍	조리읍제3투	2463	1772	691	7	1765	1008	751	1	0	3	2
경기도	파주시	조리읍	조리읍제4투	3750	2848	902	3	2845	1600	1230	2	7	4	2
경기도	파주시	조리읍	조리읍제5투	2212	1379	833	4	1375	805	568	0	0	1	1
경기도	파주시	조리읍	조리읍제6투	4136	3092	1044	7	3085	1606	1472	0	2	3	2
경기도	파주시	조리읍	조리읍제7투	2242	1547	695	6	1541	1004	536	0	0	1	0
경기도	파주시	조리읍	조리읍제8투	1037	755	282	5	750	486	258	1	0	3	2
경기도	파주시	조리읍	조리읍제9투	1232	874	358	2	872	566	305	0	1	0	0
경기도	파주시	법원읍	소계	10745	7443	3302	54	7389	4994	2349	2	7	12	25
경기도	파주시	법원읍	법원읍제1투	2579	1573	1006	4	1569	1081	483	0	1	1	3
경기도	파주시	법원읍	법원읍제2투	284	219	65	0	219	133	82	0	0	0	4
경기도	파주시	법원읍	법원읍제3투	704	511	193	35	476	318	146	1	1	4	6
경기도	파주시	법원읍	법원읍제4투	742	569	173	0	569	384	182	0	0	0	3
경기도	파주시	법원읍	법원읍제5투	2335	1652	683	8	1644	1126	512	0	2	2	2
경기도	파주시	법원읍	법원읍제6투	1987	1411	576	3	1408	986	416	0	2	2	2
경기도	파주시	법원읍	법원읍제7투	2114	1508	606	4	1504	966	528	1	1	3	5
경기도	파주시	파주읍	소계	11484	7757	3727	26	7731	5056	2635	5	7	8	20
경기도	파주시	파주읍	파주읍제1투	4148	2528	1620	11	2517	1680	825	1	3	2	6
경기도	파주시	파주읍	파주읍제2투	2457	1693	764	3	1690	1067	614	2	1	1	5
경기도	파주시	파주읍	파주읍제3투	1259	848	411	0	848	547	298	1	1	0	1
경기도	파주시	파주읍	파주읍제4투	1352	1019	333	3	1016	649	359	0	2	2	4
경기도	파주시	파주읍	파주읍제5투	1097	789	308	4	785	519	265	0	0	0	1
경기도	파주시	파주읍	파주읍제6투	1171	880	291	5	875	594	274	1	0	3	3
경기도	파주시	광탄면	소계	10564	7319	3245	31	7288	4784	2473	4	3	13	11
경기도	파주시	광탄면	광탄면제1투	3077	2065	1012	7	2058	1283	768	1	1	1	4
경기도	파주시	광탄면	광탄면제2투	2469	1691	778	5	1686	1120	559	0	0	4	3
경기도	파주시	광탄면	광탄면제3투	1351	1011	340	7	1004	687	306	1	1	6	3
경기도	파주시	광탄면	광탄면제4투	2053	1405	648	8	1397	925	469	1	1	1	0
경기도	파주시	광탄면	광탄면제5투	1614	1147	467	4	1143	769	371	1	0	1	1
경기도	파주시	탄현면	소계	10901	7679	3222	30	7649	4221	3389	3	6	12	18
경기도	파주시	탄현면	탄현면제1투	2049	1443	606	7	1436	970	457	1	1	2	5
경기도	파주시	탄현면	탄현면제2투	1252	906	346	2	904	586	315	0	0	1	2
경기도	파주시	탄현면	탄현면제3투	1602	1093	509	7	1086	734	347	1	0	1	3
경기도	파주시	탄현면	탄현면제4투	2448	1704	744	7	1697	812	875	0	0	4	6
경기도	파주시	탄현면	탄현면제5투	3550	2533	1017	7	2526	1119	1395	1	5	4	2
경기도	파주시	월롱면	소계	13752	10507	3245	51	10456	3790	6589	6	11	19	41
경기도	파주시	월롱면	월롱면제1투	1543	1065	478	2	1063	730	327	0	1	0	5
경기도	파주시	월롱면	월롱면제2투	1790	1189	601	8	1181	623	553	2	0	0	3
경기도	파주시	월롱면	월롱면제3투	2346	1630	716	3	1627	983	636	0	1	4	3
경기도	파주시	월롱면	월롱면제4투	2372	1868	504	4	1864	477	1375	0	2	6	4
경기도	파주시	월롱면	월롱면제5투	5701	4755	946	34	4721	977	3698	4	7	9	26
경기도	파주시	적성면	소계	6496	4586	1910	20	4566	3263	1278	3	2	9	11
경기도	파주시	적성면	적성면제1투	3182	2177	1005	5	2172	1544	626	0	0	1	1
경기도	파주시	적성면	적성면제2투	731	532	199	7	525	357	161	2	1	1	3
경기도	파주시	적성면	적성면제3투	1163	830	333	3	827	592	228	0	0	6	1
경기도	파주시	적성면	적성면제4투	712	510	202	2	508	373	129	1	1	0	4
경기도	파주시	적성면	적성면제5투	708	537	171	3	534	397	134	0	0	1	2
경기도	파주시	파평면	소계	3754	2800	954	14	2786	1926	849	0	1	1	9
경기도	파주시	파평면	파평면제1투	569	424	145	3	421	305	112	0	0	0	4
경기도	파주시	파평면	파평면제2투	402	298	104	0	298	180	118	0	0	0	0
경기도	파주시	파평면	파평면제3투	548	395	153	2	393	286	105	0	1	0	1
경기도	파주시	파평면	파평면제4투	1008	752	256	4	748	483	263	0	0	0	2
경기도	파주시	파평면	파평면제5투	630	466	164	4	462	330	131	0	0	1	0
경기도	파주시	파평면	파평면제6투	597	465	132	1	464	342	120	0	0	0	2
경기도	파주시	군내면	소계	540	446	94	2	444	266	178	0	0	0	0
경기도	파주시	군내면	군내면투표소	540	446	94	2	444	266	178	0	0	0	0
경기도	파주시	진동면	소계	144	116	28	0	116	68	48	0	0	0	0
경기도	파주시	진동면	진동면투표소	144	116	28	0	116	68	48	0	0	0	0
경기도	파주시	교하동	소계	30443	23062	7381	41	23021	10614	12341	7	8	35	16
경기도	파주시	교하동	교하동제1투	2774	1763	1011	3	1760	1132	623	2	0	1	2
경기도	파주시	교하동	교하동제2투	3665	2846	819	5	2841	1419	1412	1	1	6	2
경기도	파주시	교하동	교하동제3투	3935	2781	1154	5	2776	1357	1412	0	1	1	5
경기도	파주시	교하동	교하동제4투	2250	1577	673	3	1574	931	633	2	0	6	2
경기도	파주시	교하동	교하동제5투	2763	2039	724	5	2034	905	1124	0	3	2	0
경기도	파주시	교하동	교하동제6투	3185	2514	671	7	2507	1208	1293	0	1	4	1
경기도	파주시	교하동	교하동제7투	2698	2182	516	3	2179	878	1291	1	0	6	3
경기도	파주시	교하동	교하동제8투	3214	2611	603	5	2606	897	1705	0	0	4	0
경기도	파주시	교하동	교하동제9투	2343	1961	382	4	1957	755	1199	0	2	1	0
경기도	파주시	교하동	교하동제10투	3616	2788	828	1	2787	1132	1649	1	0	4	1
경기도	파주시	운정1동	소계	20449	15583	4866	34	15549	7025	8468	3	8	27	18
경기도	파주시	운정1동	운정1동제1투	2110	1405	705	5	1400	860	535	0	0	1	4
경기도	파주시	운정1동	운정1동제2투	2589	2103	486	3	2100	827	1266	1	1	4	1
경기도	파주시	운정1동	운정1동제3투	2586	1817	769	3	1814	911	895	0	1	3	4
경기도	파주시	운정1동	운정1동제4투	4352	3393	959	9	3384	1444	1927	0	3	9	1
경기도	파주시	운정1동	운정1동제5투	2977	2338	639	6	2332	1084	1241	1	0	4	2
경기도	파주시	운정1동	운정1동제6투	3558	2859	699	3	2856	1090	1756	1	2	2	5
경기도	파주시	운정1동	운정1동제7투	2277	1668	609	5	1663	809	848	0	1	4	1
경기도	파주시	운정2동	소계	18855	15031	3824	24	15007	6632	8325	4	8	24	14
경기도	파주시	운정2동	운정2동제1투	2188	1643	545	5	1638	803	825	1	3	3	3
경기도	파주시	운정2동	운정2동제2투	2112	1784	328	0	1784	691	1089	0	1	1	2
경기도	파주시	운정2동	운정2동제3투	1470	1173	297	2	1171	412	756	1	0	2	0
경기도	파주시	운정2동	운정2동제4투	3334	2678	656	5	2673	1143	1523	0	3	3	1
경기도	파주시	운정2동	운정2동제5투	2916	2321	595	4	2317	1104	1204	0	0	5	4
경기도	파주시	운정2동	운정2동제6투	2944	2411	533	3	2408	1032	1368	2	0	3	3
경기도	파주시	운정2동	운정2동제7투	1492	1145	347	2	1143	556	584	0	0	3	0
경기도	파주시	운정2동	운정2동제8투	2399	1876	523	3	1873	891	976	0	1	4	1
경기도	파주시	운정3동	소계	32131	24171	7960	46	24125	10656	13419	1	7	32	10
경기도	파주시	운정3동	운정3동제1투	4662	3719	943	9	3710	1669	2035	0	1	4	1
경기도	파주시	운정3동	운정3동제2투	5218	4263	955	6	4257	1672	2572	0	2	10	1
경기도	파주시	운정3동	운정3동제3투	2563	1756	807	7	1749	848	896	1	0	1	3
경기도	파주시	운정3동	운정3동제4투	3357	2580	777	4	2576	1300	1268	0	2	5	1
경기도	파주시	운정3동	운정3동제5투	4188	3090	1098	5	3085	1445	1637	0	0	2	1
경기도	파주시	운정3동	운정3동제6투	4423	2973	1450	3	2970	1289	1676	0	0	4	1
경기도	파주시	운정3동	운정3동제7투	3017	2262	755	8	2254	1018	1231	0	2	3	0
경기도	파주시	운정3동	운정3동제8투	4703	3528	1175	4	3524	1415	2104	0	0	3	2
경기도	파주시	금촌1동	소계	18407	12366	6041	30	12336	7241	5060	2	1	15	17
경기도	파주시	금촌1동	금촌1동제1투	3769	2595	1174	3	2592	1467	1118	0	0	2	5
경기도	파주시	금촌1동	금촌1동제2투	2619	1861	758	5	1856	1110	740	1	0	2	3
경기도	파주시	금촌1동	금촌1동제3투	2681	1720	961	5	1715	1126	582	1	0	4	2
경기도	파주시	금촌1동	금촌1동제4투	3418	2280	1138	6	2274	1390	878	0	0	1	5
경기도	파주시	금촌1동	금촌1동제5투	2676	1579	1097	4	1575	853	720	0	0	1	1
경기도	파주시	금촌1동	금촌1동제6투	3244	2331	913	7	2324	1295	1022	0	1	5	1
경기도	파주시	금촌2동	소계	25050	18654	6396	29	18625	8779	9780	5	8	36	17
경기도	파주시	금촌2동	금촌2동제1투	5063	3595	1468	3	3592	1644	1930	1	1	11	5
경기도	파주시	금촌2동	금촌2동제2투	4314	3126	1188	5	3121	1594	1511	2	3	8	3
경기도	파주시	금촌2동	금촌2동제3투	5315	3843	1472	5	3838	1705	2123	2	0	7	1
경기도	파주시	금촌2동	금촌2동제4투	2158	1577	581	5	1572	879	687	0	2	1	3
경기도	파주시	금촌2동	금촌2동제5투	3570	2914	656	6	2908	1325	1575	0	1	5	2
경기도	파주시	금촌2동	금촌2동제6투	4630	3599	1031	5	3594	1632	1954	0	1	4	3
경기도	파주시	금촌3동	소계	21043	15414	5629	34	15380	7860	7473	0	7	22	18
경기도	파주시	금촌3동	금촌3동제1투	3234	2357	877	3	2354	1208	1139	0	0	4	3
경기도	파주시	금촌3동	금촌3동제2투	3246	2294	952	8	2286	1205	1071	0	1	3	6
경기도	파주시	금촌3동	금촌3동제3투	3707	2717	990	5	2712	1436	1270	0	0	3	3
경기도	파주시	금촌3동	금촌3동제4투	4226	3186	1040	9	3177	1539	1630	0	1	6	1
경기도	파주시	금촌3동	금촌3동제5투	3860	2888	972	4	2884	1368	1506	0	4	5	1
경기도	파주시	금촌3동	금촌3동제6투	2770	1972	798	5	1967	1104	857	0	1	1	4
경기도	여주시	계	계	87815	62882	24933	273	62609	40504	21766	27	45	101	166
경기도	여주시	재외투표	재외투표	303	230	73	0	230	100	128	0	1	1	0
경기도	여주시	국내부재자투표	국내부재자투표	2267	2087	180	37	2050	1022	1015	3	6	1	3
경기도	여주시	여주읍	소계	39979	28113	11866	79	28034	16959	10963	11	14	44	43
경기도	여주시	여주읍	여주읍제1투	2638	1558	1080	4	1554	1073	478	0	0	2	1
경기도	여주시	여주읍	여주읍제2투	2676	1955	721	6	1949	1138	806	0	1	4	0
경기도	여주시	여주읍	여주읍제3투	3396	2421	975	4	2417	1482	928	1	1	2	3
경기도	여주시	여주읍	여주읍제4투	1805	1312	493	4	1308	804	496	0	1	2	5
경기도	여주시	여주읍	여주읍제5투	4106	2762	1344	8	2754	1603	1142	0	3	3	3
경기도	여주시	여주읍	여주읍제6투	2193	1592	601	6	1586	980	602	0	1	1	2
경기도	여주시	여주읍	여주읍제7투	3006	2056	950	2	2054	1342	701	2	1	4	4
경기도	여주시	여주읍	여주읍제8투	3874	2814	1060	11	2803	1699	1089	1	1	6	7
경기도	여주시	여주읍	여주읍제9투	4458	3326	1132	7	3319	1789	1516	2	2	7	3
경기도	여주시	여주읍	여주읍제10투	3070	2221	849	7	2214	1367	839	0	0	8	0
경기도	여주시	여주읍	여주읍제11투	4591	3212	1379	9	3203	1892	1298	2	3	2	6
경기도	여주시	여주읍	여주읍제12투	4166	2884	1282	11	2873	1790	1068	3	0	3	9
경기도	여주시	점동면	소계	3986	2862	1124	28	2834	2016	795	2	2	6	13
경기도	여주시	점동면	점동면제1투	2657	1868	789	24	1844	1308	522	1	1	3	9
경기도	여주시	점동면	점동면제2투	768	583	185	3	580	422	152	1	0	2	3
경기도	여주시	점동면	점동면제3투	561	411	150	1	410	286	121	0	1	1	1
경기도	여주시	가남면	소계	12668	8867	3801	28	8839	5577	3221	4	9	11	17
경기도	여주시	가남면	가남면제1투	2595	1676	919	6	1670	1131	532	1	2	0	4
경기도	여주시	가남면	가남면제2투	2032	1442	590	4	1438	959	472	0	3	3	1
경기도	여주시	가남면	가남면제3투	1143	800	343	3	797	556	238	0	1	0	2
경기도	여주시	가남면	가남면제4투	530	392	138	1	391	276	113	0	1	0	1
경기도	여주시	가남면	가남면제5투	3497	2590	907	12	2578	1367	1195	2	2	7	5
경기도	여주시	가남면	가남면제6투	2871	1967	904	2	1965	1288	671	1	0	1	4
경기도	여주시	능서면	소계	5532	3965	1567	26	3939	2756	1149	1	2	11	20
경기도	여주시	능서면	능서면제1투	2379	1664	715	11	1653	1126	511	0	0	4	12
경기도	여주시	능서면	능서면제2투	1975	1440	535	12	1428	1012	401	1	1	6	7
경기도	여주시	능서면	능서면제3투	1178	861	317	3	858	618	237	0	1	1	1
경기도	여주시	흥천면	소계	4507	3269	1238	9	3260	2302	940	2	2	4	10
경기도	여주시	흥천면	흥천면제1투	2697	1943	754	3	1940	1345	585	0	0	2	8
경기도	여주시	흥천면	흥천면제2투	1810	1326	484	6	1320	957	355	2	2	2	2
경기도	여주시	금사면	소계	2633	1933	700	11	1922	1488	425	1	2	2	4
경기도	여주시	금사면	금사면제1투	1718	1250	468	6	1244	976	261	0	2	2	3
경기도	여주시	금사면	금사면제2투	915	683	232	5	678	512	164	1	0	0	1
경기도	여주시	산북면	소계	2119	1564	555	4	1560	1078	468	0	2	3	9
경기도	여주시	산북면	산북면투표소	2119	1564	555	4	1560	1078	468	0	2	3	9
경기도	여주시	대신면	소계	6449	4612	1837	23	4589	3391	1171	1	3	8	15
경기도	여주시	대신면	대신면제1투	2442	1703	739	10	1693	1266	420	0	1	1	5
경기도	여주시	대신면	대신면제2투	1895	1374	521	4	1370	1021	338	0	2	5	4
경기도	여주시	대신면	대신면제3투	1211	884	327	7	877	637	236	1	0	1	2
경기도	여주시	대신면	대신면제4투	901	651	250	2	649	467	177	0	0	1	4
경기도	여주시	북내면	소계	4325	3096	1229	17	3079	2181	865	1	2	7	23
경기도	여주시	북내면	북내면제1투	2550	1836	714	8	1828	1304	508	0	1	2	13
경기도	여주시	북내면	북내면제2투	1145	820	325	6	814	594	209	0	1	4	6
경기도	여주시	북내면	북내면제3투	630	440	190	3	437	283	148	1	0	1	4
경기도	여주시	강천면	소계	3047	2284	763	11	2273	1634	626	1	0	3	9
경기도	여주시	강천면	강천면제1투	1061	778	283	4	774	553	214	1	0	3	3
경기도	여주시	강천면	강천면제2투	671	504	167	3	501	381	116	0	0	0	4
경기도	여주시	강천면	강천면제3투	581	416	165	1	415	286	128	0	0	0	1
경기도	여주시	강천면	강천면제4투	734	586	148	3	583	414	168	0	0	0	1
경기도	이천시	계	계	157488	113269	44219	553	112716	66241	45996	55	63	190	171
경기도	이천시	재외투표	재외투표	659	442	217	4	438	152	285	0	0	0	1
경기도	이천시	국내부재자투표	국내부재자투표	4008	3704	304	136	3568	1846	1664	16	9	15	18
경기도	이천시	장호원읍	소계	12311	8734	3577	32	8702	5803	2865	0	2	15	17
경기도	이천시	장호원읍	장호원읍제1투	2577	1728	849	4	1724	1162	558	0	2	2	0
경기도	이천시	장호원읍	장호원읍제2투	2140	1512	628	7	1505	1053	443	0	0	5	4
경기도	이천시	장호원읍	장호원읍제3투	1089	729	360	2	727	509	215	0	0	1	2
경기도	이천시	장호원읍	장호원읍제4투	1284	962	322	5	957	727	227	0	0	1	2
경기도	이천시	장호원읍	장호원읍제5투	894	672	222	1	671	501	165	0	0	2	3
경기도	이천시	장호원읍	장호원읍제6투	668	495	173	2	493	336	154	0	0	1	2
경기도	이천시	장호원읍	장호원읍제7투	3659	2636	1023	11	2625	1515	1103	0	0	3	4
경기도	이천시	부발읍	소계	27422	19559	7863	60	19499	9621	9815	10	9	28	16
경기도	이천시	부발읍	부발읍제1투	4784	3074	1710	9	3065	1851	1207	2	0	5	0
경기도	이천시	부발읍	부발읍제2투	2402	1688	714	4	1684	1194	484	1	2	1	2
경기도	이천시	부발읍	부발읍제3투	632	447	185	4	443	325	114	1	0	2	1
경기도	이천시	부발읍	부발읍제4투	3733	2710	1023	13	2697	1309	1379	2	1	3	3
경기도	이천시	부발읍	부발읍제5투	3779	2665	1114	10	2655	1409	1237	0	0	5	4
경기도	이천시	부발읍	부발읍제6투	2889	2221	668	3	2218	1004	1203	2	1	6	2
경기도	이천시	부발읍	부발읍제7투	2532	1778	754	3	1775	350	1423	0	1	1	0
경기도	이천시	부발읍	부발읍제8투	3644	2398	1246	7	2391	1228	1155	1	2	2	3
경기도	이천시	부발읍	부발읍제9투	3027	2578	449	7	2571	951	1613	1	2	3	1
경기도	이천시	신둔면	소계	8701	6165	2536	31	6134	3912	2187	2	3	13	17
경기도	이천시	신둔면	신둔면제1투	3383	2325	1058	5	2320	1456	848	1	3	7	5
경기도	이천시	신둔면	신둔면제2투	3302	2400	902	13	2387	1480	895	1	0	5	6
경기도	이천시	신둔면	신둔면제3투	2016	1440	576	13	1427	976	444	0	0	1	6
경기도	이천시	백사면	소계	7839	5481	2358	20	5461	3547	1898	1	0	7	8
경기도	이천시	백사면	백사면제1투	4276	2979	1297	12	2967	1986	971	0	0	4	6
경기도	이천시	백사면	백사면제2투	3563	2502	1061	8	2494	1561	927	1	0	3	2
경기도	이천시	호법면	소계	4582	3315	1267	11	3304	2361	926	3	2	6	6
경기도	이천시	호법면	호법면제1투	3335	2362	973	8	2354	1655	686	3	2	6	2
경기도	이천시	호법면	호법면제2투	1247	953	294	3	950	706	240	0	0	0	4
경기도	이천시	마장면	소계	6951	4677	2274	38	4639	3230	1389	3	0	10	7
경기도	이천시	마장면	마장면제1투	2514	1750	764	8	1742	1240	497	2	0	1	2
경기도	이천시	마장면	마장면제2투	2341	1607	734	6	1601	1108	489	0	0	3	1
경기도	이천시	마장면	마장면제3투	2096	1320	776	24	1296	882	403	1	0	6	4
경기도	이천시	대월면	소계	10221	7335	2886	17	7318	3870	3424	2	3	12	7
경기도	이천시	대월면	대월면제1투	3046	2110	936	8	2102	1332	761	2	0	5	2
경기도	이천시	대월면	대월면제2투	1326	940	386	1	939	668	264	0	1	3	3
경기도	이천시	대월면	대월면제3투	2484	1642	842	3	1639	1050	584	0	1	2	2
경기도	이천시	대월면	대월면제4투	3365	2643	722	5	2638	820	1815	0	1	2	0
경기도	이천시	모가면	소계	3982	2884	1098	14	2870	2109	740	3	1	6	11
경기도	이천시	모가면	모가면제1투	2407	1748	659	10	1738	1249	476	2	1	4	6
경기도	이천시	모가면	모가면제2투	1575	1136	439	4	1132	860	264	1	0	2	5
경기도	이천시	설성면	소계	4630	3352	1278	55	3297	2254	1002	5	8	8	20
경기도	이천시	설성면	설성면제1투	1742	1186	556	3	1183	798	374	1	2	2	6
경기도	이천시	설성면	설성면제2투	1241	913	328	46	867	578	270	4	6	2	7
경기도	이천시	설성면	설성면제3투	1647	1253	394	6	1247	878	358	0	0	4	7
경기도	이천시	율면	소계	2549	1868	681	12	1856	1243	602	1	0	5	5
경기도	이천시	율면	율면투표소	2549	1868	681	12	1856	1243	602	1	0	5	5
경기도	이천시	창전동	소계	15240	10230	5010	33	10197	6560	3610	3	6	10	8
경기도	이천시	창전동	창전동제1투	3811	2403	1408	5	2398	1535	856	0	1	2	4
경기도	이천시	창전동	창전동제2투	3085	2006	1079	9	1997	1304	688	1	2	1	1
경기도	이천시	창전동	창전동제3투	2865	1917	948	5	1912	1267	638	1	0	4	2
경기도	이천시	창전동	창전동제4투	2907	2146	761	8	2138	1342	791	0	2	3	0
경기도	이천시	창전동	창전동제5투	2572	1758	814	6	1752	1112	637	1	1	0	1
경기도	이천시	증포동	소계	28662	21648	7014	48	21600	11321	10222	2	12	29	14
경기도	이천시	증포동	증포동제1투	3442	2549	893	11	2538	1363	1165	1	3	2	4
경기도	이천시	증포동	증포동제2투	5067	3748	1319	12	3736	2134	1590	0	2	7	3
경기도	이천시	증포동	증포동제3투	4608	3499	1109	5	3494	1801	1687	1	1	4	0
경기도	이천시	증포동	증포동제4투	3000	2260	740	5	2255	1080	1173	0	1	0	1
경기도	이천시	증포동	증포동제5투	2461	1792	669	3	1789	1116	668	0	1	3	1
경기도	이천시	증포동	증포동제6투	3560	2866	694	6	2860	1460	1393	0	1	4	2
경기도	이천시	증포동	증포동제7투	3025	2320	705	3	2317	1085	1226	0	1	3	2
경기도	이천시	증포동	증포동제8투	3499	2614	885	3	2611	1282	1320	0	2	6	1
경기도	이천시	중리동	소계	11453	8069	3384	33	8036	4809	3200	3	4	11	9
경기도	이천시	중리동	중리동제1투	2870	1845	1025	7	1838	1222	609	1	0	4	2
경기도	이천시	중리동	중리동제2투	2848	1999	849	5	1994	1316	671	0	1	3	3
경기도	이천시	중리동	중리동제3투	3155	2400	755	11	2389	1077	1305	1	3	2	1
경기도	이천시	중리동	중리동제4투	2580	1825	755	10	1815	1194	615	1	0	2	3
경기도	이천시	관고동	소계	8278	5806	2472	9	5797	3603	2167	1	4	15	7
경기도	이천시	관고동	관고동제1투	3184	2210	974	2	2208	1326	872	0	1	6	3
경기도	이천시	관고동	관고동제2투	3160	2243	917	3	2240	1428	802	1	2	6	1
경기도	이천시	관고동	관고동제3투	1934	1353	581	4	1349	849	493	0	1	3	3
경기도	용인시처인구	계	계	164566	118365	46201	460	117905	67598	49828	44	63	215	157
경기도	용인시처인구	재외투표	재외투표	695	490	205	4	486	171	313	0	0	1	1
경기도	용인시처인구	국내부재자투표	국내부재자투표	3637	3394	243	60	3334	1714	1594	3	4	7	12
경기도	용인시처인구	포곡읍	소계	23939	16902	7037	49	16853	9148	7652	2	7	29	15
경기도	용인시처인구	포곡읍	포곡읍제1투	3771	2445	1326	13	2432	1323	1105	0	0	4	0
경기도	용인시처인구	포곡읍	포곡읍제2투	1526	1195	331	2	1193	606	583	0	1	2	1
경기도	용인시처인구	포곡읍	포곡읍제3투	2138	1548	590	7	1541	924	612	0	1	4	0
경기도	용인시처인구	포곡읍	포곡읍제4투	3710	2531	1179	7	2524	1455	1063	0	1	2	3
경기도	용인시처인구	포곡읍	포곡읍제5투	1157	848	309	1	847	624	221	0	0	0	2
경기도	용인시처인구	포곡읍	포곡읍제6투	2833	1972	861	3	1969	1052	910	2	0	3	2
경기도	용인시처인구	포곡읍	포곡읍제7투	4180	2906	1274	10	2896	1582	1302	0	2	7	3
경기도	용인시처인구	포곡읍	포곡읍제8투	4624	3457	1167	6	3451	1582	1856	0	2	7	4
경기도	용인시처인구	모현면	소계	17998	12951	5047	42	12909	7287	5570	6	3	20	23
경기도	용인시처인구	모현면	모현면제1투	5353	4088	1265	15	4073	2038	2020	3	0	7	5
경기도	용인시처인구	모현면	모현면제2투	3075	2190	885	7	2183	1362	812	0	1	5	3
경기도	용인시처인구	모현면	모현면제3투	4176	3065	1111	10	3055	1729	1314	0	1	4	7
경기도	용인시처인구	모현면	모현면제4투	2717	1792	925	5	1787	1127	650	2	0	2	6
경기도	용인시처인구	모현면	모현면제5투	2677	1816	861	5	1811	1031	774	1	1	2	2
경기도	용인시처인구	남사면	소계	6002	4390	1612	26	4364	2885	1457	2	5	9	6
경기도	용인시처인구	남사면	남사면제1투	1617	1153	464	8	1145	770	365	0	2	4	4
경기도	용인시처인구	남사면	남사면제2투	1106	814	292	3	811	532	274	1	2	2	0
경기도	용인시처인구	남사면	남사면제3투	1406	1073	333	9	1064	693	366	1	1	1	2
경기도	용인시처인구	남사면	남사면제4투	1873	1350	523	6	1344	890	452	0	0	2	0
경기도	용인시처인구	이동면	소계	15725	10885	4840	62	10823	6263	4491	9	7	28	25
경기도	용인시처인구	이동면	이동면제1투	3786	2641	1145	7	2634	1507	1117	1	0	6	3
경기도	용인시처인구	이동면	이동면제2투	886	664	222	7	657	482	171	0	0	2	2
경기도	용인시처인구	이동면	이동면제3투	1566	1170	396	7	1163	736	423	1	0	2	1
경기도	용인시처인구	이동면	이동면제4투	3920	2730	1190	11	2719	1610	1095	1	2	7	4
경기도	용인시처인구	이동면	이동면제5투	5567	3680	1887	30	3650	1928	1685	6	5	11	15
경기도	용인시처인구	원삼면	소계	6394	4777	1617	28	4749	3262	1462	1	4	11	9
경기도	용인시처인구	원삼면	원삼면제1투	1750	1271	479	5	1266	912	346	1	0	5	2
경기도	용인시처인구	원삼면	원삼면제2투	1497	1163	334	10	1153	804	343	0	1	2	3
경기도	용인시처인구	원삼면	원삼면제3투	2083	1601	482	9	1592	1037	547	0	2	3	3
경기도	용인시처인구	원삼면	원삼면제4투	1064	742	322	4	738	509	226	0	1	1	1
경기도	용인시처인구	백암면	소계	7961	5527	2434	47	5480	3744	1698	6	5	10	17
경기도	용인시처인구	백암면	백암면제1투	1881	1250	631	3	1247	887	355	0	0	1	4
경기도	용인시처인구	백암면	백암면제2투	1016	760	256	1	759	524	233	0	0	1	1
경기도	용인시처인구	백암면	백암면제3투	1634	1055	579	10	1045	703	339	0	0	1	2
경기도	용인시처인구	백암면	백암면제4투	1695	1200	495	19	1181	789	370	5	3	5	9
경기도	용인시처인구	백암면	백암면제5투	1735	1262	473	14	1248	841	401	1	2	2	1
경기도	용인시처인구	양지면	소계	12198	8544	3654	24	8520	5046	3451	2	3	9	9
경기도	용인시처인구	양지면	양지면제1투	4538	3177	1361	10	3167	1839	1324	0	0	2	2
경기도	용인시처인구	양지면	양지면제2투	2873	2089	784	1	2088	1257	823	0	1	5	2
경기도	용인시처인구	양지면	양지면제3투	2027	1406	621	8	1398	908	482	1	2	1	4
경기도	용인시처인구	양지면	양지면제4투	2760	1872	888	5	1867	1042	822	1	0	1	1
경기도	용인시처인구	중앙동	소계	18984	13611	5373	36	13575	8097	5436	5	3	23	11
경기도	용인시처인구	중앙동	중앙동제1투	2532	1619	913	4	1615	972	637	1	1	2	2
경기도	용인시처인구	중앙동	중앙동제2투	1788	1224	564	4	1220	774	443	1	1	0	1
경기도	용인시처인구	중앙동	중앙동제3투	1898	1340	558	4	1336	793	541	1	0	1	0
경기도	용인시처인구	중앙동	중앙동제4투	2302	1605	697	7	1598	938	653	1	0	5	1
경기도	용인시처인구	중앙동	중앙동제5투	2449	1819	630	6	1813	1080	729	1	1	2	0
경기도	용인시처인구	중앙동	중앙동제6투	4442	3188	1254	7	3181	1886	1279	0	0	11	5
경기도	용인시처인구	중앙동	중앙동제7투	3573	2816	757	4	2812	1654	1154	0	0	2	2
경기도	용인시처인구	역삼동	소계	17093	12634	4459	25	12609	6786	5783	3	6	25	6
경기도	용인시처인구	역삼동	역삼동제1투	3066	2050	1016	8	2042	1120	913	0	1	8	0
경기도	용인시처인구	역삼동	역삼동제2투	3228	2304	924	1	2303	1335	961	0	2	2	3
경기도	용인시처인구	역삼동	역삼동제3투	2469	1731	738	3	1728	979	748	0	0	0	1
경기도	용인시처인구	역삼동	역삼동제4투	2936	2268	668	4	2264	1231	1025	0	1	5	2
경기도	용인시처인구	역삼동	역삼동제5투	3565	2753	812	6	2747	1320	1414	2	2	9	0
경기도	용인시처인구	역삼동	역삼동제6투	1829	1528	301	3	1525	801	722	1	0	1	0
경기도	용인시처인구	유림동	소계	23090	16418	6672	37	16381	8594	7737	3	14	21	12
경기도	용인시처인구	유림동	유림동제1투	3571	2272	1299	6	2266	1282	976	0	5	2	1
경기도	용인시처인구	유림동	유림동제2투	3287	2535	752	4	2531	1272	1250	1	0	6	2
경기도	용인시처인구	유림동	유림동제3투	2660	1894	766	3	1891	1125	762	0	0	2	2
경기도	용인시처인구	유림동	유림동제4투	5107	3365	1742	6	3359	1820	1531	0	2	1	5
경기도	용인시처인구	유림동	유림동제5투	4686	3503	1183	12	3491	1627	1858	1	3	2	0
경기도	용인시처인구	유림동	유림동제6투	3779	2849	930	6	2843	1468	1360	1	4	8	2
경기도	용인시처인구	동부동	소계	10850	7842	3008	20	7822	4601	3184	2	2	22	11
경기도	용인시처인구	동부동	동부동제1투	4313	3108	1205	8	3100	1753	1337	0	1	5	4
경기도	용인시처인구	동부동	동부동제2투	4798	3407	1391	10	3397	1929	1446	2	1	14	5
경기도	용인시처인구	동부동	동부동제3투	1739	1327	412	2	1325	919	401	0	0	3	2
경기도	용인시수지구	계	계	244771	195876	48895	414	195462	101487	93337	39	72	402	125
경기도	용인시수지구	재외투표	재외투표	2948	2082	866	14	2068	877	1182	0	3	4	2
경기도	용인시수지구	국내부재자투표	국내부재자투표	5079	4714	365	56	4658	2389	2239	6	7	6	11
경기도	용인시수지구	풍덕천1동	소계	26054	20126	5928	37	20089	9353	10677	3	7	40	9
경기도	용인시수지구	풍덕천1동	풍덕천1동제1투	3727	2323	1404	7	2316	1058	1253	0	0	4	1
경기도	용인시수지구	풍덕천1동	풍덕천1동제2투	3627	2692	935	8	2684	1376	1303	0	1	2	2
경기도	용인시수지구	풍덕천1동	풍덕천1동제3투	3588	2831	757	5	2826	1166	1652	1	1	5	1
경기도	용인시수지구	풍덕천1동	풍덕천1동제4투	4007	3227	780	8	3219	1472	1741	0	2	3	1
경기도	용인시수지구	풍덕천1동	풍덕천1동제5투	4057	3307	750	2	3305	1506	1786	1	2	9	1
경기도	용인시수지구	풍덕천1동	풍덕천1동제6투	3433	2788	645	6	2782	1474	1294	1	1	11	1
경기도	용인시수지구	풍덕천1동	풍덕천1동제7투	3615	2958	657	1	2957	1301	1648	0	0	6	2
경기도	용인시수지구	풍덕천2동	소계	27599	22351	5248	34	22317	10504	11737	3	10	52	11
경기도	용인시수지구	풍덕천2동	풍덕천2동제1투	3234	2787	447	3	2784	1310	1464	0	2	6	2
경기도	용인시수지구	풍덕천2동	풍덕천2동제2투	2834	2009	825	3	2006	951	1045	2	1	5	2
경기도	용인시수지구	풍덕천2동	풍덕천2동제3투	3693	3121	572	2	3119	1506	1601	1	1	10	0
경기도	용인시수지구	풍덕천2동	풍덕천2동제4투	3200	2463	737	6	2457	921	1527	0	3	4	2
경기도	용인시수지구	풍덕천2동	풍덕천2동제5투	4240	3465	775	7	3458	1322	2126	0	3	5	2
경기도	용인시수지구	풍덕천2동	풍덕천2동제6투	3302	2723	579	5	2718	1321	1384	0	0	11	2
경기도	용인시수지구	풍덕천2동	풍덕천2동제7투	2970	2444	526	5	2439	1147	1288	0	0	4	0
경기도	용인시수지구	풍덕천2동	풍덕천2동제8투	4126	3339	787	3	3336	2026	1302	0	0	7	1
경기도	용인시수지구	신봉동	소계	22780	18407	4373	18	18389	10340	7993	1	6	38	11
경기도	용인시수지구	신봉동	신봉동제1투	2607	2129	478	5	2124	913	1206	0	1	3	1
경기도	용인시수지구	신봉동	신봉동제2투	2993	2504	489	2	2502	1156	1338	0	1	5	2
경기도	용인시수지구	신봉동	신봉동제3투	4701	3809	892	3	3806	2182	1614	0	1	8	1
경기도	용인시수지구	신봉동	신봉동제4투	3811	3081	730	3	3078	1801	1265	1	0	9	2
경기도	용인시수지구	신봉동	신봉동제5투	2803	2240	563	0	2240	1565	665	0	1	6	3
경기도	용인시수지구	신봉동	신봉동제6투	3896	3056	840	3	3053	1817	1232	0	1	2	1
경기도	용인시수지구	신봉동	신봉동제7투	1969	1588	381	2	1586	906	673	0	1	5	1
경기도	용인시수지구	죽전1동	소계	42758	34163	8595	59	34104	16512	17489	8	6	65	24
경기도	용인시수지구	죽전1동	죽전1동제1투	4347	3320	1027	6	3314	1500	1799	2	2	8	3
경기도	용인시수지구	죽전1동	죽전1동제2투	4695	3799	896	3	3796	1757	2034	0	1	2	2
경기도	용인시수지구	죽전1동	죽전1동제3투	4514	3678	836	4	3674	1761	1898	2	0	10	3
경기도	용인시수지구	죽전1동	죽전1동제4투	4807	3934	873	6	3928	2011	1906	1	0	8	2
경기도	용인시수지구	죽전1동	죽전1동제5투	4483	3693	790	5	3688	1667	2012	0	0	6	3
경기도	용인시수지구	죽전1동	죽전1동제6투	4096	3312	784	2	3310	1889	1417	0	0	2	2
경기도	용인시수지구	죽전1동	죽전1동제7투	3592	2831	761	6	2825	1533	1279	0	0	10	3
경기도	용인시수지구	죽전1동	죽전1동제8투	4156	3238	918	10	3228	1514	1702	0	2	8	2
경기도	용인시수지구	죽전1동	죽전1동제9투	4438	3470	968	12	3458	1555	1896	1	1	4	1
경기도	용인시수지구	죽전1동	죽전1동제10투	3630	2888	742	5	2883	1325	1546	2	0	7	3
경기도	용인시수지구	죽전2동	소계	15040	11934	3106	33	11901	5441	6412	4	4	28	12
경기도	용인시수지구	죽전2동	죽전2동제1투	4140	3138	1002	8	3130	1340	1779	1	1	5	4
경기도	용인시수지구	죽전2동	죽전2동제2투	3868	3086	782	6	3080	1410	1658	0	0	7	5
경기도	용인시수지구	죽전2동	죽전2동제3투	3535	2875	660	8	2867	1430	1426	2	1	8	0
경기도	용인시수지구	죽전2동	죽전2동제4투	3497	2835	662	11	2824	1261	1549	1	2	8	3
경기도	용인시수지구	동천동	소계	24140	19449	4691	46	19403	10103	9222	4	12	49	13
경기도	용인시수지구	동천동	동천동제1투	3982	3190	792	13	3177	1562	1598	1	1	11	4
경기도	용인시수지구	동천동	동천동제2투	2341	1803	538	10	1793	952	827	1	5	7	1
경기도	용인시수지구	동천동	동천동제3투	3512	2940	572	4	2936	1498	1430	1	0	5	2
경기도	용인시수지구	동천동	동천동제4투	4442	3593	849	3	3590	1624	1953	1	1	8	3
경기도	용인시수지구	동천동	동천동제5투	1569	1185	384	5	1180	703	468	0	1	8	0
경기도	용인시수지구	동천동	동천동제6투	3008	2416	592	5	2411	1052	1351	0	2	5	1
경기도	용인시수지구	동천동	동천동제7투	2003	1630	373	1	1629	972	654	0	0	2	1
경기도	용인시수지구	동천동	동천동제8투	3283	2692	591	5	2687	1740	941	0	2	3	1
경기도	용인시수지구	상현1동	소계	30627	24419	6208	38	24381	13113	11197	5	8	47	11
경기도	용인시수지구	상현1동	상현1동제1투	3563	2789	774	3	2786	1597	1175	1	0	12	1
경기도	용인시수지구	상현1동	상현1동제2투	4563	3619	944	8	3611	2170	1432	0	2	3	4
경기도	용인시수지구	상현1동	상현1동제3투	3788	3052	736	1	3051	1561	1481	1	2	5	1
경기도	용인시수지구	상현1동	상현1동제4투	3078	2477	601	7	2470	1529	933	1	1	6	0
경기도	용인시수지구	상현1동	상현1동제5투	3169	2474	695	6	2468	1419	1046	0	0	3	0
경기도	용인시수지구	상현1동	상현1동제6투	3522	2818	704	4	2814	1448	1358	1	1	5	1
경기도	용인시수지구	상현1동	상현1동제7투	3128	2545	583	6	2539	1428	1099	1	1	8	2
경기도	용인시수지구	상현1동	상현1동제8투	2357	1925	432	1	1924	839	1081	0	0	2	2
경기도	용인시수지구	상현1동	상현1동제9투	3459	2720	739	2	2718	1122	1592	0	1	3	0
경기도	용인시수지구	상현2동	소계	23095	18673	4422	37	18636	9948	8634	2	3	38	11
경기도	용인시수지구	상현2동	상현2동제1투	3603	2834	769	6	2828	1586	1231	0	0	8	3
경기도	용인시수지구	상현2동	상현2동제2투	3874	3066	808	6	3060	1795	1261	0	0	4	0
경기도	용인시수지구	상현2동	상현2동제3투	3412	2771	641	1	2770	1529	1233	1	1	4	2
경기도	용인시수지구	상현2동	상현2동제4투	3858	3154	704	4	3150	1639	1502	0	1	7	1
경기도	용인시수지구	상현2동	상현2동제5투	4187	3397	790	10	3387	1717	1661	0	0	7	2
경기도	용인시수지구	상현2동	상현2동제6투	4161	3451	710	10	3441	1682	1746	1	1	8	3
경기도	용인시수지구	성복동	소계	24651	19558	5093	42	19516	12907	6555	3	6	35	10
경기도	용인시수지구	성복동	성복동제1투	3353	2725	628	10	2715	1799	907	0	2	5	2
경기도	용인시수지구	성복동	성복동제2투	4141	3298	843	4	3294	2375	908	0	1	8	2
경기도	용인시수지구	성복동	성복동제3투	3101	2446	655	5	2441	1813	623	1	1	2	1
경기도	용인시수지구	성복동	성복동제4투	5300	4251	1049	7	4244	2588	1642	0	1	11	2
경기도	용인시수지구	성복동	성복동제5투	4793	3811	982	3	3808	2493	1308	1	0	5	1
경기도	용인시수지구	성복동	성복동제6투	3963	3027	936	13	3014	1839	1167	1	1	4	2
경기도	용인시기흥구	계	계	277326	217011	60315	461	216550	104957	110907	28	82	421	155
경기도	용인시기흥구	재외투표	재외투표	2361	1692	669	10	1682	640	1035	0	1	4	2
경기도	용인시기흥구	국내부재자투표	국내부재자투표	5553	5171	382	73	5098	2514	2551	4	4	12	13
경기도	용인시기흥구	신갈동	소계	25080	18938	6142	44	18894	9130	9707	4	10	31	12
경기도	용인시기흥구	신갈동	신갈동제1투	3233	2147	1086	6	2141	1218	918	0	1	1	3
경기도	용인시기흥구	신갈동	신갈동제2투	3367	2538	829	7	2531	1266	1258	1	0	3	3
경기도	용인시기흥구	신갈동	신갈동제3투	2555	1587	968	8	1579	842	729	1	1	5	1
경기도	용인시기흥구	신갈동	신갈동제4투	1965	1443	522	3	1440	669	767	0	2	2	0
경기도	용인시기흥구	신갈동	신갈동제5투	3454	2782	672	6	2776	1467	1300	0	2	4	3
경기도	용인시기흥구	신갈동	신갈동제6투	2962	2400	562	4	2396	976	1417	1	0	2	0
경기도	용인시기흥구	신갈동	신갈동제7투	4699	3630	1069	5	3625	1599	2011	1	3	10	1
경기도	용인시기흥구	신갈동	신갈동제8투	2845	2411	434	5	2406	1093	1307	0	1	4	1
경기도	용인시기흥구	영덕동	소계	28265	22361	5904	32	22329	9888	12370	3	9	41	18
경기도	용인시기흥구	영덕동	영덕동제1투	2924	2242	682	5	2237	1298	933	0	0	3	3
경기도	용인시기흥구	영덕동	영덕동제2투	2161	1753	408	2	1751	823	920	0	2	5	1
경기도	용인시기흥구	영덕동	영덕동제3투	3018	2459	559	7	2452	1000	1448	1	0	3	0
경기도	용인시기흥구	영덕동	영덕동제4투	2453	1921	532	2	1919	926	982	0	2	5	4
경기도	용인시기흥구	영덕동	영덕동제5투	3891	3114	777	5	3109	1564	1533	0	1	8	3
경기도	용인시기흥구	영덕동	영덕동제6투	5222	4305	917	6	4299	1758	2524	1	3	10	3
경기도	용인시기흥구	영덕동	영덕동제7투	5115	3696	1419	4	3692	1605	2079	1	0	5	2
경기도	용인시기흥구	영덕동	영덕동제8투	3481	2871	610	1	2870	914	1951	0	1	2	2
경기도	용인시기흥구	구갈동	소계	20527	15485	5042	32	15453	7135	8267	3	6	29	13
경기도	용인시기흥구	구갈동	구갈동제1투	3175	2160	1015	2	2158	864	1288	0	1	3	2
경기도	용인시기흥구	구갈동	구갈동제2투	3142	2141	1001	5	2136	1011	1117	0	0	5	3
경기도	용인시기흥구	구갈동	구갈동제3투	2768	2012	756	5	2007	1000	999	2	0	5	1
경기도	용인시기흥구	구갈동	구갈동제4투	3090	2479	611	4	2475	1152	1313	0	2	7	1
경기도	용인시기흥구	구갈동	구갈동제5투	3977	3001	976	6	2995	1378	1609	0	1	5	2
경기도	용인시기흥구	구갈동	구갈동제6투	2019	1714	305	5	1709	765	938	1	1	2	2
경기도	용인시기흥구	구갈동	구갈동제7투	2356	1978	378	5	1973	965	1003	0	1	2	2
경기도	용인시기흥구	상갈동	소계	33323	25888	7435	50	25838	12292	13462	9	13	48	14
경기도	용인시기흥구	상갈동	상갈동제1투	3441	2592	849	3	2589	1249	1331	0	2	4	3
경기도	용인시기흥구	상갈동	상갈동제2투	4112	2887	1225	5	2882	1058	1816	1	3	2	2
경기도	용인시기흥구	상갈동	상갈동제3투	3361	2790	571	2	2788	1309	1468	0	1	9	1
경기도	용인시기흥구	상갈동	상갈동제4투	1651	1168	483	3	1165	620	540	0	0	2	3
경기도	용인시기흥구	상갈동	상갈동제5투	2275	1757	518	5	1752	915	827	1	3	4	2
경기도	용인시기흥구	상갈동	상갈동제6투	2736	2249	487	5	2244	1078	1159	3	0	4	0
경기도	용인시기흥구	상갈동	상갈동제7투	3905	3136	769	10	3126	1818	1299	1	1	7	0
경기도	용인시기흥구	상갈동	상갈동제8투	2683	2114	569	4	2110	1081	1023	0	1	5	0
경기도	용인시기흥구	상갈동	상갈동제9투	3465	2586	879	5	2581	1208	1368	1	0	4	0
경기도	용인시기흥구	상갈동	상갈동제10투	2543	2111	432	4	2107	725	1376	0	0	5	1
경기도	용인시기흥구	상갈동	상갈동제11투	3151	2498	653	4	2494	1231	1255	2	2	2	2
경기도	용인시기흥구	기흥동	소계	14430	10785	3645	23	10762	5376	5344	0	3	23	16
경기도	용인시기흥구	기흥동	기흥동제1투	2317	1633	684	1	1632	765	857	0	0	8	2
경기도	용인시기흥구	기흥동	기흥동제2투	3372	2551	821	8	2543	1041	1492	0	1	4	5
경기도	용인시기흥구	기흥동	기흥동제3투	1193	835	358	1	834	563	269	0	1	1	0
경기도	용인시기흥구	기흥동	기흥동제4투	4212	3159	1053	8	3151	1550	1589	0	0	6	6
경기도	용인시기흥구	기흥동	기흥동제5투	3336	2607	729	5	2602	1457	1137	0	1	4	3
경기도	용인시기흥구	서농동	소계	10504	8021	2483	13	8008	3232	4746	0	7	19	4
경기도	용인시기흥구	서농동	서농동제1투	2428	1727	701	5	1722	322	1397	0	1	2	0
경기도	용인시기흥구	서농동	서농동제2투	3213	2539	674	3	2536	1237	1288	0	3	7	1
경기도	용인시기흥구	서농동	서농동제3투	1912	1562	350	2	1560	773	781	0	0	5	1
경기도	용인시기흥구	서농동	서농동제4투	2951	2193	758	3	2190	900	1280	0	3	5	2
경기도	용인시기흥구	구성동	소계	28136	22219	5917	47	22172	11557	10572	1	8	27	7
경기도	용인시기흥구	구성동	구성동제1투	3570	2778	792	5	2773	1826	940	1	2	2	2
경기도	용인시기흥구	구성동	구성동제2투	3592	2865	727	6	2859	1712	1145	0	0	2	0
경기도	용인시기흥구	구성동	구성동제3투	4233	3318	915	8	3310	1612	1690	0	3	5	0
경기도	용인시기흥구	구성동	구성동제4투	3923	3290	633	4	3286	1786	1490	0	1	7	2
경기도	용인시기흥구	구성동	구성동제5투	2067	1674	393	4	1670	884	781	0	0	4	1
경기도	용인시기흥구	구성동	구성동제6투	3805	2977	828	6	2971	1235	1732	0	0	2	2
경기도	용인시기흥구	구성동	구성동제7투	3535	2736	799	10	2726	1332	1390	0	1	3	0
경기도	용인시기흥구	구성동	구성동제8투	3411	2581	830	4	2577	1170	1404	0	1	2	0
경기도	용인시기흥구	마북동	소계	23474	18567	4907	30	18537	10333	8159	0	5	32	8
경기도	용인시기흥구	마북동	마북동제1투	3175	2395	780	3	2392	1333	1054	0	1	3	1
경기도	용인시기흥구	마북동	마북동제2투	3893	3066	827	6	3060	1849	1203	0	1	6	1
경기도	용인시기흥구	마북동	마북동제3투	3042	2372	670	7	2365	1178	1177	0	1	8	1
경기도	용인시기흥구	마북동	마북동제4투	3261	2693	568	3	2690	1758	926	0	0	3	3
경기도	용인시기흥구	마북동	마북동제5투	3777	3053	724	7	3046	1499	1542	0	0	4	1
경기도	용인시기흥구	마북동	마북동제6투	2817	2211	606	2	2209	1293	911	0	1	4	0
경기도	용인시기흥구	마북동	마북동제7투	3509	2777	732	2	2775	1423	1346	0	1	4	1
경기도	용인시기흥구	동백동	소계	43501	34651	8850	54	34597	15226	19260	3	10	74	24
경기도	용인시기흥구	동백동	동백동제1투	4419	3516	903	6	3510	1671	1823	1	2	10	3
경기도	용인시기흥구	동백동	동백동제2투	3929	3270	659	4	3266	1258	2002	0	1	3	2
경기도	용인시기흥구	동백동	동백동제3투	3418	2661	757	8	2653	1254	1388	0	0	8	3
경기도	용인시기흥구	동백동	동백동제4투	3777	2963	814	6	2957	1097	1854	0	1	4	1
경기도	용인시기흥구	동백동	동백동제5투	3298	2544	754	5	2539	1146	1388	0	0	3	2
경기도	용인시기흥구	동백동	동백동제6투	4080	3162	918	2	3160	1194	1953	0	2	9	2
경기도	용인시기흥구	동백동	동백동제7투	3092	2527	565	2	2525	1089	1432	1	0	3	0
경기도	용인시기흥구	동백동	동백동제8투	3850	3176	674	4	3172	1471	1688	0	1	8	4
경기도	용인시기흥구	동백동	동백동제9투	4803	3784	1019	7	3777	2008	1754	1	2	9	3
경기도	용인시기흥구	동백동	동백동제10투	2528	2102	426	2	2100	795	1296	0	0	8	1
경기도	용인시기흥구	동백동	동백동제11투	2767	2197	570	1	2196	880	1310	0	0	6	0
경기도	용인시기흥구	동백동	동백동제12투	3540	2749	791	7	2742	1363	1372	0	1	3	3
경기도	용인시기흥구	상하동	소계	17024	13180	3844	28	13152	6373	6742	0	1	26	10
경기도	용인시기흥구	상하동	상하동제1투	3673	2811	862	7	2804	1324	1470	0	0	8	2
경기도	용인시기흥구	상하동	상하동제2투	3584	2751	833	3	2748	1351	1392	0	1	1	3
경기도	용인시기흥구	상하동	상하동제3투	3245	2575	670	3	2572	1222	1341	0	0	7	2
경기도	용인시기흥구	상하동	상하동제4투	4114	3110	1004	9	3101	1522	1571	0	0	6	2
경기도	용인시기흥구	상하동	상하동제5투	2408	1933	475	6	1927	954	968	0	0	4	1
경기도	용인시기흥구	보정동	소계	25148	20053	5095	25	20028	11261	8692	1	5	55	14
경기도	용인시기흥구	보정동	보정동제1투	4521	3384	1137	4	3380	1780	1592	0	1	7	0
경기도	용인시기흥구	보정동	보정동제2투	4242	3499	743	5	3494	2397	1095	0	0	1	1
경기도	용인시기흥구	보정동	보정동제3투	5011	4027	984	5	4022	2365	1629	0	1	21	6
경기도	용인시기흥구	보정동	보정동제4투	3107	2525	582	2	2523	1309	1200	0	1	12	1
경기도	용인시기흥구	보정동	보정동제5투	3106	2438	668	3	2435	1357	1070	0	1	5	2
경기도	용인시기흥구	보정동	보정동제6투	3780	3121	659	3	3118	1401	1704	0	1	8	4
경기도	용인시기흥구	보정동	보정동제7투	1381	1059	322	3	1056	652	402	1	0	1	0
경기도	안성시	계	계	142260	102464	39796	399	102065	57656	43967	35	52	183	172
경기도	안성시	재외투표	재외투표	501	345	156	1	344	135	206	0	0	2	1
경기도	안성시	국내부재자투표	국내부재자투표	3274	3013	261	74	2939	1434	1484	3	6	6	6
경기도	안성시	공도읍	소계	39362	28331	11031	62	28269	13671	14511	4	11	47	25
경기도	안성시	공도읍	공도읍제1투	2416	1707	709	9	1698	1124	568	0	1	2	3
경기도	안성시	공도읍	공도읍제2투	2566	1825	741	4	1821	844	970	1	0	5	1
경기도	안성시	공도읍	공도읍제3투	2707	1941	766	4	1937	1022	912	1	0	0	2
경기도	안성시	공도읍	공도읍제4투	4580	3007	1573	6	3001	1589	1406	0	0	3	3
경기도	안성시	공도읍	공도읍제5투	4015	3071	944	4	3067	1521	1531	1	1	9	4
경기도	안성시	공도읍	공도읍제6투	3481	2411	1070	7	2404	1064	1333	1	0	4	2
경기도	안성시	공도읍	공도읍제7투	4073	2777	1296	5	2772	1436	1324	0	2	6	4
경기도	안성시	공도읍	공도읍제8투	4272	2942	1330	5	2937	1318	1606	0	2	8	3
경기도	안성시	공도읍	공도읍제9투	2254	1663	591	4	1659	728	926	0	2	3	0
경기도	안성시	공도읍	공도읍제10투	4070	3084	986	6	3078	1420	1653	0	0	3	2
경기도	안성시	공도읍	공도읍제11투	4928	3903	1025	8	3895	1605	2282	0	3	4	1
경기도	안성시	보개면	소계	5279	3779	1500	14	3765	2389	1349	4	4	6	13
경기도	안성시	보개면	보개면제1투	1733	1159	574	3	1156	673	481	0	1	0	1
경기도	안성시	보개면	보개면제2투	937	694	243	2	692	467	220	1	0	0	4
경기도	안성시	보개면	보개면제3투	1591	1154	437	7	1147	697	441	2	1	3	3
경기도	안성시	보개면	보개면제4투	1018	772	246	2	770	552	207	1	2	3	5
경기도	안성시	금광면	소계	6609	4843	1766	17	4826	2717	2082	2	2	7	16
경기도	안성시	금광면	금광면제1투	1527	1103	424	6	1097	698	389	1	0	2	7
경기도	안성시	금광면	금광면제2투	780	571	209	1	570	397	171	0	0	0	2
경기도	안성시	금광면	금광면제3투	754	542	212	4	538	319	214	0	0	2	3
경기도	안성시	금광면	금광면제4투	666	499	167	2	497	337	155	1	0	1	3
경기도	안성시	금광면	금광면제5투	2882	2128	754	4	2124	966	1153	0	2	2	1
경기도	안성시	서운면	소계	3421	2440	981	10	2430	1637	783	1	1	1	7
경기도	안성시	서운면	서운면제1투	1886	1302	584	5	1297	874	420	0	0	0	3
경기도	안성시	서운면	서운면제2투	699	521	178	3	518	375	139	1	1	0	2
경기도	안성시	서운면	서운면제3투	836	617	219	2	615	388	224	0	0	1	2
경기도	안성시	미양면	소계	6097	4290	1807	25	4265	2481	1756	2	1	10	15
경기도	안성시	미양면	미양면제1투	1946	1410	536	11	1399	827	563	1	0	2	6
경기도	안성시	미양면	미양면제2투	2729	1820	909	6	1814	969	838	1	1	2	3
경기도	안성시	미양면	미양면제3투	1422	1060	362	8	1052	685	355	0	0	6	6
경기도	안성시	대덕면	소계	9431	5565	3866	18	5547	3170	2353	3	4	9	8
경기도	안성시	대덕면	대덕면제1투	2288	1571	717	3	1568	997	560	2	2	4	3
경기도	안성시	대덕면	대덕면제2투	1881	1324	557	6	1318	748	565	0	1	2	2
경기도	안성시	대덕면	대덕면제3투	5262	2670	2592	9	2661	1425	1228	1	1	3	3
경기도	안성시	양성면	소계	4693	3428	1265	20	3408	2382	996	3	3	14	10
경기도	안성시	양성면	양성면제1투	1923	1408	515	7	1401	954	438	0	1	3	5
경기도	안성시	양성면	양성면제2투	1228	934	294	5	929	682	244	0	1	1	1
경기도	안성시	양성면	양성면제3투	1542	1086	456	8	1078	746	314	3	1	10	4
경기도	안성시	원곡면	소계	4064	2982	1082	14	2968	1827	1128	0	2	5	6
경기도	안성시	원곡면	원곡면제1투	2211	1587	624	12	1575	1035	532	0	1	3	4
경기도	안성시	원곡면	원곡면제2투	1099	843	256	0	843	398	443	0	1	0	1
경기도	안성시	원곡면	원곡면제3투	754	552	202	2	550	394	153	0	0	2	1
경기도	안성시	일죽면	소계	7053	5053	2000	18	5035	3349	1662	1	1	8	14
경기도	안성시	일죽면	일죽면제1투	2303	1622	681	2	1620	1038	580	0	0	1	1
경기도	안성시	일죽면	일죽면제2투	1790	1300	490	9	1291	876	411	0	0	1	3
경기도	안성시	일죽면	일죽면제3투	1698	1272	426	7	1265	850	405	1	1	2	6
경기도	안성시	일죽면	일죽면제4투	1262	859	403	0	859	585	266	0	0	4	4
경기도	안성시	죽산면	소계	6060	4292	1768	21	4271	2860	1395	2	1	5	8
경기도	안성시	죽산면	죽산면제1투	3265	2330	935	8	2322	1585	729	1	1	3	3
경기도	안성시	죽산면	죽산면제2투	1876	1283	593	6	1277	801	469	1	0	2	4
경기도	안성시	죽산면	죽산면제3투	919	679	240	7	672	474	197	0	0	0	1
경기도	안성시	삼죽면	소계	3278	2219	1059	6	2213	1351	840	1	2	10	9
경기도	안성시	삼죽면	삼죽면제1투	1894	1355	539	5	1350	843	494	1	2	6	4
경기도	안성시	삼죽면	삼죽면제2투	1384	864	520	1	863	508	346	0	0	4	5
경기도	안성시	고삼면	소계	1812	1385	427	5	1380	870	491	1	2	5	11
경기도	안성시	고삼면	고삼면제1투	1183	900	283	4	896	572	314	1	1	4	4
경기도	안성시	고삼면	고삼면제2투	629	485	144	1	484	298	177	0	1	1	7
경기도	안성시	안성1동	소계	10444	7553	2891	26	7527	4654	2848	0	1	17	7
경기도	안성시	안성1동	안성1동제1투	2259	1558	701	4	1554	983	569	0	0	2	0
경기도	안성시	안성1동	안성1동제2투	2726	2056	670	5	2051	1213	832	0	1	4	1
경기도	안성시	안성1동	안성1동제3투	3270	2375	895	14	2361	1431	918	0	0	8	4
경기도	안성시	안성1동	안성1동제4투	2189	1564	625	3	1561	1027	529	0	0	3	2
경기도	안성시	안성2동	소계	14098	10295	3803	25	10270	5642	4589	5	6	18	10
경기도	안성시	안성2동	안성2동제1투	3747	2752	995	4	2748	1598	1142	0	1	4	3
경기도	안성시	안성2동	안성2동제2투	5194	3614	1580	13	3601	1973	1618	3	1	4	2
경기도	안성시	안성2동	안성2동제3투	4060	3122	938	5	3117	1592	1510	1	3	6	5
경기도	안성시	안성2동	안성2동제4투	1097	807	290	3	804	479	319	1	1	4	0
경기도	안성시	안성3동	소계	16784	12651	4133	43	12608	7087	5494	3	5	13	6
경기도	안성시	안성3동	안성3동제1투	2132	1558	574	5	1553	854	698	0	0	1	0
경기도	안성시	안성3동	안성3동제2투	2326	1906	420	8	1898	1029	866	0	0	1	2
경기도	안성시	안성3동	안성3동제3투	1971	1438	533	4	1434	859	573	0	1	0	1
경기도	안성시	안성3동	안성3동제4투	3129	2283	846	9	2274	1353	917	1	1	2	0
경기도	안성시	안성3동	안성3동제5투	3367	2512	855	9	2503	1335	1156	0	3	7	2
경기도	안성시	안성3동	안성3동제6투	1690	1213	477	6	1207	717	487	1	0	1	1
경기도	안성시	안성3동	안성3동제7투	2169	1741	428	2	1739	940	797	1	0	1	0
경기도	김포시	계	계	218508	164872	53636	488	164384	88962	74859	41	68	298	156
경기도	김포시	재외투표	재외투표	1187	833	354	0	833	355	471	1	0	5	1
경기도	김포시	국내부재자투표	국내부재자투표	4856	4504	352	70	4434	2231	2158	4	11	12	18
경기도	김포시	통진읍	소계	21548	14920	6628	54	14866	9002	5799	7	9	23	26
경기도	김포시	통진읍	통진읍제1투	2662	2101	561	4	2097	1199	886	2	2	5	3
경기도	김포시	통진읍	통진읍제2투	2059	1373	686	9	1364	874	488	0	1	0	1
경기도	김포시	통진읍	통진읍제3투	3567	2435	1132	7	2428	1511	908	1	2	3	3
경기도	김포시	통진읍	통진읍제4투	1701	1296	405	7	1289	870	411	0	0	2	6
경기도	김포시	통진읍	통진읍제5투	2136	1525	611	8	1517	960	543	4	0	5	5
경기도	김포시	통진읍	통진읍제6투	3366	2299	1067	8	2291	1433	847	0	2	5	4
경기도	김포시	통진읍	통진읍제7투	2441	1608	833	7	1601	963	633	0	1	2	2
경기도	김포시	통진읍	통진읍제8투	3616	2283	1333	4	2279	1192	1083	0	1	1	2
경기도	김포시	고촌읍	소계	19056	15014	4042	34	14980	8319	6619	2	6	29	5
경기도	김포시	고촌읍	고촌읍제1투	3303	2480	823	5	2475	1426	1044	0	1	3	1
경기도	김포시	고촌읍	고촌읍제2투	2019	1540	479	1	1539	1088	447	1	0	2	1
경기도	김포시	고촌읍	고촌읍제3투	4478	3534	944	9	3525	1853	1663	0	3	6	0
경기도	김포시	고촌읍	고촌읍제4투	2917	2213	704	5	2208	1274	931	0	0	3	0
경기도	김포시	고촌읍	고촌읍제5투	3076	2511	565	5	2506	1225	1272	0	2	6	1
경기도	김포시	고촌읍	고촌읍제6투	3263	2736	527	9	2727	1453	1262	1	0	9	2
경기도	김포시	양촌읍	소계	19999	13970	6029	44	13926	8095	5791	4	7	11	18
경기도	김포시	양촌읍	양촌읍제1투	4860	3103	1757	10	3093	1949	1132	0	6	4	2
경기도	김포시	양촌읍	양촌읍제2투	2775	2011	764	6	2005	1134	866	1	0	0	4
경기도	김포시	양촌읍	양촌읍제3투	1649	1111	538	3	1108	724	382	0	0	0	2
경기도	김포시	양촌읍	양촌읍제4투	3275	2353	922	9	2344	1260	1080	1	0	2	1
경기도	김포시	양촌읍	양촌읍제5투	579	414	165	1	413	284	126	0	0	2	1
경기도	김포시	양촌읍	양촌읍제6투	392	299	93	2	297	212	84	1	0	0	0
경기도	김포시	양촌읍	양촌읍제7투	904	646	258	1	645	479	163	0	0	0	3
경기도	김포시	양촌읍	양촌읍제8투	3427	2500	927	8	2492	1282	1206	1	0	1	2
경기도	김포시	양촌읍	양촌읍제9투	2138	1533	605	4	1529	771	752	0	1	2	3
경기도	김포시	대곶면	소계	8629	5909	2720	25	5884	3990	1856	3	5	15	15
경기도	김포시	대곶면	대곶면제1투	3041	1986	1055	15	1971	1311	643	1	5	4	7
경기도	김포시	대곶면	대곶면제2투	1864	1347	517	3	1344	958	379	1	0	3	3
경기도	김포시	대곶면	대곶면제3투	1386	931	455	2	929	605	318	1	0	5	0
경기도	김포시	대곶면	대곶면제4투	1071	757	314	2	755	506	246	0	0	1	2
경기도	김포시	대곶면	대곶면제5투	1267	888	379	3	885	610	270	0	0	2	3
경기도	김포시	월곶면	소계	4981	3492	1489	16	3476	2347	1112	2	1	10	4
경기도	김포시	월곶면	월곶면제1투	1374	961	413	4	957	643	311	0	0	3	0
경기도	김포시	월곶면	월곶면제2투	636	462	174	6	456	313	142	0	0	0	1
경기도	김포시	월곶면	월곶면제3투	640	460	180	1	459	334	122	0	0	3	0
경기도	김포시	월곶면	월곶면제4투	2331	1609	722	5	1604	1057	537	2	1	4	3
경기도	김포시	하성면	소계	7562	5352	2210	12	5340	3696	1623	1	3	10	7
경기도	김포시	하성면	하성면제1투	2890	1943	947	5	1938	1272	662	0	0	3	1
경기도	김포시	하성면	하성면제2투	1263	940	323	1	939	659	274	0	2	2	2
경기도	김포시	하성면	하성면제3투	1208	847	361	3	844	583	256	0	1	3	1
경기도	김포시	하성면	하성면제4투	1477	1107	370	1	1106	808	297	1	0	0	0
경기도	김포시	하성면	하성면제5투	724	515	209	2	513	374	134	0	0	2	3
경기도	김포시	김포1동	소계	37550	29151	8399	62	29089	15526	13473	7	8	56	19
경기도	김포시	김포1동	김포1동제1투	3275	2366	909	5	2361	1239	1119	0	0	3	0
경기도	김포시	김포1동	김포1동제2투	2258	1585	673	5	1580	898	677	1	0	2	2
경기도	김포시	김포1동	김포1동제3투	1403	994	409	0	994	615	376	0	0	2	1
경기도	김포시	김포1동	김포1동제4투	2515	1802	713	3	1799	1024	773	0	1	0	1
경기도	김포시	김포1동	김포1동제5투	3556	2869	687	3	2866	1604	1250	0	0	9	3
경기도	김포시	김포1동	김포1동제6투	3216	2512	704	4	2508	1371	1126	3	0	5	3
경기도	김포시	김포1동	김포1동제7투	2635	2070	565	10	2060	1168	882	0	1	4	5
경기도	김포시	김포1동	김포1동제8투	1639	1270	369	2	1268	636	629	0	1	2	0
경기도	김포시	김포1동	김포1동제9투	5067	3978	1089	13	3965	1912	2040	0	1	11	1
경기도	김포시	김포1동	김포1동제10투	4302	3499	803	3	3496	1727	1762	1	0	5	1
경기도	김포시	김포1동	김포1동제11투	3834	3145	689	7	3138	1599	1532	0	3	3	1
경기도	김포시	김포1동	김포1동제12투	3850	3061	789	7	3054	1733	1307	2	1	10	1
경기도	김포시	김포2동	소계	28291	21978	6313	50	21928	10443	11432	1	5	36	11
경기도	김포시	김포2동	김포2동제1투	2220	1585	635	7	1578	918	654	0	0	2	4
경기도	김포시	김포2동	김포2동제2투	4941	3859	1082	9	3850	2282	1558	1	0	7	2
경기도	김포시	김포2동	김포2동제3투	3910	3139	771	10	3129	1587	1536	0	1	5	0
경기도	김포시	김포2동	김포2동제4투	4834	3810	1024	6	3804	1443	2355	0	0	5	1
경기도	김포시	김포2동	김포2동제5투	2714	2172	542	2	2170	871	1294	0	1	4	0
경기도	김포시	김포2동	김포2동제6투	4789	3823	966	6	3817	1563	2244	0	1	7	2
경기도	김포시	김포2동	김포2동제7투	1268	964	304	2	962	499	456	0	1	4	2
경기도	김포시	김포2동	김포2동제8투	3615	2626	989	8	2618	1280	1335	0	1	2	0
경기도	김포시	사우동	소계	16512	12217	4295	27	12190	6408	5752	4	3	15	8
경기도	김포시	사우동	사우동제1투	3297	2118	1179	2	2116	1226	886	0	1	2	1
경기도	김포시	사우동	사우동제2투	3358	2398	960	4	2394	1267	1123	0	0	4	0
경기도	김포시	사우동	사우동제3투	3799	3104	695	7	3097	1534	1553	1	0	6	3
경기도	김포시	사우동	사우동제4투	2170	1593	577	9	1584	826	756	0	0	0	2
경기도	김포시	사우동	사우동제5투	3888	3004	884	5	2999	1555	1434	3	2	3	2
경기도	김포시	풍무동	소계	27696	21676	6020	56	21620	11037	10522	2	3	44	12
경기도	김포시	풍무동	풍무동제1투	4235	3226	1009	9	3217	1562	1646	0	1	7	1
경기도	김포시	풍무동	풍무동제2투	1892	1434	458	2	1432	827	595	1	1	7	1
경기도	김포시	풍무동	풍무동제3투	3891	3016	875	10	3006	1614	1384	1	0	5	2
경기도	김포시	풍무동	풍무동제4투	3558	2717	841	9	2708	1364	1337	0	0	7	0
경기도	김포시	풍무동	풍무동제5투	3227	2637	590	5	2632	1316	1312	0	0	2	2
경기도	김포시	풍무동	풍무동제6투	3241	2533	708	5	2528	1280	1241	0	0	6	1
경기도	김포시	풍무동	풍무동제7투	4292	3429	863	9	3420	1604	1805	0	1	6	4
경기도	김포시	풍무동	풍무동제8투	3360	2684	676	7	2677	1470	1202	0	0	4	1
경기도	김포시	장기동	소계	20641	15856	4785	38	15818	7513	8251	3	7	32	12
경기도	김포시	장기동	장기동제1투	3963	3096	867	5	3091	1357	1722	0	1	9	2
경기도	김포시	장기동	장기동제2투	3758	3115	643	12	3103	1574	1519	0	3	6	1
경기도	김포시	장기동	장기동제3투	3232	2256	976	4	2252	1117	1127	1	2	3	2
경기도	김포시	장기동	장기동제4투	4627	3487	1140	8	3479	1504	1964	1	1	7	2
경기도	김포시	장기동	장기동제5투	2591	2014	577	6	2008	982	1020	1	0	2	3
경기도	김포시	장기동	장기동제6투	2470	1888	582	3	1885	979	899	0	0	5	2
경기도	광주시	계	계	214855	157795	57060	619	157176	84388	72299	45	67	214	163
경기도	광주시	재외투표	재외투표	1071	742	329	4	738	309	423	0	1	4	1
경기도	광주시	국내부재자투표	국내부재자투표	4432	4151	281	101	4050	2042	1959	11	8	6	24
경기도	광주시	오포읍	소계	51219	37800	13419	102	37698	19437	18171	3	19	42	26
경기도	광주시	오포읍	오포읍제1투	2085	1363	722	11	1352	762	587	0	0	3	0
경기도	광주시	오포읍	오포읍제2투	4154	3056	1098	11	3045	1632	1405	0	2	3	3
경기도	광주시	오포읍	오포읍제3투	3014	2195	819	9	2186	1042	1141	0	0	2	1
경기도	광주시	오포읍	오포읍제4투	1900	1396	504	4	1392	741	644	0	1	2	4
경기도	광주시	오포읍	오포읍제5투	2854	1999	855	8	1991	1115	872	0	1	1	2
경기도	광주시	오포읍	오포읍제6투	3652	2753	899	3	2750	1428	1310	0	3	5	4
경기도	광주시	오포읍	오포읍제7투	4195	3074	1121	4	3070	1546	1519	0	3	1	1
경기도	광주시	오포읍	오포읍제8투	3073	2312	761	6	2306	1155	1144	1	1	4	1
경기도	광주시	오포읍	오포읍제9투	4828	3639	1189	3	3636	1939	1690	0	2	4	1
경기도	광주시	오포읍	오포읍제10투	4626	3253	1373	14	3239	1781	1451	0	0	4	3
경기도	광주시	오포읍	오포읍제11투	4336	3250	1086	9	3241	1587	1647	1	1	3	2
경기도	광주시	오포읍	오포읍제12투	3122	2471	651	9	2462	1220	1237	0	1	3	1
경기도	광주시	오포읍	오포읍제13투	2944	2330	614	4	2326	1039	1282	1	1	3	0
경기도	광주시	오포읍	오포읍제14투	3209	2351	858	2	2349	1267	1077	0	2	2	1
경기도	광주시	오포읍	오포읍제15투	3227	2358	869	5	2353	1183	1165	0	1	2	2
경기도	광주시	초월읍	소계	27743	20215	7528	70	20145	10868	9221	3	8	34	11
경기도	광주시	초월읍	초월읍제1투	4140	2982	1158	7	2975	1715	1258	0	0	2	0
경기도	광주시	초월읍	초월읍제2투	2839	2161	678	5	2156	1049	1101	0	0	4	2
경기도	광주시	초월읍	초월읍제3투	2781	2127	654	6	2121	1050	1067	0	0	3	1
경기도	광주시	초월읍	초월읍제4투	4498	3388	1110	7	3381	1821	1554	1	1	3	1
경기도	광주시	초월읍	초월읍제5투	3063	2134	929	9	2125	1327	786	0	1	7	4
경기도	광주시	초월읍	초월읍제6투	3714	2584	1130	12	2572	1385	1179	0	4	2	2
경기도	광주시	초월읍	초월읍제7투	2492	1604	888	14	1590	995	587	1	1	5	1
경기도	광주시	초월읍	초월읍제8투	4216	3235	981	10	3225	1526	1689	1	1	8	0
경기도	광주시	곤지암읍	소계	18104	12676	5428	68	12608	7423	5140	6	9	15	15
경기도	광주시	곤지암읍	곤지암읍제1투	4433	3112	1321	11	3101	1645	1450	0	1	4	1
경기도	광주시	곤지암읍	곤지암읍제2투	3595	2483	1112	12	2471	1537	928	1	1	2	2
경기도	광주시	곤지암읍	곤지암읍제3투	2696	1913	783	19	1894	1246	636	1	3	5	3
경기도	광주시	곤지암읍	곤지암읍제4투	2791	1889	902	17	1872	1283	577	3	0	3	6
경기도	광주시	곤지암읍	곤지암읍제5투	4589	3279	1310	9	3270	1712	1549	1	4	1	3
경기도	광주시	도척면	소계	7353	5304	2049	29	5275	3275	1986	0	3	5	6
경기도	광주시	도척면	도척면제1투	3397	2421	976	15	2406	1467	935	0	0	1	3
경기도	광주시	도척면	도척면제2투	2391	1757	634	10	1747	1073	667	0	2	4	1
경기도	광주시	도척면	도척면제3투	1565	1126	439	4	1122	735	384	0	1	0	2
경기도	광주시	퇴촌면	소계	9532	6846	2686	30	6816	4265	2530	1	0	12	8
경기도	광주시	퇴촌면	퇴촌면제1투	3316	2389	927	10	2379	1513	855	0	0	5	6
경기도	광주시	퇴촌면	퇴촌면제2투	3080	2224	856	11	2213	1370	840	0	0	1	2
경기도	광주시	퇴촌면	퇴촌면제3투	3136	2233	903	9	2224	1382	835	1	0	6	0
경기도	광주시	남종면	소계	1463	1104	359	1	1103	817	281	0	1	2	2
경기도	광주시	남종면	남종면제1투	775	591	184	1	590	430	158	0	1	1	0
경기도	광주시	남종면	남종면제2투	420	317	103	0	317	245	70	0	0	0	2
경기도	광주시	남종면	남종면제3투	268	196	72	0	196	142	53	0	0	1	0
경기도	광주시	중부면	소계	2352	1813	539	15	1798	1124	659	1	0	7	7
경기도	광주시	중부면	중부면제1투	847	598	249	3	595	391	200	0	0	3	1
경기도	광주시	중부면	중부면제2투	759	617	142	3	614	335	274	0	0	2	3
경기도	광주시	중부면	중부면제3투	746	598	148	9	589	398	185	1	0	2	3
경기도	광주시	경안동	소계	26834	18987	7847	71	18916	10126	8730	11	8	21	20
경기도	광주시	경안동	경안동제1투	2229	1538	691	6	1532	892	637	0	0	1	2
경기도	광주시	경안동	경안동제2투	3200	2180	1020	10	2170	1246	914	4	3	1	2
경기도	광주시	경안동	경안동제3투	2102	1266	836	3	1263	740	517	0	1	2	3
경기도	광주시	경안동	경안동제4투	4601	3258	1343	11	3247	1702	1534	3	0	5	3
경기도	광주시	경안동	경안동제5투	2972	2050	922	11	2039	1140	896	2	1	0	0
경기도	광주시	경안동	경안동제6투	4199	2941	1258	13	2928	1527	1392	0	1	4	4
경기도	광주시	경안동	경안동제7투	4574	3635	939	12	3623	1798	1819	1	2	2	1
경기도	광주시	경안동	경안동제8투	2957	2119	838	5	2114	1081	1021	1	0	6	5
경기도	광주시	송정동	소계	35753	26661	9092	80	26581	14058	12447	4	8	35	29
경기도	광주시	송정동	송정동제1투	2339	1607	732	5	1602	747	852	0	1	2	0
경기도	광주시	송정동	송정동제2투	3960	3165	795	10	3155	1718	1427	0	4	3	3
경기도	광주시	송정동	송정동제3투	4182	3196	986	8	3188	1796	1380	1	0	3	8
경기도	광주시	송정동	송정동제4투	3962	2924	1038	20	2904	1716	1182	0	1	4	1
경기도	광주시	송정동	송정동제5투	3164	2272	892	4	2268	1229	1029	1	1	4	4
경기도	광주시	송정동	송정동제6투	4140	2919	1221	11	2908	1589	1314	0	0	4	1
경기도	광주시	송정동	송정동제7투	4307	3233	1074	9	3224	1575	1639	0	1	4	5
경기도	광주시	송정동	송정동제8투	5075	3520	1555	4	3516	1845	1660	2	0	6	3
경기도	광주시	송정동	송정동제9투	2615	2116	499	6	2110	1024	1084	0	0	2	0
경기도	광주시	송정동	송정동제10투	2009	1709	300	3	1706	819	880	0	0	3	4
경기도	광주시	광남동	소계	28999	21478	7521	48	21430	10637	10741	5	2	31	14
경기도	광주시	광남동	광남동제1투	4205	2991	1214	7	2984	1504	1475	0	0	4	1
경기도	광주시	광남동	광남동제2투	4981	4034	947	4	4030	1976	2046	2	0	5	1
경기도	광주시	광남동	광남동제3투	3862	2746	1116	8	2738	1448	1286	0	0	3	1
경기도	광주시	광남동	광남동제4투	6086	4141	1945	10	4131	2043	2079	1	1	2	5
경기도	광주시	광남동	광남동제5투	5302	3800	1502	10	3790	1953	1825	1	0	7	4
경기도	광주시	광남동	광남동제6투	3227	2638	589	5	2633	1161	1459	1	1	9	2
경기도	광주시	광남동	광남동제7투	1336	1128	208	4	1124	552	571	0	0	1	0
경기도	광주시	잘못 투입·구분된 투표지	잘못 투입·구분된 투표지	0	18	-18	0	18	7	11	0	0	0	0
경기도	포천시	계	계	126354	89172	37182	386	88786	56633	31751	40	40	141	181
경기도	포천시	재외투표	재외투표	357	264	93	1	263	136	125	1	0	1	0
경기도	포천시	국내부재자투표	국내부재자투표	3393	3164	229	55	3109	1605	1459	5	8	13	19
경기도	포천시	소흘읍	소계	35428	24787	10641	57	24730	14276	10392	6	6	31	19
경기도	포천시	소흘읍	소흘읍제1투	4834	3027	1807	10	3017	1789	1218	0	1	4	5
경기도	포천시	소흘읍	소흘읍제2투	2151	1508	643	2	1506	982	518	0	1	4	1
경기도	포천시	소흘읍	소흘읍제3투	2210	1706	504	5	1701	1109	585	0	1	3	3
경기도	포천시	소흘읍	소흘읍제4투	2478	1656	822	2	1654	1066	584	0	0	1	3
경기도	포천시	소흘읍	소흘읍제5투	4511	3447	1064	7	3440	1870	1565	2	0	3	0
경기도	포천시	소흘읍	소흘읍제6투	4097	2739	1358	4	2735	1554	1175	1	1	2	2
경기도	포천시	소흘읍	소흘읍제7투	3312	2208	1104	9	2199	1183	1011	1	0	4	0
경기도	포천시	소흘읍	소흘읍제8투	3085	2208	877	3	2205	1373	828	1	1	1	1
경기도	포천시	소흘읍	소흘읍제9투	4101	2958	1143	7	2951	1489	1456	0	0	6	0
경기도	포천시	소흘읍	소흘읍제10투	3204	2335	869	3	2332	1282	1043	0	1	2	4
경기도	포천시	소흘읍	소흘읍제11투	1445	995	450	5	990	579	409	1	0	1	0
경기도	포천시	군내면	소계	5655	3954	1701	27	3927	2734	1171	2	2	7	11
경기도	포천시	군내면	군내면제1투	2318	1554	764	8	1546	1107	431	0	1	4	3
경기도	포천시	군내면	군내면제2투	1203	867	336	4	863	560	299	0	0	1	3
경기도	포천시	군내면	군내면제3투	2134	1533	601	15	1518	1067	441	2	1	2	5
경기도	포천시	내촌면	소계	4453	3151	1302	19	3132	2204	919	1	0	4	4
경기도	포천시	내촌면	내촌면제1투	2460	1729	731	5	1724	1169	551	0	0	3	1
경기도	포천시	내촌면	내촌면제2투	825	603	222	5	598	444	153	0	0	1	0
경기도	포천시	내촌면	내촌면제3투	1168	819	349	9	810	591	215	1	0	0	3
경기도	포천시	가산면	소계	7281	4947	2334	26	4921	3314	1582	0	5	6	14
경기도	포천시	가산면	가산면제1투	3062	2064	998	9	2055	1389	660	0	2	2	2
경기도	포천시	가산면	가산면제2투	2285	1552	733	11	1541	1032	498	0	2	3	6
경기도	포천시	가산면	가산면제3투	1934	1331	603	6	1325	893	424	0	1	1	6
경기도	포천시	신북면	소계	10748	7317	3431	26	7291	4917	2333	5	3	12	21
경기도	포천시	신북면	신북면제1투	1806	1287	519	3	1284	876	404	0	0	2	2
경기도	포천시	신북면	신북면제2투	3997	2555	1442	9	2546	1666	870	1	1	3	5
경기도	포천시	신북면	신북면제3투	1684	1228	456	6	1222	878	337	0	0	2	5
경기도	포천시	신북면	신북면제4투	954	680	274	2	678	483	188	2	0	1	4
경기도	포천시	신북면	신북면제5투	2307	1567	740	6	1561	1014	534	2	2	4	5
경기도	포천시	창수면	소계	2189	1615	574	8	1607	1138	465	0	1	2	1
경기도	포천시	창수면	창수면제1투	1207	911	296	7	904	672	230	0	1	0	1
경기도	포천시	창수면	창수면제2투	982	704	278	1	703	466	235	0	0	2	0
경기도	포천시	영중면	소계	4802	3372	1430	19	3353	2312	1024	2	1	6	8
경기도	포천시	영중면	영중면제1투	1028	749	279	5	744	540	200	1	1	0	2
경기도	포천시	영중면	영중면제2투	1942	1299	643	7	1292	883	403	0	0	3	3
경기도	포천시	영중면	영중면제3투	726	553	173	1	552	357	192	0	0	1	2
경기도	포천시	영중면	영중면제4투	1106	771	335	6	765	532	229	1	0	2	1
경기도	포천시	일동면	소계	8636	6090	2546	26	6064	4179	1854	3	2	11	15
경기도	포천시	일동면	일동면제1투	2514	1683	831	5	1678	1112	558	0	0	6	2
경기도	포천시	일동면	일동면제2투	446	343	103	1	342	272	68	0	0	1	1
경기도	포천시	일동면	일동면제3투	1312	959	353	9	950	679	265	0	0	1	5
경기도	포천시	일동면	일동면제4투	2764	1947	817	5	1942	1308	626	2	1	1	4
경기도	포천시	일동면	일동면제5투	693	524	169	2	522	344	176	1	0	0	1
경기도	포천시	일동면	일동면제6투	907	634	273	4	630	464	161	0	1	2	2
경기도	포천시	이동면	소계	5066	3690	1376	20	3670	2546	1106	1	1	5	11
경기도	포천시	이동면	이동면제1투	1572	1122	450	7	1115	812	300	0	0	2	1
경기도	포천시	이동면	이동면제2투	842	598	244	3	595	403	186	0	1	2	3
경기도	포천시	이동면	이동면제3투	963	704	259	5	699	468	226	1	0	1	3
경기도	포천시	이동면	이동면제4투	1689	1266	423	5	1261	863	394	0	0	0	4
경기도	포천시	영북면	소계	7520	5264	2256	18	5246	3673	1540	3	2	7	21
경기도	포천시	영북면	영북면제1투	2407	1553	854	4	1549	1081	460	2	1	1	4
경기도	포천시	영북면	영북면제2투	827	615	212	2	613	444	162	0	0	1	6
경기도	포천시	영북면	영북면제3투	1415	1050	365	2	1048	736	309	0	0	1	2
경기도	포천시	영북면	영북면제4투	294	217	77	2	215	156	58	0	0	0	1
경기도	포천시	영북면	영북면제5투	1387	953	434	4	949	657	283	0	1	4	4
경기도	포천시	영북면	영북면제6투	633	470	163	2	468	319	148	1	0	0	0
경기도	포천시	영북면	영북면제7투	557	406	151	2	404	280	120	0	0	0	4
경기도	포천시	관인면	소계	2878	2094	784	8	2086	1426	650	1	0	3	6
경기도	포천시	관인면	관인면제1투	1704	1243	461	4	1239	838	398	0	0	1	2
경기도	포천시	관인면	관인면제2투	632	450	182	3	447	306	138	0	0	2	1
경기도	포천시	관인면	관인면제3투	542	401	141	1	400	282	114	1	0	0	3
경기도	포천시	화현면	소계	2418	1810	608	9	1801	1241	547	2	2	3	6
경기도	포천시	화현면	화현면제1투	1783	1328	455	8	1320	909	403	1	2	2	3
경기도	포천시	화현면	화현면제2투	635	482	153	1	481	332	144	1	0	1	3
경기도	포천시	포천동	소계	14672	10488	4184	36	10452	6573	3843	4	4	13	15
경기도	포천시	포천동	포천동제1투	3534	2573	961	9	2564	1584	971	1	2	1	5
경기도	포천시	포천동	포천동제2투	2071	1304	767	3	1301	885	415	0	0	0	1
경기도	포천시	포천동	포천동제3투	2959	2117	842	10	2107	1341	759	1	0	2	4
경기도	포천시	포천동	포천동제4투	4807	3600	1207	9	3591	2187	1388	2	2	8	4
경기도	포천시	포천동	포천동제5투	1301	894	407	5	889	576	310	0	0	2	1
경기도	포천시	선단동	소계	10858	7165	3693	31	7134	4359	2741	4	3	17	10
경기도	포천시	선단동	선단동제1투	3461	2307	1154	6	2301	1307	982	2	1	7	2
경기도	포천시	선단동	선단동제2투	1528	1034	494	6	1028	691	332	0	1	2	2
경기도	포천시	선단동	선단동제3투	1556	1035	521	7	1028	645	377	1	1	2	2
경기도	포천시	선단동	선단동제4투	4313	2789	1524	12	2777	1716	1050	1	0	6	4
경기도	연천군	계	계	37796	27716	10080	179	27537	17989	9359	23	20	73	73
경기도	연천군	재외투표	재외투표	109	67	42	0	67	30	36	1	0	0	0
경기도	연천군	국내부재자투표	국내부재자투표	1485	1369	116	31	1338	772	549	2	3	6	6
경기도	연천군	연천읍	소계	5410	4038	1372	26	4012	2516	1467	3	3	10	13
경기도	연천군	연천읍	연천읍제1투	1711	1237	474	10	1227	723	497	1	1	1	4
경기도	연천군	연천읍	연천읍제2투	1364	1027	337	7	1020	662	346	0	2	4	6
경기도	연천군	연천읍	연천읍제3투	743	534	209	3	531	340	186	1	0	2	2
경기도	연천군	연천읍	연천읍제4투	220	172	48	0	172	92	79	0	0	1	0
경기도	연천군	연천읍	연천읍제5투	1372	1068	304	6	1062	699	359	1	0	2	1
경기도	연천군	전곡읍	소계	15449	10916	4533	44	10872	6918	3901	5	9	24	15
경기도	연천군	전곡읍	전곡읍제1투	2669	1739	930	10	1729	1174	546	1	1	4	3
경기도	연천군	전곡읍	전곡읍제2투	1191	829	362	4	825	538	285	1	0	0	1
경기도	연천군	전곡읍	전곡읍제3투	3922	2813	1109	5	2808	1698	1100	0	5	3	2
경기도	연천군	전곡읍	전곡읍제4투	1587	1163	424	4	1159	821	334	1	1	0	2
경기도	연천군	전곡읍	전곡읍제5투	2607	1906	701	11	1895	1200	685	0	2	6	2
경기도	연천군	전곡읍	전곡읍제6투	362	259	103	1	258	173	83	0	0	1	1
경기도	연천군	전곡읍	전곡읍제7투	244	172	72	1	171	113	56	0	0	1	1
경기도	연천군	전곡읍	전곡읍제8투	480	342	138	1	341	185	156	0	0	0	0
경기도	연천군	전곡읍	전곡읍제9투	2387	1693	694	7	1686	1016	656	2	0	9	3
경기도	연천군	군남면	소계	3011	2238	773	15	2223	1526	682	2	0	6	7
경기도	연천군	군남면	군남면제1투	832	620	212	4	616	455	158	0	0	1	2
경기도	연천군	군남면	군남면제2투	531	409	122	3	406	261	143	0	0	0	2
경기도	연천군	군남면	군남면제3투	487	353	134	4	349	249	98	1	0	0	1
경기도	연천군	군남면	군남면제4투	950	698	252	4	694	454	235	1	0	3	1
경기도	연천군	군남면	군남면제5투	211	158	53	0	158	107	48	0	0	2	1
경기도	연천군	청산면	소계	3831	2721	1110	22	2699	1925	752	4	4	7	7
경기도	연천군	청산면	청산면제1투	2092	1444	648	16	1428	1015	400	4	2	4	3
경기도	연천군	청산면	청산면제2투	1044	762	282	4	758	539	212	0	2	2	3
경기도	연천군	청산면	청산면제3투	695	515	180	2	513	371	140	0	0	1	1
경기도	연천군	백학면	소계	2414	1746	668	17	1729	1198	515	3	1	5	7
경기도	연천군	백학면	백학면제1투	1509	1095	414	8	1087	752	326	0	1	4	4
경기도	연천군	백학면	백학면제2투	905	651	254	9	642	446	189	3	0	1	3
경기도	연천군	미산면	소계	1511	1117	394	5	1112	769	336	0	0	4	3
경기도	연천군	미산면	미산면제1투	805	608	197	1	607	428	173	0	0	3	3
경기도	연천군	미산면	미산면제2투	706	509	197	4	505	341	163	0	0	1	0
경기도	연천군	왕징면	소계	1012	795	217	5	790	506	277	1	0	1	5
경기도	연천군	왕징면	왕징면제1투	476	377	99	2	375	237	134	0	0	1	3
경기도	연천군	왕징면	왕징면제2투	206	163	43	1	162	98	63	0	0	0	1
경기도	연천군	왕징면	왕징면제3투	330	255	75	2	253	171	80	1	0	0	1
경기도	연천군	신서면	소계	2768	2065	703	13	2052	1379	655	2	0	10	6
경기도	연천군	신서면	신서면제1투	1787	1317	470	10	1307	874	419	2	0	7	5
경기도	연천군	신서면	신서면제2투	163	117	46	0	117	79	35	0	0	3	0
경기도	연천군	신서면	신서면제3투	285	224	61	1	223	145	78	0	0	0	0
경기도	연천군	신서면	신서면제4투	533	407	126	2	405	281	123	0	0	0	1
경기도	연천군	중면	소계	217	171	46	0	171	105	64	0	0	0	2
경기도	연천군	중면	중면투표소	217	171	46	0	171	105	64	0	0	0	2
경기도	연천군	장남면	소계	579	473	106	1	472	345	125	0	0	0	2
경기도	연천군	장남면	장남면투표소	579	473	106	1	472	345	125	0	0	0	2
경기도	양평군	계	계	84769	62448	22321	324	62124	40862	20857	39	51	125	190
경기도	양평군	재외투표	재외투표	466	338	128	1	337	115	220	0	2	0	0
경기도	양평군	국내부재자투표	국내부재자투표	2641	2462	179	78	2384	1284	1051	15	13	8	13
경기도	양평군	양평읍	소계	21560	15743	5817	54	15689	10009	5614	6	9	29	22
경기도	양평군	양평읍	양평읍제1투	3262	2278	984	6	2272	1549	719	0	0	3	1
경기도	양평군	양평읍	양평읍제2투	3155	2300	855	4	2296	1448	835	0	0	11	2
경기도	양평군	양평읍	양평읍제3투	1425	1025	400	3	1022	741	277	1	0	1	2
경기도	양평군	양평읍	양평읍제4투	1256	905	351	9	896	626	262	1	0	1	6
경기도	양평군	양평읍	양평읍제5투	3353	2387	966	12	2375	1504	861	1	2	4	3
경기도	양평군	양평읍	양평읍제6투	2055	1547	508	4	1543	1074	465	0	1	1	2
경기도	양평군	양평읍	양평읍제7투	4231	3244	987	10	3234	1871	1351	3	2	4	3
경기도	양평군	양평읍	양평읍제8투	2823	2057	766	6	2051	1196	844	0	4	4	3
경기도	양평군	강상면	소계	5755	4235	1520	12	4223	2745	1454	2	1	6	15
경기도	양평군	강상면	강상면제1투	2777	2075	702	5	2070	1325	737	1	1	1	5
경기도	양평군	강상면	강상면제2투	1830	1298	532	6	1292	840	443	0	0	4	5
경기도	양평군	강상면	강상면제3투	1148	862	286	1	861	580	274	1	0	1	5
경기도	양평군	강하면	소계	3649	2685	964	8	2677	1874	789	2	2	2	8
경기도	양평군	강하면	강하면제1투	2033	1461	572	5	1456	1006	446	1	1	0	2
경기도	양평군	강하면	강하면제2투	1616	1224	392	3	1221	868	343	1	1	2	6
경기도	양평군	양서면	소계	8756	6367	2389	20	6347	4029	2288	2	9	10	9
경기도	양평군	양서면	양서면제1투	2493	1838	655	5	1833	1138	687	1	2	3	2
경기도	양평군	양서면	양서면제2투	1234	949	285	2	947	610	328	1	3	2	3
경기도	양평군	양서면	양서면제3투	3898	2758	1140	8	2750	1726	1014	0	4	2	4
경기도	양평군	양서면	양서면제4투	1131	822	309	5	817	555	259	0	0	3	0
경기도	양평군	옥천면	소계	5570	4086	1484	11	4075	2680	1364	1	3	13	14
경기도	양평군	옥천면	옥천면제1투	2010	1490	520	3	1487	907	566	0	1	4	9
경기도	양평군	옥천면	옥천면제2투	1403	1027	376	4	1023	715	306	0	1	1	0
경기도	양평군	옥천면	옥천면제3투	1202	882	320	2	880	599	275	1	1	4	0
경기도	양평군	옥천면	옥천면제4투	955	687	268	2	685	459	217	0	0	4	5
경기도	양평군	서종면	소계	6367	4533	1834	12	4521	2955	1543	2	1	14	6
경기도	양평군	서종면	서종면제1투	2806	1981	825	4	1977	1227	743	0	0	6	1
경기도	양평군	서종면	서종면제2투	728	549	179	1	548	351	195	0	0	2	0
경기도	양평군	서종면	서종면제3투	1048	759	289	2	757	516	235	0	0	4	2
경기도	양평군	서종면	서종면제4투	529	353	176	2	351	248	102	0	0	0	1
경기도	양평군	서종면	서종면제5투	1256	891	365	3	888	613	268	2	1	2	2
경기도	양평군	단월면	소계	2896	2141	755	15	2126	1526	580	1	2	6	11
경기도	양평군	단월면	단월면제1투	1144	866	278	4	862	623	233	0	0	4	2
경기도	양평군	단월면	단월면제2투	1034	755	279	4	751	547	194	0	0	1	9
경기도	양평군	단월면	단월면제3투	448	328	120	2	326	245	81	0	0	0	0
경기도	양평군	단월면	단월면제4투	270	192	78	5	187	111	72	1	2	1	0
경기도	양평군	청운면	소계	3213	2370	843	17	2353	1663	671	0	2	3	14
경기도	양평군	청운면	청운면제1투	1347	989	358	4	985	701	274	0	2	1	7
경기도	양평군	청운면	청운면제2투	574	424	150	4	420	293	122	0	0	1	4
경기도	양평군	청운면	청운면제3투	594	441	153	6	435	307	124	0	0	1	3
경기도	양평군	청운면	청운면제4투	698	516	182	3	513	362	151	0	0	0	0
경기도	양평군	양동면	소계	3941	2881	1060	28	2853	2047	778	3	1	6	18
경기도	양평군	양동면	양동면제1투	1845	1392	453	15	1377	957	405	2	1	2	10
경기도	양평군	양동면	양동면제2투	784	551	233	6	545	396	144	1	0	2	2
경기도	양평군	양동면	양동면제3투	780	576	204	3	573	436	133	0	0	1	3
경기도	양평군	양동면	양동면제4투	532	362	170	4	358	258	96	0	0	1	3
경기도	양평군	지평면	소계	5413	3911	1502	23	3888	2743	1111	2	1	8	23
경기도	양평군	지평면	지평면제1투	1145	836	309	7	829	600	224	0	0	0	5
경기도	양평군	지평면	지평면제2투	915	654	261	4	650	447	199	0	0	1	3
경기도	양평군	지평면	지평면제3투	721	546	175	0	546	398	142	1	0	0	5
경기도	양평군	지평면	지평면제4투	994	701	293	3	698	487	203	0	1	4	3
경기도	양평군	지평면	지평면제5투	822	591	231	5	586	406	175	0	0	2	3
경기도	양평군	지평면	지평면제6투	816	583	233	4	579	405	168	1	0	1	4
경기도	양평군	용문면	소계	10775	7888	2887	34	7854	5193	2608	2	5	17	29
경기도	양평군	용문면	용문면제1투	2964	2136	828	7	2129	1375	744	1	0	3	6
경기도	양평군	용문면	용문면제2투	1978	1437	541	8	1429	998	420	1	1	3	6
경기도	양평군	용문면	용문면제3투	1566	1076	490	5	1071	685	380	0	1	3	2
경기도	양평군	용문면	용문면제4투	1290	958	332	5	953	622	326	0	0	2	3
경기도	양평군	용문면	용문면제5투	1591	1227	364	7	1220	776	431	0	2	4	7
경기도	양평군	용문면	용문면제6투	724	550	174	1	549	394	151	0	1	1	2
경기도	양평군	용문면	용문면제7투	662	504	158	1	503	343	156	0	0	1	3
경기도	양평군	개군면	소계	3767	2808	959	11	2797	1999	786	1	0	3	8
경기도	양평군	개군면	개군면제1투	1599	1193	406	3	1190	864	323	0	0	1	2
경기도	양평군	개군면	개군면제2투	1223	902	321	5	897	613	277	1	0	2	4
경기도	양평군	개군면	개군면제3투	945	713	232	3	710	522	186	0	0	0	2
경기도	가평군	계	계	50634	37316	13318	298	37018	24987	11696	56	38	98	143
경기도	가평군	재외투표	재외투표	188	135	53	1	134	60	73	0	0	0	1
경기도	가평군	국내부재자투표	국내부재자투표	2709	2523	186	140	2383	1438	819	45	16	35	30
경기도	가평군	가평읍	소계	15319	11287	4032	44	11243	7450	3744	2	7	16	24
경기도	가평군	가평읍	가평읍제1투	3417	2461	956	8	2453	1517	928	1	1	5	1
경기도	가평군	가평읍	가평읍제2투	2679	1984	695	7	1977	1309	664	0	1	3	0
경기도	가평군	가평읍	가평읍제3투	3443	2600	843	7	2593	1677	905	1	1	2	7
경기도	가평군	가평읍	가평읍제4투	1836	1344	492	4	1340	882	450	0	3	2	3
경기도	가평군	가평읍	가평읍제5투	1111	787	324	2	785	548	234	0	0	2	1
경기도	가평군	가평읍	가평읍제6투	1107	843	264	8	835	603	224	0	0	2	6
경기도	가평군	가평읍	가평읍제7투	971	724	247	4	720	534	182	0	1	0	3
경기도	가평군	가평읍	가평읍제8투	755	544	211	4	540	380	157	0	0	0	3
경기도	가평군	설악면	소계	6332	4624	1708	29	4595	3240	1316	3	5	9	22
경기도	가평군	설악면	설악면제1투	2374	1690	684	11	1679	1167	500	1	2	0	9
경기도	가평군	설악면	설악면제2투	950	706	244	6	700	509	185	0	1	1	4
경기도	가평군	설악면	설악면제3투	1165	849	316	6	843	603	235	0	1	3	1
경기도	가평군	설악면	설악면제4투	507	387	120	0	387	269	111	0	1	2	4
경기도	가평군	설악면	설악면제5투	1336	992	344	6	986	692	285	2	0	3	4
경기도	가평군	청평면	소계	11478	8257	3221	23	8234	5486	2708	2	2	18	18
경기도	가평군	청평면	청평면제1투	4074	2912	1162	10	2902	1887	1003	1	1	4	6
경기도	가평군	청평면	청평면제2투	1700	1236	464	2	1234	943	284	1	0	2	4
경기도	가평군	청평면	청평면제3투	381	265	116	1	264	187	76	0	0	0	1
경기도	가평군	청평면	청평면제4투	3546	2553	993	6	2547	1550	982	0	1	10	4
경기도	가평군	청평면	청평면제5투	581	435	146	2	433	297	134	0	0	1	1
경기도	가평군	청평면	청평면제6투	644	464	180	2	462	323	136	0	0	1	2
경기도	가평군	청평면	청평면제7투	552	392	160	0	392	299	93	0	0	0	0
경기도	가평군	상면	소계	4546	3277	1269	18	3259	2333	899	0	4	6	17
경기도	가평군	상면	상면제1투	1181	888	293	6	882	632	244	0	1	2	3
경기도	가평군	상면	상면제2투	1137	836	301	2	834	611	214	0	1	1	7
경기도	가평군	상면	상면제3투	546	410	136	4	406	289	113	0	1	0	3
경기도	가평군	상면	상면제4투	1026	756	270	4	752	546	199	0	1	3	3
경기도	가평군	상면	상면제5투	656	387	269	2	385	255	129	0	0	0	1
경기도	가평군	하면	소계	6756	4799	1957	34	4765	3296	1442	4	3	8	12
경기도	가평군	하면	하면제1투	2032	1521	511	6	1515	1005	502	2	1	3	2
경기도	가평군	하면	하면제2투	1177	886	291	6	880	619	256	0	1	3	1
경기도	가평군	하면	하면제3투	1236	852	384	4	848	583	262	0	0	2	1
경기도	가평군	하면	하면제4투	1120	629	491	10	619	459	157	0	1	0	2
경기도	가평군	하면	하면제5투	588	440	148	7	433	305	122	1	0	0	5
경기도	가평군	하면	하면제6투	603	471	132	1	470	325	143	1	0	0	1
경기도	가평군	북면	소계	3306	2414	892	9	2405	1684	695	0	1	6	19
경기도	가평군	북면	북면제1투	1449	1086	363	5	1081	769	300	0	1	2	9
경기도	가평군	북면	북면제2투	665	462	203	2	460	339	115	0	0	1	5
경기도	가평군	북면	북면제3투	746	539	207	1	538	351	183	0	0	2	2
경기도	가평군	북면	북면제4투	446	327	119	1	326	225	97	0	0	1	3
강원도	춘천시	계	계	215931	163981	51950	517	163464	93414	69365	60	104	276	245
강원도	춘천시	재외투표	재외투표	815	574	241	5	569	224	341	0	4	0	0
강원도	춘천시	국내부재자투표	국내부재자투표	6673	6178	495	99	6079	3039	2969	10	12	14	35
강원도	춘천시	신북읍	소계	6010	4519	1491	37	4482	2937	1516	4	1	7	17
강원도	춘천시	신북읍	신북읍제1투	1712	1279	433	5	1274	842	428	1	1	0	2
강원도	춘천시	신북읍	신북읍제2투	2062	1532	530	8	1524	971	546	1	0	2	4
강원도	춘천시	신북읍	신북읍제3투	1362	1066	296	20	1046	701	336	2	0	2	5
강원도	춘천시	신북읍	신북읍제4투	874	642	232	4	638	423	206	0	0	3	6
강원도	춘천시	동면	소계	8666	6788	1878	14	6774	3760	2996	0	2	9	7
강원도	춘천시	동면	동면제1투	2737	2257	480	2	2255	1150	1103	0	0	1	1
강원도	춘천시	동면	동면제2투	2019	1473	546	7	1466	977	483	0	1	4	1
강원도	춘천시	동면	동면제3투	275	195	80	2	193	137	55	0	0	0	1
강원도	춘천시	동면	동면제4투	3635	2863	772	3	2860	1496	1355	0	1	4	4
강원도	춘천시	동산면	소계	1365	1032	333	6	1026	687	329	2	0	3	5
강원도	춘천시	동산면	동산면제1투	772	581	191	2	579	397	178	1	0	1	2
강원도	춘천시	동산면	동산면제2투	593	451	142	4	447	290	151	1	0	2	3
강원도	춘천시	신동면	소계	2052	1593	459	12	1581	1088	484	1	0	2	6
강원도	춘천시	신동면	신동면투표소	2052	1593	459	12	1581	1088	484	1	0	2	6
강원도	춘천시	동내면	소계	11065	8386	2679	27	8359	4643	3683	2	4	14	13
강원도	춘천시	동내면	동내면제1투	4069	2924	1145	11	2913	1704	1199	1	1	5	3
강원도	춘천시	동내면	동내면제2투	2192	1677	515	10	1667	1074	577	0	2	4	10
강원도	춘천시	동내면	동내면제3투	4804	3785	1019	6	3779	1865	1907	1	1	5	0
강원도	춘천시	남면	소계	976	733	243	5	728	534	189	0	1	3	1
강원도	춘천시	남면	남면투표소	976	733	243	5	728	534	189	0	1	3	1
강원도	춘천시	남산면	소계	3357	2390	967	10	2380	1631	732	2	1	3	11
강원도	춘천시	남산면	남산면제1투	1872	1321	551	7	1314	881	425	1	0	1	6
강원도	춘천시	남산면	남산면제2투	738	537	201	1	536	369	162	1	1	2	1
강원도	춘천시	남산면	남산면제3투	747	532	215	2	530	381	145	0	0	0	4
강원도	춘천시	서면	소계	3469	2530	939	12	2518	1713	792	2	3	2	6
강원도	춘천시	서면	서면제1투	2716	2022	694	8	2014	1331	672	2	3	2	4
강원도	춘천시	서면	서면제2투	753	508	245	4	504	382	120	0	0	0	2
강원도	춘천시	사북면	소계	2208	1635	573	3	1632	1135	483	0	0	5	9
강원도	춘천시	사북면	사북면제1투	688	529	159	0	529	352	172	0	0	2	3
강원도	춘천시	사북면	사북면제2투	357	256	101	1	255	172	80	0	0	2	1
강원도	춘천시	사북면	사북면제3투	1163	850	313	2	848	611	231	0	0	1	5
강원도	춘천시	북산면	소계	805	593	212	4	589	446	139	0	0	0	4
강원도	춘천시	북산면	북산면제1투	629	468	161	3	465	337	124	0	0	0	4
강원도	춘천시	북산면	북산면제2투	176	125	51	1	124	109	15	0	0	0	0
강원도	춘천시	소양동	소계	6521	4719	1802	12	4707	2858	1835	2	1	4	7
강원도	춘천시	소양동	소양동제1투	2408	1835	573	6	1829	1085	739	1	0	1	3
강원도	춘천시	소양동	소양동제2투	2482	1860	622	4	1856	1104	747	0	0	3	2
강원도	춘천시	소양동	소양동제3투	1631	1024	607	2	1022	669	349	1	1	0	2
강원도	춘천시	교동	소계	3474	2444	1030	4	2440	1428	1001	1	1	7	2
강원도	춘천시	교동	교동투표소	3474	2444	1030	4	2440	1428	1001	1	1	7	2
강원도	춘천시	조운동	소계	3066	2151	915	7	2144	1350	784	2	2	2	4
강원도	춘천시	조운동	조운동투표소	3066	2151	915	7	2144	1350	784	2	2	2	4
강원도	춘천시	약사명동	소계	3882	2857	1025	7	2850	1801	1036	2	1	3	7
강원도	춘천시	약사명동	약사명동투표소	3882	2857	1025	7	2850	1801	1036	2	1	3	7
강원도	춘천시	근화동	소계	6499	4674	1825	10	4664	2853	1795	1	2	6	7
강원도	춘천시	근화동	근화동제1투	3405	2567	838	6	2561	1492	1066	0	0	2	1
강원도	춘천시	근화동	근화동제2투	3094	2107	987	4	2103	1361	729	1	2	4	6
강원도	춘천시	후평1동	소계	10573	7682	2891	18	7664	4688	2947	3	4	12	10
강원도	춘천시	후평1동	후평1동제1투	3594	2616	978	8	2608	1523	1076	0	3	3	3
강원도	춘천시	후평1동	후평1동제2투	3439	2390	1049	4	2386	1494	887	1	0	2	2
강원도	춘천시	후평1동	후평1동제3투	3540	2676	864	6	2670	1671	984	2	1	7	5
강원도	춘천시	후평2동	소계	11480	8679	2801	17	8662	4859	3769	3	8	16	7
강원도	춘천시	후평2동	후평2동제1투	3556	2643	913	5	2638	1539	1095	0	2	0	2
강원도	춘천시	후평2동	후평2동제2투	3704	2661	1043	6	2655	1466	1173	2	3	6	5
강원도	춘천시	후평2동	후평2동제3투	4220	3375	845	6	3369	1854	1501	1	3	10	0
강원도	춘천시	후평3동	소계	16501	12302	4199	20	12282	6939	5290	1	14	24	14
강원도	춘천시	후평3동	후평3동제1투	4539	3572	967	4	3568	2090	1464	0	5	7	2
강원도	춘천시	후평3동	후평3동제2투	2124	1426	698	1	1425	757	661	0	2	1	4
강원도	춘천시	후평3동	후평3동제3투	4108	2946	1162	6	2940	1546	1381	1	2	8	2
강원도	춘천시	후평3동	후평3동제4투	2169	1664	505	0	1664	983	676	0	2	1	2
강원도	춘천시	후평3동	후평3동제5투	3561	2694	867	9	2685	1563	1108	0	3	7	4
강원도	춘천시	효자1동	소계	3066	2154	912	3	2151	1350	795	0	0	5	1
강원도	춘천시	효자1동	효자1동투표소	3066	2154	912	3	2151	1350	795	0	0	5	1
강원도	춘천시	효자2동	소계	10529	7530	2999	26	7504	4511	2968	1	3	14	7
강원도	춘천시	효자2동	효자2동제1투	2727	1887	840	11	1876	1116	755	0	0	4	1
강원도	춘천시	효자2동	효자2동제2투	2383	1830	553	7	1823	1102	717	1	0	3	0
강원도	춘천시	효자2동	효자2동제3투	2775	1988	787	3	1985	1200	776	0	2	3	4
강원도	춘천시	효자2동	효자2동제4투	2644	1825	819	5	1820	1093	720	0	1	4	2
강원도	춘천시	효자3동	소계	4180	2957	1223	7	2950	1713	1227	0	3	3	4
강원도	춘천시	효자3동	효자3동투표소	4180	2957	1223	7	2950	1713	1227	0	3	3	4
강원도	춘천시	석사동	소계	29494	22670	6824	46	22624	11681	10877	6	9	37	14
강원도	춘천시	석사동	석사동제1투	3513	2740	773	9	2731	1538	1185	1	0	4	3
강원도	춘천시	석사동	석사동제2투	2684	1755	929	3	1752	1019	727	1	2	3	0
강원도	춘천시	석사동	석사동제3투	2395	1680	715	5	1675	860	811	0	0	2	2
강원도	춘천시	석사동	석사동제4투	3803	3168	635	3	3165	1630	1528	0	0	5	2
강원도	춘천시	석사동	석사동제5투	3002	2397	605	1	2396	1161	1231	0	1	3	0
강원도	춘천시	석사동	석사동제6투	4708	3762	946	6	3756	1871	1873	0	0	9	3
강원도	춘천시	석사동	석사동제7투	2699	1901	798	4	1897	1037	852	1	3	2	2
강원도	춘천시	석사동	석사동제8투	2412	2009	403	3	2006	945	1055	0	1	5	0
강원도	춘천시	석사동	석사동제9투	4278	3258	1020	12	3246	1620	1615	3	2	4	2
강원도	춘천시	퇴계동	소계	33065	26036	7029	57	25979	13753	12142	11	15	42	16
강원도	춘천시	퇴계동	퇴계동제1투	4548	3491	1057	9	3482	1891	1579	3	0	8	1
강원도	춘천시	퇴계동	퇴계동제2투	2417	1860	557	3	1857	1063	786	2	1	4	1
강원도	춘천시	퇴계동	퇴계동제3투	2390	1889	501	5	1884	994	889	0	0	1	0
강원도	춘천시	퇴계동	퇴계동제4투	2907	2424	483	4	2420	1361	1053	1	2	2	1
강원도	춘천시	퇴계동	퇴계동제5투	1703	1350	353	5	1345	726	612	1	1	4	1
강원도	춘천시	퇴계동	퇴계동제6투	2808	2260	548	8	2252	1222	1025	1	0	4	0
강원도	춘천시	퇴계동	퇴계동제7투	4593	3549	1044	5	3544	1967	1558	3	3	8	5
강원도	춘천시	퇴계동	퇴계동제8투	3550	2664	886	4	2660	1242	1407	0	2	8	1
강원도	춘천시	퇴계동	퇴계동제9투	2225	1818	407	2	1816	873	936	0	4	0	3
강원도	춘천시	퇴계동	퇴계동제10투	3599	2766	833	7	2759	1443	1310	0	2	2	2
강원도	춘천시	퇴계동	퇴계동제11투	2325	1965	360	5	1960	971	987	0	0	1	1
강원도	춘천시	강남동	소계	11183	8588	2595	16	8572	4946	3593	1	5	16	11
강원도	춘천시	강남동	강남동제1투	2175	1530	645	5	1525	874	649	0	2	0	0
강원도	춘천시	강남동	강남동제2투	2163	1697	466	4	1693	1031	654	0	0	4	4
강원도	춘천시	강남동	강남동제3투	3333	2617	716	3	2614	1570	1034	0	1	5	4
강원도	춘천시	강남동	강남동제4투	3512	2744	768	4	2740	1471	1256	1	2	7	3
강원도	춘천시	신사우동	소계	14957	11587	3370	33	11554	6847	4653	3	8	23	20
강원도	춘천시	신사우동	신사우동제1투	3660	2767	893	9	2758	1519	1228	2	3	5	1
강원도	춘천시	신사우동	신사우동제2투	3141	2504	637	3	2501	1487	1003	0	2	6	3
강원도	춘천시	신사우동	신사우동제3투	3464	2654	810	5	2649	1591	1049	0	0	3	6
강원도	춘천시	신사우동	신사우동제4투	1712	1298	414	4	1294	897	390	0	2	2	3
강원도	춘천시	신사우동	신사우동제5투	2980	2364	616	12	2352	1353	983	1	1	7	7
강원도	원주시	계	계	251375	182937	68438	565	182372	105702	75943	55	110	280	282
강원도	원주시	재외투표	재외투표	723	502	221	1	501	199	299	0	1	2	0
강원도	원주시	국내부재자투표	국내부재자투표	7847	6983	864	116	6867	3270	3535	8	10	19	25
강원도	원주시	문막읍	소계	14627	10051	4576	31	10020	5682	4298	4	2	8	26
강원도	원주시	문막읍	문막읍제1투	4731	3091	1640	6	3085	1766	1313	0	1	2	3
강원도	원주시	문막읍	문막읍제2투	2512	1827	685	8	1819	1239	566	3	0	3	8
강원도	원주시	문막읍	문막읍제3투	1330	967	363	8	959	671	285	0	0	0	3
강원도	원주시	문막읍	문막읍제4투	2963	2063	900	5	2058	1009	1042	1	0	1	5
강원도	원주시	문막읍	문막읍제5투	3091	2103	988	4	2099	997	1092	0	1	2	7
강원도	원주시	소초면	소계	7674	5518	2156	25	5493	3623	1845	0	2	5	18
강원도	원주시	소초면	소초면제1투	2342	1672	670	11	1661	1072	574	0	0	5	10
강원도	원주시	소초면	소초면제2투	1603	1246	357	3	1243	834	406	0	1	0	2
강원도	원주시	소초면	소초면제3투	2833	1944	889	6	1938	1282	652	0	1	0	3
강원도	원주시	소초면	소초면제4투	896	656	240	5	651	435	213	0	0	0	3
강원도	원주시	호저면	소계	3709	2756	953	21	2735	1842	875	3	4	2	9
강원도	원주시	호저면	호저면제1투	2468	1841	627	14	1827	1229	583	2	3	2	8
강원도	원주시	호저면	호저면제2투	1241	915	326	7	908	613	292	1	1	0	1
강원도	원주시	지정면	소계	2612	1988	624	20	1968	1344	593	2	8	6	15
강원도	원주시	지정면	지정면제1투	1545	1173	372	12	1161	793	344	2	8	3	11
강원도	원주시	지정면	지정면제2투	1067	815	252	8	807	551	249	0	0	3	4
강원도	원주시	부론면	소계	2219	1658	561	4	1654	1178	467	1	0	3	5
강원도	원주시	부론면	부론면투표소	2219	1658	561	4	1654	1178	467	1	0	3	5
강원도	원주시	귀래면	소계	1814	1372	442	7	1365	946	408	2	0	3	6
강원도	원주시	귀래면	귀래면투표소	1814	1372	442	7	1365	946	408	2	0	3	6
강원도	원주시	흥업면	소계	6791	4628	2163	18	4610	2578	2011	4	1	4	12
강원도	원주시	흥업면	흥업면제1투	3493	2328	1165	7	2321	1315	998	1	0	1	6
강원도	원주시	흥업면	흥업면제2투	1062	776	286	4	772	515	253	1	0	0	3
강원도	원주시	흥업면	흥업면제3투	2236	1524	712	7	1517	748	760	2	1	3	3
강원도	원주시	판부면	소계	5371	3739	1632	8	3731	2156	1549	2	3	9	12
강원도	원주시	판부면	판부면제1투	1014	756	258	2	754	492	259	0	0	1	2
강원도	원주시	판부면	판부면제2투	776	569	207	3	566	357	201	1	1	1	5
강원도	원주시	판부면	판부면제3투	3581	2414	1167	3	2411	1307	1089	1	2	7	5
강원도	원주시	신림면	소계	3388	2506	882	15	2491	1645	836	0	2	6	2
강원도	원주시	신림면	신림면제1투	2511	1856	655	13	1843	1229	606	0	2	4	2
강원도	원주시	신림면	신림면제2투	877	650	227	2	648	416	230	0	0	2	0
강원도	원주시	중앙동	소계	2921	1944	977	5	1939	1381	546	0	1	7	4
강원도	원주시	중앙동	중앙동투표소	2921	1944	977	5	1939	1381	546	0	1	7	4
강원도	원주시	원인동	소계	5472	3806	1666	10	3796	2334	1451	1	1	6	3
강원도	원주시	원인동	원인동제1투	3634	2499	1135	6	2493	1509	976	1	1	5	1
강원도	원주시	원인동	원인동제2투	1838	1307	531	4	1303	825	475	0	0	1	2
강원도	원주시	개운동	소계	11096	8397	2699	17	8380	5168	3189	2	6	10	5
강원도	원주시	개운동	개운동제1투	3325	2484	841	5	2479	1625	847	0	2	3	2
강원도	원주시	개운동	개운동제2투	4622	3441	1181	8	3433	2130	1292	0	2	6	3
강원도	원주시	개운동	개운동제3투	3149	2472	677	4	2468	1413	1050	2	2	1	0
강원도	원주시	명륜1동	소계	8559	6360	2199	9	6351	3844	2476	2	6	15	8
강원도	원주시	명륜1동	명륜1동제1투	2959	2041	918	2	2039	1325	703	0	2	5	4
강원도	원주시	명륜1동	명륜1동제2투	2472	1829	643	4	1825	1089	726	2	1	3	4
강원도	원주시	명륜1동	명륜1동제3투	3128	2490	638	3	2487	1430	1047	0	3	7	0
강원도	원주시	명륜2동	소계	14304	10330	3974	24	10306	5851	4415	3	6	17	14
강원도	원주시	명륜2동	명륜2동제1투	4648	3093	1555	8	3085	1966	1100	2	2	4	11
강원도	원주시	명륜2동	명륜2동제2투	5186	3894	1292	8	3886	2004	1870	0	3	8	1
강원도	원주시	명륜2동	명륜2동제3투	4470	3343	1127	8	3335	1881	1445	1	1	5	2
강원도	원주시	단구동	소계	33891	24785	9106	39	24746	13561	11111	2	14	33	25
강원도	원주시	단구동	단구동제1투	3908	2772	1136	4	2768	1698	1062	0	3	4	1
강원도	원주시	단구동	단구동제2투	3621	2734	887	9	2725	1638	1077	0	1	6	3
강원도	원주시	단구동	단구동제3투	5616	3999	1617	6	3993	1944	2033	1	3	6	6
강원도	원주시	단구동	단구동제4투	2933	2173	760	4	2169	1476	686	0	0	3	4
강원도	원주시	단구동	단구동제5투	2873	2155	718	2	2153	1296	856	0	0	0	1
강원도	원주시	단구동	단구동제6투	3248	2502	746	3	2499	1297	1196	0	2	1	3
강원도	원주시	단구동	단구동제7투	4919	3404	1515	5	3399	1751	1638	1	3	4	2
강원도	원주시	단구동	단구동제8투	4971	3644	1327	5	3639	1787	1837	0	1	9	5
강원도	원주시	단구동	단구동제9투	1802	1402	400	1	1401	674	726	0	1	0	0
강원도	원주시	일산동	소계	7079	5023	2056	16	5007	3137	1853	0	3	7	7
강원도	원주시	일산동	일산동제1투	3776	2647	1129	10	2637	1657	972	0	2	4	2
강원도	원주시	일산동	일산동제2투	3303	2376	927	6	2370	1480	881	0	1	3	5
강원도	원주시	학성동	소계	4939	3502	1437	6	3496	2296	1188	1	0	7	4
강원도	원주시	학성동	학성동제1투	3175	2312	863	5	2307	1446	858	0	0	3	0
강원도	원주시	학성동	학성동제2투	1764	1190	574	1	1189	850	330	1	0	4	4
강원도	원주시	단계동	소계	18467	13477	4990	28	13449	7741	5651	3	15	23	16
강원도	원주시	단계동	단계동제1투	3711	2589	1122	9	2580	1502	1068	1	2	4	3
강원도	원주시	단계동	단계동제2투	4418	3339	1079	5	3334	1916	1403	1	3	6	5
강원도	원주시	단계동	단계동제3투	4023	2916	1107	7	2909	1677	1223	0	2	2	5
강원도	원주시	단계동	단계동제4투	2366	1620	746	2	1618	931	674	0	3	8	2
강원도	원주시	단계동	단계동제5투	3949	3013	936	5	3008	1715	1283	1	5	3	1
강원도	원주시	우산동	소계	10383	7215	3168	11	7204	4362	2823	2	3	9	5
강원도	원주시	우산동	우산동제1투	2842	1878	964	2	1876	1223	647	2	0	2	2
강원도	원주시	우산동	우산동제2투	3742	2664	1078	6	2658	1603	1049	0	3	1	2
강원도	원주시	우산동	우산동제3투	3799	2673	1126	3	2670	1536	1127	0	0	6	1
강원도	원주시	태장1동	소계	7897	5707	2190	18	5689	3334	2337	2	4	7	5
강원도	원주시	태장1동	태장1동제1투	3449	2552	897	11	2541	1542	993	0	1	2	3
강원도	원주시	태장1동	태장1동제2투	4448	3155	1293	7	3148	1792	1344	2	3	5	2
강원도	원주시	태장2동	소계	19383	13791	5592	34	13757	8274	5438	5	5	15	20
강원도	원주시	태장2동	태장2동제1투	3308	2127	1181	8	2119	1299	814	0	1	4	1
강원도	원주시	태장2동	태장2동제2투	3949	2936	1013	8	2928	1727	1189	1	1	5	5
강원도	원주시	태장2동	태장2동제3투	3626	2694	932	4	2690	1510	1170	1	2	2	5
강원도	원주시	태장2동	태장2동제4투	2086	1387	699	0	1387	910	472	2	1	0	2
강원도	원주시	태장2동	태장2동제5투	2542	1757	785	2	1755	1153	595	0	0	2	5
강원도	원주시	태장2동	태장2동제6투	3872	2890	982	12	2878	1675	1198	1	0	2	2
강원도	원주시	봉산동	소계	8467	6235	2232	20	6215	3902	2291	1	3	12	6
강원도	원주시	봉산동	봉산동제1투	2785	2006	779	7	1999	1302	691	1	1	4	0
강원도	원주시	봉산동	봉산동제2투	2482	1758	724	10	1748	1163	574	0	1	6	4
강원도	원주시	봉산동	봉산동제3투	3200	2471	729	3	2468	1437	1026	0	1	2	2
강원도	원주시	행구동	소계	6106	4640	1466	14	4626	2594	2022	0	1	4	5
강원도	원주시	행구동	행구동제1투	2629	1857	772	11	1846	1130	712	0	0	2	2
강원도	원주시	행구동	행구동제2투	3477	2783	694	3	2780	1464	1310	0	1	2	3
강원도	원주시	무실동	소계	21382	15551	5831	30	15521	8174	7308	2	6	21	10
강원도	원주시	무실동	무실동제1투	4391	3154	1237	7	3147	1725	1417	1	1	1	2
강원도	원주시	무실동	무실동제2투	5746	4167	1579	9	4158	2186	1963	0	3	2	4
강원도	원주시	무실동	무실동제3투	3431	2844	587	4	2840	1380	1452	0	1	7	0
강원도	원주시	무실동	무실동제4투	3107	1888	1219	5	1883	1165	712	0	1	2	3
강원도	원주시	무실동	무실동제5투	4707	3498	1209	5	3493	1718	1764	1	0	9	1
강원도	원주시	반곡관설동	소계	14254	10473	3781	18	10455	5286	5128	3	3	20	15
강원도	원주시	반곡관설동	반곡관설동제1투	1187	895	292	4	891	615	272	0	0	1	3
강원도	원주시	반곡관설동	반곡관설동제2투	2459	1812	647	5	1807	949	848	0	0	5	5
강원도	원주시	반곡관설동	반곡관설동제3투	4998	3364	1634	4	3360	1721	1627	0	2	4	6
강원도	원주시	반곡관설동	반곡관설동제4투	2859	2143	716	1	2142	979	1157	1	1	3	1
강원도	원주시	반곡관설동	반곡관설동제5투	2751	2259	492	4	2255	1022	1224	2	0	7	0
강원도	강릉시	계	계	175077	129776	45301	457	129319	85045	43750	41	50	200	233
강원도	강릉시	재외투표	재외투표	475	330	145	5	325	101	220	0	0	4	0
강원도	강릉시	국내부재자투표	국내부재자투표	5653	5070	583	104	4966	2461	2457	6	14	8	20
강원도	강릉시	주문진읍	소계	15878	10780	5098	40	10740	7783	2897	8	3	14	35
강원도	강릉시	주문진읍	주문진읍제1투	3491	2307	1184	9	2298	1799	480	2	0	3	14
강원도	강릉시	주문진읍	주문진읍제2투	3384	2137	1247	9	2128	1583	529	3	1	2	10
강원도	강릉시	주문진읍	주문진읍제3투	3242	2317	925	5	2312	1683	621	0	2	5	1
강원도	강릉시	주문진읍	주문진읍제4투	1016	759	257	4	755	568	182	0	0	1	4
강원도	강릉시	주문진읍	주문진읍제5투	2276	1571	705	8	1563	1097	460	1	0	2	3
강원도	강릉시	주문진읍	주문진읍제6투	2469	1689	780	5	1684	1053	625	2	0	1	3
강원도	강릉시	성산면	소계	2768	2076	692	7	2069	1503	556	1	0	5	4
강원도	강릉시	성산면	성산면제1투	2203	1634	569	6	1628	1194	428	1	0	3	2
강원도	강릉시	성산면	성산면제2투	565	442	123	1	441	309	128	0	0	2	2
강원도	강릉시	왕산면	소계	1553	1163	390	5	1158	866	286	0	0	2	4
강원도	강릉시	왕산면	왕산면제1투	797	616	181	2	614	459	151	0	0	2	2
강원도	강릉시	왕산면	왕산면제2투	373	283	90	1	282	217	65	0	0	0	0
강원도	강릉시	왕산면	왕산면제3투	383	264	119	2	262	190	70	0	0	0	2
강원도	강릉시	구정면	소계	3366	2509	857	6	2503	1783	705	1	0	2	12
강원도	강릉시	구정면	구정면제1투	2216	1675	541	4	1671	1164	498	0	0	2	7
강원도	강릉시	구정면	구정면제2투	1150	834	316	2	832	619	207	1	0	0	5
강원도	강릉시	강동면	소계	4356	3169	1187	12	3157	2411	727	2	3	5	9
강원도	강릉시	강동면	강동면제1투	3071	2258	813	8	2250	1723	513	2	1	4	7
강원도	강릉시	강동면	강동면제2투	1285	911	374	4	907	688	214	0	2	1	2
강원도	강릉시	옥계면	소계	3753	2758	995	13	2745	2040	679	3	0	6	17
강원도	강릉시	옥계면	옥계면제1투	2289	1668	621	5	1663	1246	401	3	0	4	9
강원도	강릉시	옥계면	옥계면제2투	1464	1090	374	8	1082	794	278	0	0	2	8
강원도	강릉시	사천면	소계	3640	2680	960	19	2661	1900	749	1	0	3	8
강원도	강릉시	사천면	사천면제1투	2285	1639	646	11	1628	1187	434	0	0	1	6
강원도	강릉시	사천면	사천면제2투	1355	1041	314	8	1033	713	315	1	0	2	2
강원도	강릉시	연곡면	소계	5644	4160	1484	11	4149	2751	1374	0	1	6	17
강원도	강릉시	연곡면	연곡면제1투	3850	2801	1049	7	2794	1718	1060	0	0	5	11
강원도	강릉시	연곡면	연곡면제2투	1794	1359	435	4	1355	1033	314	0	1	1	6
강원도	강릉시	홍제동	소계	6535	4831	1704	19	4812	3203	1594	0	3	5	7
강원도	강릉시	홍제동	홍제동제1투	3314	2427	887	9	2418	1577	836	0	0	2	3
강원도	강릉시	홍제동	홍제동제2투	3221	2404	817	10	2394	1626	758	0	3	3	4
강원도	강릉시	중앙동	소계	5350	3752	1598	17	3735	2741	977	2	2	8	5
강원도	강릉시	중앙동	중앙동제1투	2103	1526	577	5	1521	1074	438	1	0	7	1
강원도	강릉시	중앙동	중앙동제2투	3247	2226	1021	12	2214	1667	539	1	2	1	4
강원도	강릉시	옥천동	소계	3495	2506	989	3	2503	1888	606	1	0	5	3
강원도	강릉시	옥천동	옥천동투표소	3495	2506	989	3	2503	1888	606	1	0	5	3
강원도	강릉시	교1동	소계	21585	16470	5115	34	16436	9809	6578	5	2	34	8
강원도	강릉시	교1동	교1동제1투	3364	2560	804	6	2554	1634	912	2	0	5	1
강원도	강릉시	교1동	교1동제2투	3411	2510	901	5	2505	1801	700	0	0	3	1
강원도	강릉시	교1동	교1동제3투	3316	2701	615	4	2697	1494	1193	0	1	8	1
강원도	강릉시	교1동	교1동제4투	4125	3025	1100	4	3021	1635	1375	0	0	8	3
강원도	강릉시	교1동	교1동제5투	3767	2811	956	10	2801	1614	1176	3	1	7	0
강원도	강릉시	교1동	교1동제6투	3602	2863	739	5	2858	1631	1222	0	0	3	2
강원도	강릉시	교2동	소계	7611	5618	1993	6	5612	3806	1789	1	1	9	6
강원도	강릉시	교2동	교2동제1투	2539	1744	795	0	1744	1273	464	0	0	3	4
강원도	강릉시	교2동	교2동제2투	2175	1627	548	3	1624	1143	477	0	0	2	2
강원도	강릉시	교2동	교2동제3투	2897	2247	650	3	2244	1390	848	1	1	4	0
강원도	강릉시	포남1동	소계	10086	7506	2580	14	7492	5221	2249	1	3	12	6
강원도	강릉시	포남1동	포남1동제1투	3354	2472	882	4	2468	1720	739	0	1	4	4
강원도	강릉시	포남1동	포남1동제2투	3263	2453	810	5	2448	1757	686	1	0	3	1
강원도	강릉시	포남1동	포남1동제3투	3469	2581	888	5	2576	1744	824	0	2	5	1
강원도	강릉시	포남2동	소계	12592	9119	3473	30	9089	5867	3191	0	3	12	16
강원도	강릉시	포남2동	포남2동제1투	3630	2503	1127	10	2493	1706	780	0	1	3	3
강원도	강릉시	포남2동	포남2동제2투	3220	2332	888	4	2328	1491	831	0	1	3	2
강원도	강릉시	포남2동	포남2동제3투	2921	2099	822	7	2092	1298	787	0	0	2	5
강원도	강릉시	포남2동	포남2동제4투	2821	2185	636	9	2176	1372	793	0	1	4	6
강원도	강릉시	초당동	소계	4374	3300	1074	2	3298	2000	1286	3	2	6	1
강원도	강릉시	초당동	초당동제1투	1763	1307	456	1	1306	896	408	0	0	2	0
강원도	강릉시	초당동	초당동제2투	2611	1993	618	1	1992	1104	878	3	2	4	1
강원도	강릉시	송정동	소계	5603	4276	1327	15	4261	2687	1565	1	2	4	2
강원도	강릉시	송정동	송정동제1투	2290	1758	532	8	1750	1215	533	0	1	1	0
강원도	강릉시	송정동	송정동제2투	3313	2518	795	7	2511	1472	1032	1	1	3	2
강원도	강릉시	내곡동	소계	9070	6542	2528	11	6531	4151	2358	0	1	12	9
강원도	강릉시	내곡동	내곡동제1투	4177	3212	965	4	3208	2065	1130	0	0	7	6
강원도	강릉시	내곡동	내곡동제2투	4893	3330	1563	7	3323	2086	1228	0	1	5	3
강원도	강릉시	강남동	소계	16647	12364	4283	38	12326	8462	3825	2	3	17	17
강원도	강릉시	강남동	강남동제1투	3655	2675	980	10	2665	1832	829	0	0	2	2
강원도	강릉시	강남동	강남동제2투	3463	2638	825	3	2635	1869	755	0	2	5	4
강원도	강릉시	강남동	강남동제3투	3809	2730	1079	7	2723	1895	821	0	0	5	2
강원도	강릉시	강남동	강남동제4투	3578	2703	875	8	2695	1673	1012	0	1	4	5
강원도	강릉시	강남동	강남동제5투	1183	894	289	5	889	674	210	1	0	1	3
강원도	강릉시	강남동	강남동제6투	959	724	235	5	719	519	198	1	0	0	1
강원도	강릉시	성덕동	소계	20999	15762	5237	35	15727	9574	6109	3	6	16	19
강원도	강릉시	성덕동	성덕동제1투	2312	1659	653	8	1651	1144	503	0	1	0	3
강원도	강릉시	성덕동	성덕동제2투	4432	3347	1085	4	3343	2004	1329	1	0	5	4
강원도	강릉시	성덕동	성덕동제3투	4948	3576	1372	11	3565	2391	1162	1	2	3	6
강원도	강릉시	성덕동	성덕동제4투	3734	2817	917	7	2810	1682	1121	1	0	3	3
강원도	강릉시	성덕동	성덕동제5투	3976	3194	782	1	3193	1564	1622	0	2	4	1
강원도	강릉시	성덕동	성덕동제6투	1597	1169	428	4	1165	789	372	0	1	1	2
강원도	강릉시	경포동	소계	4044	3035	1009	11	3024	2037	973	0	1	5	8
강원도	강릉시	경포동	경포동제1투	2364	1713	651	7	1706	1116	583	0	1	2	4
강원도	강릉시	경포동	경포동제2투	1680	1322	358	4	1318	921	390	0	0	3	4
강원도	동해시	계	계	74573	55083	19490	225	54858	36139	18511	18	23	68	99
강원도	동해시	재외투표	재외투표	170	114	56	1	113	60	52	1	0	0	0
강원도	동해시	국내부재자투표	국내부재자투표	3816	3545	271	62	3483	1903	1531	2	11	17	19
강원도	동해시	천곡동	소계	20513	15250	5263	36	15214	9729	5452	4	2	18	9
강원도	동해시	천곡동	천곡동제1투	2701	2038	663	2	2036	1313	721	0	1	0	1
강원도	동해시	천곡동	천곡동제2투	2526	1850	676	4	1846	1232	611	1	0	1	1
강원도	동해시	천곡동	천곡동제3투	2282	1658	624	1	1657	1062	589	1	0	3	2
강원도	동해시	천곡동	천곡동제4투	3010	2209	801	5	2204	1398	802	0	1	3	0
강원도	동해시	천곡동	천곡동제5투	1927	1405	522	5	1400	985	411	1	0	1	2
강원도	동해시	천곡동	천곡동제6투	2165	1729	436	4	1725	1142	580	0	0	3	0
강원도	동해시	천곡동	천곡동제7투	2600	1810	790	8	1802	1192	604	0	0	4	2
강원도	동해시	천곡동	천곡동제8투	3302	2551	751	7	2544	1405	1134	1	0	3	1
강원도	동해시	송정동	소계	4070	2949	1121	12	2937	2102	824	0	0	5	6
강원도	동해시	송정동	송정동제1투	2703	1902	801	8	1894	1366	518	0	0	4	6
강원도	동해시	송정동	송정동제2투	1367	1047	320	4	1043	736	306	0	0	1	0
강원도	동해시	북삼동	소계	14180	10623	3557	26	10597	6264	4292	5	5	12	19
강원도	동해시	북삼동	북삼동제1투	1550	1120	430	4	1116	813	297	2	2	1	1
강원도	동해시	북삼동	북삼동제2투	1353	983	370	5	978	682	289	0	1	2	4
강원도	동해시	북삼동	북삼동제3투	1914	1207	707	1	1206	791	410	1	0	2	2
강원도	동해시	북삼동	북삼동제4투	2447	1898	549	7	1891	1128	760	0	0	0	3
강원도	동해시	북삼동	북삼동제5투	3205	2549	656	6	2543	1415	1125	0	0	0	3
강원도	동해시	북삼동	북삼동제6투	3711	2866	845	3	2863	1435	1411	2	2	7	6
강원도	동해시	부곡동	소계	5482	3834	1648	12	3822	2657	1154	2	1	1	7
강원도	동해시	부곡동	부곡동제1투	2187	1539	648	6	1533	1037	492	0	1	0	3
강원도	동해시	부곡동	부곡동제2투	1633	1128	505	4	1124	779	342	0	0	1	2
강원도	동해시	부곡동	부곡동제3투	1662	1167	495	2	1165	841	320	2	0	0	2
강원도	동해시	동호동	소계	4187	2877	1310	11	2866	2114	744	2	0	2	4
강원도	동해시	동호동	동호동제1투	1851	1275	576	4	1271	966	303	0	0	1	1
강원도	동해시	동호동	동호동제2투	2336	1602	734	7	1595	1148	441	2	0	1	3
강원도	동해시	발한동	소계	4113	2842	1271	9	2833	2161	666	0	1	3	2
강원도	동해시	발한동	발한동제1투	1933	1309	624	3	1306	983	321	0	1	0	1
강원도	동해시	발한동	발한동제2투	2180	1533	647	6	1527	1178	345	0	0	3	1
강원도	동해시	묵호동	소계	3783	2561	1222	14	2547	1910	632	0	0	1	4
강원도	동해시	묵호동	묵호동제1투	2867	1916	951	10	1906	1406	497	0	0	1	2
강원도	동해시	묵호동	묵호동제2투	916	645	271	4	641	504	135	0	0	0	2
강원도	동해시	북평동	소계	7865	5869	1996	24	5845	3868	1958	2	2	4	11
강원도	동해시	북평동	북평동제1투	2350	1710	640	10	1700	1190	505	1	1	1	2
강원도	동해시	북평동	북평동제2투	2374	1736	638	10	1726	1182	538	0	1	1	4
강원도	동해시	북평동	북평동제3투	3141	2423	718	4	2419	1496	915	1	0	2	5
강원도	동해시	망상동	소계	3238	2290	948	10	2280	1681	585	0	0	3	11
강원도	동해시	망상동	망상동제1투	1283	943	340	5	938	688	240	0	0	1	9
강원도	동해시	망상동	망상동제2투	1955	1347	608	5	1342	993	345	0	0	2	2
강원도	동해시	삼화동	소계	3156	2329	827	8	2321	1690	621	0	1	2	7
강원도	동해시	삼화동	삼화동제1투	1897	1395	502	3	1392	1046	340	0	1	2	3
강원도	동해시	삼화동	삼화동제2투	1259	934	325	5	929	644	281	0	0	0	4
강원도	삼척시	계	계	60724	44452	16272	329	44123	28849	14874	32	72	80	216
강원도	삼척시	재외투표	재외투표	128	95	33	0	95	31	64	0	0	0	0
강원도	삼척시	국내부재자투표	국내부재자투표	3396	2799	597	59	2740	1250	1462	1	9	6	12
강원도	삼척시	도계읍	소계	10444	6768	3676	23	6745	5025	1680	3	2	6	29
강원도	삼척시	도계읍	도계읍제1투	593	393	200	4	389	287	100	0	0	1	1
강원도	삼척시	도계읍	도계읍제2투	1180	702	478	0	702	518	184	0	0	0	0
강원도	삼척시	도계읍	도계읍제3투	1423	1081	342	1	1080	848	221	0	0	0	11
강원도	삼척시	도계읍	도계읍제4투	2308	1658	650	3	1655	1234	412	0	0	0	9
강원도	삼척시	도계읍	도계읍제5투	724	538	186	5	533	401	122	1	0	2	7
강원도	삼척시	도계읍	도계읍제6투	2595	1397	1198	3	1394	1012	380	0	1	0	1
강원도	삼척시	도계읍	도계읍제7투	153	112	41	2	110	86	23	1	0	0	0
강원도	삼척시	도계읍	도계읍제8투	1468	887	581	5	882	639	238	1	1	3	0
강원도	삼척시	원덕읍	소계	4890	3628	1262	48	3580	2676	845	12	17	5	25
강원도	삼척시	원덕읍	원덕읍제1투	1702	1277	425	14	1263	994	250	3	10	1	5
강원도	삼척시	원덕읍	원덕읍제2투	690	511	179	7	504	353	139	1	1	2	8
강원도	삼척시	원덕읍	원덕읍제3투	1704	1234	470	15	1219	893	313	2	4	2	5
강원도	삼척시	원덕읍	원덕읍제4투	528	405	123	11	394	275	107	6	1	0	5
강원도	삼척시	원덕읍	원덕읍제5투	266	201	65	1	200	161	36	0	1	0	2
강원도	삼척시	근덕면	소계	5074	3747	1327	51	3696	2574	1057	3	16	10	36
강원도	삼척시	근덕면	근덕면제1투	669	518	151	6	512	333	168	0	3	3	5
강원도	삼척시	근덕면	근덕면제2투	2036	1468	568	16	1452	1055	377	1	3	1	15
강원도	삼척시	근덕면	근덕면제3투	891	675	216	8	667	460	193	0	4	3	7
강원도	삼척시	근덕면	근덕면제4투	880	651	229	13	638	434	188	2	5	2	7
강원도	삼척시	근덕면	근덕면제5투	598	435	163	8	427	292	131	0	1	1	2
강원도	삼척시	하장면	소계	1321	967	354	5	962	654	296	0	1	4	7
강원도	삼척시	하장면	하장면제1투	599	433	166	0	433	294	134	0	0	2	3
강원도	삼척시	하장면	하장면제2투	314	240	74	2	238	171	66	0	0	1	0
강원도	삼척시	하장면	하장면제3투	408	294	114	3	291	189	96	0	1	1	4
강원도	삼척시	노곡면	소계	720	559	161	10	549	357	167	1	6	5	13
강원도	삼척시	노곡면	노곡면제1투	447	351	96	4	347	212	117	1	4	5	8
강원도	삼척시	노곡면	노곡면제2투	273	208	65	6	202	145	50	0	2	0	5
강원도	삼척시	미로면	소계	1794	1406	388	16	1390	988	377	0	0	3	22
강원도	삼척시	미로면	미로면제1투	1019	798	221	5	793	560	216	0	0	3	14
강원도	삼척시	미로면	미로면제2투	452	354	98	5	349	249	95	0	0	0	5
강원도	삼척시	미로면	미로면제3투	323	254	69	6	248	179	66	0	0	0	3
강원도	삼척시	가곡면	소계	657	496	161	5	491	359	121	2	1	1	7
강원도	삼척시	가곡면	가곡면제1투	356	263	93	3	260	196	56	2	1	0	5
강원도	삼척시	가곡면	가곡면제2투	301	233	68	2	231	163	65	0	0	1	2
강원도	삼척시	신기면	소계	701	523	178	2	521	376	136	0	0	1	8
강원도	삼척시	신기면	신기면투표소	701	523	178	2	521	376	136	0	0	1	8
강원도	삼척시	남양동	소계	7903	5946	1957	30	5916	4086	1804	3	0	5	18
강원도	삼척시	남양동	남양동제1투	1405	1033	372	8	1025	676	347	0	0	2	0
강원도	삼척시	남양동	남양동제2투	1515	1114	401	4	1110	766	340	0	0	1	3
강원도	삼척시	남양동	남양동제3투	2058	1594	464	10	1584	1072	510	0	0	0	2
강원도	삼척시	남양동	남양동제4투	2028	1530	498	7	1523	1037	480	0	0	2	4
강원도	삼척시	남양동	남양동제5투	897	675	222	1	674	535	127	3	0	0	9
강원도	삼척시	성내동	소계	6982	5244	1738	26	5218	3340	1840	2	5	14	17
강원도	삼척시	성내동	성내동제1투	2053	1469	584	6	1463	963	494	1	2	2	1
강원도	삼척시	성내동	성내동제2투	912	735	177	4	731	520	208	0	0	1	2
강원도	삼척시	성내동	성내동제3투	2455	1870	585	9	1861	1162	679	0	3	9	8
강원도	삼척시	성내동	성내동제4투	1562	1170	392	7	1163	695	459	1	0	2	6
강원도	삼척시	교동	소계	7929	5734	2195	23	5711	3213	2466	2	7	11	12
강원도	삼척시	교동	교동제1투	2778	1787	991	7	1780	1018	752	1	0	4	5
강원도	삼척시	교동	교동제2투	1221	872	349	11	861	552	300	1	2	2	4
강원도	삼척시	교동	교동제3투	3930	3075	855	5	3070	1643	1414	0	5	5	3
강원도	삼척시	정라동	소계	8785	6540	2245	31	6509	3920	2559	3	8	9	10
강원도	삼척시	정라동	정라동제1투	1958	1373	585	9	1364	1032	321	1	2	2	6
강원도	삼척시	정라동	정라동제2투	2912	2080	832	6	2074	1290	776	0	3	3	2
강원도	삼척시	정라동	정라동제3투	2683	2129	554	9	2120	1014	1101	0	2	2	1
강원도	삼척시	정라동	정라동제4투	1232	958	274	7	951	584	361	2	1	2	1
강원도	삼척시	잘못 투입·구분된 투표지	잘못 투입·구분된 투표지	0	0	0	0	0	0	0	0	0	0	0
강원도	태백시	계	계	40408	28993	11415	102	28891	18850	9935	10	11	34	51
강원도	태백시	재외투표	재외투표	74	53	21	0	53	23	30	0	0	0	0
강원도	태백시	국내부재자투표	국내부재자투표	1456	1235	221	25	1210	563	642	1	1	1	2
강원도	태백시	황지동	소계	5328	3788	1540	7	3781	2580	1194	1	1	3	2
강원도	태백시	황지동	황지동제1투	2529	1773	756	5	1768	1234	531	0	0	1	2
강원도	태백시	황지동	황지동제2투	1776	1265	511	1	1264	842	419	1	0	2	0
강원도	태백시	황지동	황지동제3투	1023	750	273	1	749	504	244	0	1	0	0
강원도	태백시	황연동	소계	4576	3146	1430	9	3137	2245	881	1	0	6	4
강원도	태백시	황연동	황연동제1투	1868	1265	603	0	1265	873	387	0	0	4	1
강원도	태백시	황연동	황연동제2투	1083	776	307	6	770	555	213	0	0	0	2
강원도	태백시	황연동	황연동제3투	1625	1105	520	3	1102	817	281	1	0	2	1
강원도	태백시	삼수동	소계	5665	3861	1804	12	3849	2493	1337	0	2	8	9
강원도	태백시	삼수동	삼수동제1투	2905	1852	1053	2	1850	1167	676	0	2	2	3
강원도	태백시	삼수동	삼수동제2투	2247	1637	610	5	1632	1096	531	0	0	3	2
강원도	태백시	삼수동	삼수동제3투	513	372	141	5	367	230	130	0	0	3	4
강원도	태백시	상장동	소계	11246	8076	3170	17	8059	4745	3296	1	2	7	8
강원도	태백시	상장동	상장동제1투	1732	1178	554	5	1173	840	330	0	0	2	1
강원도	태백시	상장동	상장동제2투	3378	2606	772	4	2602	1435	1165	0	0	0	2
강원도	태백시	상장동	상장동제3투	1662	1235	427	3	1232	707	520	0	1	2	2
강원도	태백시	상장동	상장동제4투	1372	980	392	0	980	643	336	0	0	0	1
강원도	태백시	상장동	상장동제5투	3102	2077	1025	5	2072	1120	945	1	1	3	2
강원도	태백시	문곡소도동	소계	3202	2331	871	6	2325	1581	734	1	0	3	6
강원도	태백시	문곡소도동	문곡소도동제1투	856	543	313	2	541	389	148	1	0	1	2
강원도	태백시	문곡소도동	문곡소도동제2투	819	638	181	2	636	447	186	0	0	1	2
강원도	태백시	문곡소도동	문곡소도동제3투	1527	1150	377	2	1148	745	400	0	0	1	2
강원도	태백시	장성동	소계	3267	2400	867	6	2394	1649	732	3	2	1	7
강원도	태백시	장성동	장성동제1투	1200	841	359	3	838	620	212	0	1	0	5
강원도	태백시	장성동	장성동제2투	909	677	232	3	674	435	237	0	0	1	1
강원도	태백시	장성동	장성동제3투	1158	882	276	0	882	594	283	3	1	0	1
강원도	태백시	구문소동	소계	2931	2174	757	11	2163	1590	566	0	1	2	4
강원도	태백시	구문소동	구문소동제1투	1908	1412	496	6	1406	988	415	0	1	1	1
강원도	태백시	구문소동	구문소동제2투	1023	762	261	5	757	602	151	0	0	1	3
강원도	태백시	철암동	소계	2663	1929	734	9	1920	1381	523	2	2	3	9
강원도	태백시	철암동	철암동제1투	1453	1026	427	4	1022	728	285	1	1	2	5
강원도	태백시	철암동	철암동제2투	1210	903	307	5	898	653	238	1	1	1	4
강원도	정선군	계	계	33781	24116	9665	130	23986	15188	8610	11	6	45	126
강원도	정선군	재외투표	재외투표	64	50	14	0	50	20	29	1	0	0	0
강원도	정선군	국내부재자투표	국내부재자투표	1190	1018	172	5	1013	425	584	1	1	0	2
강원도	정선군	정선읍	소계	8661	6302	2359	34	6268	3758	2463	1	3	15	28
강원도	정선군	정선읍	정선읍제1투	2350	1694	656	6	1688	1038	642	0	0	4	4
강원도	정선군	정선읍	정선읍제2투	1857	1325	532	9	1316	829	480	1	1	1	4
강원도	정선군	정선읍	정선읍제3투	1912	1451	461	2	1449	747	692	0	1	4	5
강원도	정선군	정선읍	정선읍제4투	1193	877	316	12	865	527	328	0	1	6	3
강원도	정선군	정선읍	정선읍제5투	741	524	217	2	522	354	163	0	0	0	5
강원도	정선군	정선읍	정선읍제6투	285	211	74	0	211	143	64	0	0	0	4
강원도	정선군	정선읍	정선읍제7투	323	220	103	3	217	120	94	0	0	0	3
강원도	정선군	고한읍	소계	4558	2790	1768	8	2782	1679	1091	3	0	4	5
강원도	정선군	고한읍	고한읍제1투	1861	976	885	2	974	530	437	0	0	2	5
강원도	정선군	고한읍	고한읍제2투	1849	1222	627	5	1217	745	468	2	0	2	0
강원도	정선군	고한읍	고한읍제3투	848	592	256	1	591	404	186	1	0	0	0
강원도	정선군	사북읍	소계	4315	2995	1320	5	2990	2059	919	0	1	3	8
강원도	정선군	사북읍	사북읍제1투	2744	1889	855	4	1885	1248	628	0	1	1	7
강원도	정선군	사북읍	사북읍제2투	1571	1106	465	1	1105	811	291	0	0	2	1
강원도	정선군	신동읍	소계	3345	2431	914	9	2422	1662	734	1	0	7	18
강원도	정선군	신동읍	신동읍제1투	1169	871	298	4	867	593	264	1	0	4	5
강원도	정선군	신동읍	신동읍제2투	1273	881	392	1	880	596	276	0	0	3	5
강원도	정선군	신동읍	신동읍제3투	457	359	98	2	357	275	76	0	0	0	6
강원도	정선군	신동읍	신동읍제4투	446	320	126	2	318	198	118	0	0	0	2
강원도	정선군	화암면	소계	1467	1027	440	7	1020	664	347	0	0	2	7
강원도	정선군	화암면	화암면제1투	1199	852	347	3	849	540	301	0	0	2	6
강원도	정선군	화암면	화암면제2투	268	175	93	4	171	124	46	0	0	0	1
강원도	정선군	남면	소계	2878	2057	821	15	2042	1326	699	0	0	4	13
강원도	정선군	남면	남면제1투	713	509	204	5	504	291	209	0	0	3	1
강원도	정선군	남면	남면제2투	1759	1249	510	8	1241	843	390	0	0	0	8
강원도	정선군	남면	남면제3투	406	299	107	2	297	192	100	0	0	1	4
강원도	정선군	여량면	소계	1886	1413	473	11	1402	967	419	2	0	0	14
강원도	정선군	여량면	여량면제1투	1615	1219	396	10	1209	827	367	2	0	0	13
강원도	정선군	여량면	여량면제2투	271	194	77	1	193	140	52	0	0	0	1
강원도	정선군	북평면	소계	2261	1642	619	10	1632	1065	550	0	0	5	12
강원도	정선군	북평면	북평면제1투	1637	1193	444	8	1185	780	392	0	0	4	9
강원도	정선군	북평면	북평면제2투	624	449	175	2	447	285	158	0	0	1	3
강원도	정선군	임계면	소계	3156	2391	765	26	2365	1563	775	2	1	5	19
강원도	정선군	임계면	임계면제1투	1253	949	304	10	939	603	325	1	1	1	8
강원도	정선군	임계면	임계면제2투	362	281	81	4	277	179	94	1	0	1	2
강원도	정선군	임계면	임계면제3투	819	605	214	9	596	384	207	0	0	2	3
강원도	정선군	임계면	임계면제4투	374	295	79	2	293	219	70	0	0	1	3
강원도	정선군	임계면	임계면제5투	348	261	87	1	260	178	79	0	0	0	3
강원도	속초시	계	계	66297	47634	18663	150	47484	29651	17671	16	19	66	61
강원도	속초시	재외투표	재외투표	169	118	51	2	116	39	76	0	1	0	0
강원도	속초시	국내부재자투표	국내부재자투표	2340	2077	263	37	2040	1055	968	5	1	3	8
강원도	속초시	영랑동	소계	4524	3157	1367	7	3150	2179	966	0	0	3	2
강원도	속초시	영랑동	영랑동제1투	1475	1026	449	3	1023	704	316	0	0	2	1
강원도	속초시	영랑동	영랑동제2투	3049	2131	918	4	2127	1475	650	0	0	1	1
강원도	속초시	동명동	소계	3327	2358	969	5	2353	1636	711	0	1	2	3
강원도	속초시	동명동	동명동제1투	1995	1427	568	4	1423	959	462	0	0	1	1
강원도	속초시	동명동	동명동제2투	1332	931	401	1	930	677	249	0	1	1	2
강원도	속초시	금호동	소계	6084	4285	1799	6	4279	2841	1426	1	2	4	5
강원도	속초시	금호동	금호동제1투	1683	1103	580	3	1100	824	274	0	0	0	2
강원도	속초시	금호동	금호동제2투	1188	813	375	1	812	564	247	0	0	0	1
강원도	속초시	금호동	금호동제3투	1511	1074	437	2	1072	704	363	1	0	3	1
강원도	속초시	금호동	금호동제4투	1702	1295	407	0	1295	749	542	0	2	1	1
강원도	속초시	교동	소계	9019	6382	2637	18	6364	4018	2315	4	4	10	13
강원도	속초시	교동	교동제1투	1718	1111	607	6	1105	796	305	0	0	0	4
강원도	속초시	교동	교동제2투	3087	2284	803	4	2280	1251	1019	1	1	4	4
강원도	속초시	교동	교동제3투	2182	1566	616	4	1562	973	580	1	2	4	2
강원도	속초시	교동	교동제4투	2032	1421	611	4	1417	998	411	2	1	2	3
강원도	속초시	노학동	소계	16973	12108	4865	37	12071	7273	4759	2	3	25	9
강원도	속초시	노학동	노학동제1투	2646	1855	791	4	1851	1118	726	0	0	6	1
강원도	속초시	노학동	노학동제2투	3092	2237	855	8	2229	1404	817	0	1	4	3
강원도	속초시	노학동	노학동제3투	3774	2597	1177	5	2592	1477	1111	1	1	1	1
강원도	속초시	노학동	노학동제4투	2027	1439	588	10	1429	886	539	0	0	4	0
강원도	속초시	노학동	노학동제5투	2130	1423	707	3	1420	948	466	1	0	3	2
강원도	속초시	노학동	노학동제6투	3304	2557	747	7	2550	1440	1100	0	1	7	2
강원도	속초시	조양동	소계	17217	12448	4769	24	12424	7226	5163	1	4	14	16
강원도	속초시	조양동	조양동제1투	1321	920	401	2	918	613	304	0	0	0	1
강원도	속초시	조양동	조양동제2투	2695	1902	793	2	1900	1120	774	0	0	1	5
강원도	속초시	조양동	조양동제3투	4337	3022	1315	5	3017	1713	1296	1	1	2	4
강원도	속초시	조양동	조양동제4투	2632	1941	691	6	1935	1077	853	0	0	3	2
강원도	속초시	조양동	조양동제5투	3145	2379	766	4	2375	1376	991	0	3	5	0
강원도	속초시	조양동	조양동제6투	3087	2284	803	5	2279	1327	945	0	0	3	4
강원도	속초시	청호동	소계	3607	2449	1158	7	2442	1781	650	3	2	2	4
강원도	속초시	청호동	청호동제1투	2447	1667	780	5	1662	1245	409	3	1	0	4
강원도	속초시	청호동	청호동제2투	1160	782	378	2	780	536	241	0	1	2	0
강원도	속초시	대포동	소계	3037	2252	785	7	2245	1603	637	0	1	3	1
강원도	속초시	대포동	대포동제1투	1320	988	332	2	986	697	287	0	0	1	1
강원도	속초시	대포동	대포동제2투	1717	1264	453	5	1259	906	350	0	1	2	0
강원도	고성군	계	계	25669	19177	6492	90	19087	12689	6285	11	9	44	49
강원도	고성군	재외투표	재외투표	55	43	12	1	42	17	25	0	0	0	0
강원도	고성군	국내부재자투표	국내부재자투표	1507	1403	104	21	1382	771	598	4	2	5	2
강원도	고성군	간성읍	소계	5439	4126	1313	19	4107	2624	1456	1	4	15	7
강원도	고성군	간성읍	간성읍제1투	1307	963	344	3	960	607	347	0	2	3	1
강원도	고성군	간성읍	간성읍제2투	2571	1992	579	10	1982	1210	759	1	2	9	1
강원도	고성군	간성읍	간성읍제3투	1056	793	263	6	787	543	236	0	0	3	5
강원도	고성군	간성읍	간성읍제4투	269	214	55	0	214	149	65	0	0	0	0
강원도	고성군	간성읍	간성읍제5투	236	164	72	0	164	115	49	0	0	0	0
강원도	고성군	거진읍	소계	6203	4520	1683	18	4502	3033	1446	1	0	9	13
강원도	고성군	거진읍	거진읍제1투	1526	1143	383	7	1136	783	345	0	0	4	4
강원도	고성군	거진읍	거진읍제2투	1323	965	358	3	962	711	247	0	0	2	2
강원도	고성군	거진읍	거진읍제3투	917	605	312	1	604	394	210	0	0	0	0
강원도	고성군	거진읍	거진읍제4투	345	272	73	0	272	172	96	0	0	3	1
강원도	고성군	거진읍	거진읍제5투	642	461	181	2	459	295	160	1	0	0	3
강원도	고성군	거진읍	거진읍제6투	1450	1074	376	5	1069	678	388	0	0	0	3
강원도	고성군	현내면	소계	2428	1880	548	9	1871	1302	550	1	0	6	12
강원도	고성군	현내면	현내면제1투	814	615	199	5	610	403	199	0	0	3	5
강원도	고성군	현내면	현내면제2투	856	657	199	2	655	471	178	1	0	2	3
강원도	고성군	현내면	현내면제3투	406	329	77	1	328	215	110	0	0	0	3
강원도	고성군	현내면	현내면제4투	352	279	73	1	278	213	63	0	0	1	1
강원도	고성군	죽왕면	소계	3397	2598	799	11	2587	1817	754	2	2	4	8
강원도	고성군	죽왕면	죽왕면제1투	1055	806	249	3	803	564	233	0	2	1	3
강원도	고성군	죽왕면	죽왕면제2투	633	478	155	0	478	348	125	0	0	1	4
강원도	고성군	죽왕면	죽왕면제3투	1212	950	262	5	945	658	283	2	0	2	0
강원도	고성군	죽왕면	죽왕면제4투	497	364	133	3	361	247	113	0	0	0	1
강원도	고성군	토성면	소계	6640	4607	2033	11	4596	3125	1456	2	1	5	7
강원도	고성군	토성면	토성면제1투	2719	1701	1018	5	1696	1144	549	0	0	1	2
강원도	고성군	토성면	토성면제2투	1296	965	331	2	963	712	248	1	0	0	2
강원도	고성군	토성면	토성면제3투	1239	952	287	2	950	633	312	0	1	2	2
강원도	고성군	토성면	토성면제4투	1386	989	397	2	987	636	347	1	0	2	1
강원도	양양군	계	계	23584	18055	5529	99	17956	12007	5869	9	7	19	45
강원도	양양군	재외투표	재외투표	83	60	23	0	60	29	31	0	0	0	0
강원도	양양군	국내부재자투표	국내부재자투표	941	857	84	20	837	442	391	0	2	1	1
강원도	양양군	양양읍	소계	8951	6808	2143	12	6796	4505	2279	3	0	5	4
강원도	양양군	양양읍	양양읍제1투	3405	2562	843	5	2557	1622	929	2	0	2	2
강원도	양양군	양양읍	양양읍제2투	2471	1862	609	3	1859	1227	628	0	0	3	1
강원도	양양군	양양읍	양양읍제3투	1486	1151	335	2	1149	838	309	1	0	0	1
강원도	양양군	양양읍	양양읍제4투	835	651	184	1	650	431	219	0	0	0	0
강원도	양양군	양양읍	양양읍제5투	754	582	172	1	581	387	194	0	0	0	0
강원도	양양군	서면	소계	2715	2085	630	18	2067	1454	598	4	3	1	7
강원도	양양군	서면	서면제1투	1238	939	299	13	926	676	240	2	1	1	6
강원도	양양군	서면	서면제2투	613	478	135	4	474	322	150	1	1	0	0
강원도	양양군	서면	서면제3투	468	353	115	1	352	234	115	1	1	0	1
강원도	양양군	서면	서면제4투	396	315	81	0	315	222	93	0	0	0	0
강원도	양양군	손양면	소계	2067	1608	459	8	1600	1038	556	0	1	1	4
강원도	양양군	손양면	손양면제1투	1216	949	267	5	944	597	343	0	0	1	3
강원도	양양군	손양면	손양면제2투	851	659	192	3	656	441	213	0	1	0	1
강원도	양양군	현북면	소계	2445	1822	623	14	1808	1225	571	1	0	3	8
강원도	양양군	현북면	현북면제1투	1216	881	335	3	878	617	256	0	0	3	2
강원도	양양군	현북면	현북면제2투	448	359	89	7	352	230	118	1	0	0	3
강원도	양양군	현북면	현북면제3투	447	329	118	3	326	211	113	0	0	0	2
강원도	양양군	현북면	현북면제4투	334	253	81	1	252	167	84	0	0	0	1
강원도	양양군	현남면	소계	2811	2130	681	16	2114	1511	580	0	0	5	18
강원도	양양군	현남면	현남면제1투	1093	823	270	7	816	596	214	0	0	1	5
강원도	양양군	현남면	현남면제2투	1083	825	258	7	818	577	230	0	0	2	9
강원도	양양군	현남면	현남면제3투	635	482	153	2	480	338	136	0	0	2	4
강원도	양양군	강현면	소계	3571	2685	886	11	2674	1803	863	1	1	3	3
강원도	양양군	강현면	강현면제1투	1488	1117	371	3	1114	786	323	1	0	2	2
강원도	양양군	강현면	강현면제2투	781	609	172	1	608	384	222	0	1	1	0
강원도	양양군	강현면	강현면제3투	379	252	127	4	248	156	92	0	0	0	0
강원도	양양군	강현면	강현면제4투	923	707	216	3	704	477	226	0	0	0	1
강원도	인제군	계	계	26234	19762	6472	133	19629	12156	7320	11	11	38	93
강원도	인제군	재외투표	재외투표	49	31	18	0	31	7	24	0	0	0	0
강원도	인제군	국내부재자투표	국내부재자투표	1342	1222	120	20	1202	666	519	0	5	3	9
강원도	인제군	인제읍	소계	7280	5462	1818	15	5447	3293	2118	2	1	9	24
강원도	인제군	인제읍	인제읍제1투	1456	1073	383	2	1071	610	456	0	1	3	1
강원도	인제군	인제읍	인제읍제2투	2335	1798	537	5	1793	1017	766	0	0	5	5
강원도	인제군	인제읍	인제읍제3투	2360	1794	566	5	1789	1125	648	2	0	1	13
강원도	인제군	인제읍	인제읍제4투	640	443	197	2	441	321	118	0	0	0	2
강원도	인제군	인제읍	인제읍제5투	489	354	135	1	353	220	130	0	0	0	3
강원도	인제군	남면	소계	3056	2246	810	14	2232	1398	809	1	0	10	14
강원도	인제군	남면	남면제1투	2191	1590	601	9	1581	990	575	0	0	7	9
강원도	인제군	남면	남면제2투	865	656	209	5	651	408	234	1	0	3	5
강원도	인제군	북면	소계	6672	4880	1792	23	4857	2959	1869	5	2	7	15
강원도	인제군	북면	북면제1투	1834	1310	524	3	1307	786	510	1	1	2	7
강원도	인제군	북면	북면제2투	2414	1751	663	13	1738	1057	675	0	0	2	4
강원도	인제군	북면	북면제3투	799	614	185	1	613	374	232	3	1	2	1
강원도	인제군	북면	북면제4투	529	394	135	3	391	273	116	0	0	1	1
강원도	인제군	북면	북면제5투	1096	811	285	3	808	469	336	1	0	0	2
강원도	인제군	기린면	소계	4044	3057	987	52	3005	2023	952	2	2	6	20
강원도	인제군	기린면	기린면제1투	1163	862	301	2	860	577	279	0	0	1	3
강원도	인제군	기린면	기린면제2투	421	310	111	1	309	216	88	0	1	0	4
강원도	인제군	기린면	기린면제3투	358	256	102	2	254	179	74	0	0	0	1
강원도	인제군	기린면	기린면제4투	280	212	68	1	211	139	71	0	0	1	0
강원도	인제군	기린면	기린면제5투	488	370	118	45	325	215	96	2	1	4	7
강원도	인제군	기린면	기린면제6투	1334	1047	287	1	1046	697	344	0	0	0	5
강원도	인제군	서화면	소계	2421	1826	595	5	1821	1146	666	1	0	2	6
강원도	인제군	서화면	서화면제1투	1545	1156	389	4	1152	759	389	0	0	0	4
강원도	인제군	서화면	서화면제2투	573	440	133	1	439	247	190	0	0	1	1
강원도	인제군	서화면	서화면제3투	303	230	73	0	230	140	87	1	0	1	1
강원도	인제군	상남면	소계	1370	1038	332	4	1034	664	363	0	1	1	5
강원도	인제군	상남면	상남면제1투	853	648	205	4	644	405	236	0	0	0	3
강원도	인제군	상남면	상남면제2투	517	390	127	0	390	259	127	0	1	1	2
강원도	홍천군	계	계	57463	42406	15057	236	42170	26715	15201	18	20	75	141
강원도	홍천군	재외투표	재외투표	171	125	46	0	125	51	73	0	0	1	0
강원도	홍천군	국내부재자투표	국내부재자투표	2272	2084	188	46	2038	1080	946	2	3	2	5
강원도	홍천군	홍천읍	소계	26171	19161	7010	61	19100	11681	7342	7	4	25	41
강원도	홍천군	홍천읍	홍천읍제1투	1427	1041	386	3	1038	648	383	0	0	2	5
강원도	홍천군	홍천읍	홍천읍제2투	1178	884	294	2	882	628	249	1	0	1	3
강원도	홍천군	홍천읍	홍천읍제3투	2281	1532	749	4	1528	959	565	1	0	2	1
강원도	홍천군	홍천읍	홍천읍제4투	2301	1667	634	5	1662	1038	617	0	0	3	4
강원도	홍천군	홍천읍	홍천읍제5투	1951	1348	603	3	1345	907	427	2	1	2	6
강원도	홍천군	홍천읍	홍천읍제6투	655	471	184	2	469	324	140	1	0	0	4
강원도	홍천군	홍천읍	홍천읍제7투	3985	2956	1029	7	2949	1632	1310	0	0	1	6
강원도	홍천군	홍천읍	홍천읍제8투	3062	2170	892	6	2164	1354	805	0	0	3	2
강원도	홍천군	홍천읍	홍천읍제9투	3746	2787	959	9	2778	1547	1224	0	2	3	2
강원도	홍천군	홍천읍	홍천읍제10투	1996	1471	525	7	1464	907	551	0	1	2	3
강원도	홍천군	홍천읍	홍천읍제11투	1343	1021	322	5	1016	658	354	1	0	1	2
강원도	홍천군	홍천읍	홍천읍제12투	2246	1813	433	8	1805	1079	717	1	0	5	3
강원도	홍천군	화촌면	소계	4024	2888	1136	19	2869	1870	972	0	1	9	17
강원도	홍천군	화촌면	화촌면제1투	1158	827	331	7	820	526	284	0	0	2	8
강원도	홍천군	화촌면	화촌면제2투	923	656	267	5	651	408	237	0	0	1	5
강원도	홍천군	화촌면	화촌면제3투	649	476	173	3	473	313	158	0	1	0	1
강원도	홍천군	화촌면	화촌면제4투	556	405	151	4	401	290	109	0	0	1	1
강원도	홍천군	화촌면	화촌면제5투	738	524	214	0	524	333	184	0	0	5	2
강원도	홍천군	두촌면	소계	2127	1597	530	10	1587	1117	455	0	0	2	13
강원도	홍천군	두촌면	두촌면제1투	1546	1162	384	8	1154	818	324	0	0	1	11
강원도	홍천군	두촌면	두촌면제2투	581	435	146	2	433	299	131	0	0	1	2
강원도	홍천군	내촌면	소계	2119	1566	553	19	1547	1036	493	4	4	4	6
강원도	홍천군	내촌면	내촌면제1투	984	723	261	5	718	501	211	2	0	0	4
강원도	홍천군	내촌면	내촌면제2투	612	462	150	2	460	294	160	1	2	2	1
강원도	홍천군	내촌면	내촌면제3투	523	381	142	12	369	241	122	1	2	2	1
강원도	홍천군	서석면	소계	3323	2462	861	22	2440	1599	823	1	2	5	10
강원도	홍천군	서석면	서석면제1투	1442	1110	332	8	1102	751	345	1	1	0	4
강원도	홍천군	서석면	서석면제2투	926	670	256	4	666	396	264	0	0	3	3
강원도	홍천군	서석면	서석면제3투	467	338	129	5	333	201	129	0	0	1	2
강원도	홍천군	서석면	서석면제4투	488	344	144	5	339	251	85	0	1	1	1
강원도	홍천군	동면	소계	3230	2514	716	17	2497	1525	949	0	2	10	11
강원도	홍천군	동면	동면제1투	1661	1301	360	7	1294	826	457	0	1	7	3
강원도	홍천군	동면	동면제2투	543	417	126	6	411	251	153	0	1	2	4
강원도	홍천군	동면	동면제3투	658	503	155	1	502	267	234	0	0	0	1
강원도	홍천군	동면	동면제4투	368	293	75	3	290	181	105	0	0	1	3
강원도	홍천군	남면	소계	4571	3268	1303	13	3255	2161	1073	1	0	5	15
강원도	홍천군	남면	남면제1투	1515	1049	466	2	1047	722	318	1	0	0	6
강원도	홍천군	남면	남면제2투	1175	844	331	5	839	560	275	0	0	2	2
강원도	홍천군	남면	남면제3투	830	587	243	2	585	359	220	0	0	2	4
강원도	홍천군	남면	남면제4투	1051	788	263	4	784	520	260	0	0	1	3
강원도	홍천군	서면	소계	3238	2243	995	11	2232	1602	616	1	0	6	7
강원도	홍천군	서면	서면제1투	1145	799	346	6	793	578	211	0	0	3	1
강원도	홍천군	서면	서면제2투	541	344	197	1	343	231	108	0	0	1	3
강원도	홍천군	서면	서면제3투	748	521	227	1	520	379	137	0	0	2	2
강원도	홍천군	서면	서면제4투	804	579	225	3	576	414	160	1	0	0	1
강원도	홍천군	북방면	소계	3337	2460	877	13	2447	1660	771	2	3	3	8
강원도	홍천군	북방면	북방면제1투	1959	1435	524	5	1430	999	424	1	1	3	2
강원도	홍천군	북방면	북방면제2투	822	607	215	5	602	383	213	1	1	0	4
강원도	홍천군	북방면	북방면제3투	556	418	138	3	415	278	134	0	1	0	2
강원도	홍천군	내면	소계	2880	2038	842	5	2033	1333	688	0	1	3	8
강원도	홍천군	내면	내면제1투	1574	1117	457	3	1114	702	406	0	1	2	3
강원도	홍천군	내면	내면제2투	724	493	231	2	491	336	154	0	0	0	1
강원도	홍천군	내면	내면제3투	582	428	154	0	428	295	128	0	0	1	4
강원도	횡성군	계	계	37340	27723	9617	147	27576	17876	9502	13	19	50	116
강원도	횡성군	재외투표	재외투표	96	70	26	0	70	27	42	0	0	0	1
강원도	횡성군	국내부재자투표	국내부재자투표	1122	1029	93	27	1002	495	496	1	2	3	5
강원도	횡성군	횡성읍	소계	15107	11259	3848	38	11221	7229	3936	3	5	14	34
강원도	횡성군	횡성읍	횡성읍제1투	3720	2686	1034	9	2677	1787	876	0	0	3	11
강원도	횡성군	횡성읍	횡성읍제2투	702	542	160	4	538	355	176	1	0	1	5
강원도	횡성군	횡성읍	횡성읍제3투	585	418	167	1	417	300	114	0	0	1	2
강원도	횡성군	횡성읍	횡성읍제4투	1142	869	273	2	867	609	254	0	0	2	2
강원도	횡성군	횡성읍	횡성읍제5투	3807	2777	1030	10	2767	1770	987	1	2	3	4
강원도	횡성군	횡성읍	횡성읍제6투	2420	1855	565	5	1850	1110	731	1	2	2	4
강원도	횡성군	횡성읍	횡성읍제7투	2731	2112	619	7	2105	1298	798	0	1	2	6
강원도	횡성군	우천면	소계	3703	2735	968	20	2715	1760	937	2	2	3	11
강원도	횡성군	우천면	우천면제1투	1432	1074	358	8	1066	673	386	1	1	2	3
강원도	횡성군	우천면	우천면제2투	1249	917	332	9	908	639	262	0	0	1	6
강원도	횡성군	우천면	우천면제3투	1022	744	278	3	741	448	289	1	1	0	2
강원도	횡성군	안흥면	소계	2197	1634	563	2	1632	1109	513	0	1	2	7
강원도	횡성군	안흥면	안흥면제1투	1809	1334	475	1	1333	905	420	0	1	1	6
강원도	횡성군	안흥면	안흥면제2투	388	300	88	1	299	204	93	0	0	1	1
강원도	횡성군	둔내면	소계	4606	3305	1301	18	3287	2147	1111	2	0	5	22
강원도	횡성군	둔내면	둔내면제1투	1740	1257	483	7	1250	830	410	0	0	2	8
강원도	횡성군	둔내면	둔내면제2투	484	342	142	2	340	228	109	0	0	0	3
강원도	횡성군	둔내면	둔내면제3투	1927	1355	572	6	1349	848	490	1	0	2	8
강원도	횡성군	둔내면	둔내면제4투	455	351	104	3	348	241	102	1	0	1	3
강원도	횡성군	갑천면	소계	1969	1424	545	9	1415	1037	366	3	0	3	6
강원도	횡성군	갑천면	갑천면제1투	1264	910	354	5	905	678	216	3	0	3	5
강원도	횡성군	갑천면	갑천면제2투	705	514	191	4	510	359	150	0	0	0	1
강원도	횡성군	청일면	소계	2073	1472	601	8	1464	1010	442	1	1	5	5
강원도	횡성군	청일면	청일면제1투	610	455	155	2	453	307	143	0	0	2	1
강원도	횡성군	청일면	청일면제2투	643	435	208	2	433	292	138	0	0	1	2
강원도	횡성군	청일면	청일면제3투	820	582	238	4	578	411	161	1	1	2	2
강원도	횡성군	공근면	소계	3189	2353	836	11	2342	1524	799	0	5	5	9
강원도	횡성군	공근면	공근면제1투	2139	1556	583	8	1548	1015	525	0	3	1	4
강원도	횡성군	공근면	공근면제2투	1050	797	253	3	794	509	274	0	2	4	5
강원도	횡성군	서원면	소계	1926	1438	488	10	1428	870	539	1	2	7	9
강원도	횡성군	서원면	서원면제1투	1217	900	317	8	892	564	317	0	1	3	7
강원도	횡성군	서원면	서원면제2투	709	538	171	2	536	306	222	1	1	4	2
강원도	횡성군	강림면	소계	1352	1004	348	4	1000	668	321	0	1	3	7
강원도	횡성군	강림면	강림면투표소	1352	1004	348	4	1000	668	321	0	1	3	7
강원도	영월군	계	계	33827	24853	8974	124	24729	15515	9021	12	16	55	110
강원도	영월군	재외투표	재외투표	75	53	22	0	53	20	32	0	0	1	0
강원도	영월군	국내부재자투표	국내부재자투표	1382	1252	130	23	1229	543	669	2	5	3	7
강원도	영월군	영월읍	소계	16697	12052	4645	38	12014	7173	4787	6	3	15	30
강원도	영월군	영월읍	영월읍제1투	2277	1583	694	4	1579	1014	561	1	0	0	3
강원도	영월군	영월읍	영월읍제2투	2117	1520	597	4	1516	918	590	1	1	4	2
강원도	영월군	영월읍	영월읍제3투	3853	2765	1088	3	2762	1455	1291	2	2	3	9
강원도	영월군	영월읍	영월읍제4투	1949	1423	526	6	1417	838	577	0	0	1	1
강원도	영월군	영월읍	영월읍제5투	1666	1213	453	9	1204	712	486	1	0	1	4
강원도	영월군	영월읍	영월읍제6투	416	278	138	3	275	196	75	0	0	1	3
강원도	영월군	영월읍	영월읍제7투	379	262	117	1	261	169	88	0	0	2	2
강원도	영월군	영월읍	영월읍제8투	2318	1709	609	6	1703	1036	663	1	0	1	2
강원도	영월군	영월읍	영월읍제9투	1722	1299	423	2	1297	835	456	0	0	2	4
강원도	영월군	상동읍	소계	1136	845	291	2	843	612	223	1	1	2	4
강원도	영월군	상동읍	상동읍제1투	361	247	114	0	247	180	65	0	0	1	1
강원도	영월군	상동읍	상동읍제2투	381	306	75	2	304	233	67	1	1	0	2
강원도	영월군	상동읍	상동읍제3투	394	292	102	0	292	199	91	0	0	1	1
강원도	영월군	중동면	소계	1382	977	405	6	971	693	266	1	0	2	9
강원도	영월군	중동면	중동면제1투	807	562	245	2	560	393	160	1	0	0	6
강원도	영월군	중동면	중동면제2투	575	415	160	4	411	300	106	0	0	2	3
강원도	영월군	김삿갓면	소계	1504	1111	393	12	1099	708	374	0	0	2	15
강원도	영월군	김삿갓면	김삿갓면제1투	858	620	238	7	613	379	227	0	0	1	6
강원도	영월군	김삿갓면	김삿갓면제2투	646	491	155	5	486	329	147	0	0	1	9
강원도	영월군	북면	소계	1999	1443	556	7	1436	989	433	0	1	0	13
강원도	영월군	북면	북면제1투	841	598	243	2	596	423	168	0	0	0	5
강원도	영월군	북면	북면제2투	699	510	189	3	507	347	153	0	1	0	6
강원도	영월군	북면	북면제3투	459	335	124	2	333	219	112	0	0	0	2
강원도	영월군	남면	소계	1998	1474	524	8	1466	922	523	0	2	11	8
강원도	영월군	남면	남면제1투	1278	931	347	6	925	594	319	0	1	7	4
강원도	영월군	남면	남면제2투	480	362	118	1	361	221	134	0	0	3	3
강원도	영월군	남면	남면제3투	240	181	59	1	180	107	70	0	1	1	1
강원도	영월군	한반도면	소계	2760	2090	670	11	2079	1450	615	1	0	8	5
강원도	영월군	한반도면	한반도면제1투	936	706	230	4	702	463	235	0	0	2	2
강원도	영월군	한반도면	한반도면제2투	1824	1384	440	7	1377	987	380	1	0	6	3
강원도	영월군	주천면	소계	3348	2438	910	13	2425	1640	760	1	4	7	13
강원도	영월군	주천면	주천면제1투	2166	1561	605	9	1552	1069	470	0	3	3	7
강원도	영월군	주천면	주천면제2투	346	250	96	1	249	183	64	0	1	1	0
강원도	영월군	주천면	주천면제3투	836	627	209	3	624	388	226	1	0	3	6
강원도	영월군	수주면	소계	1546	1118	428	4	1114	765	339	0	0	4	6
강원도	영월군	수주면	수주면제1투	920	669	251	3	666	441	219	0	0	2	4
강원도	영월군	수주면	수주면제2투	626	449	177	1	448	324	120	0	0	2	2
강원도	평창군	계	계	36478	26084	10394	130	25954	16406	9381	6	8	53	100
강원도	평창군	재외투표	재외투표	103	69	34	1	68	32	36	0	0	0	0
강원도	평창군	국내부재자투표	국내부재자투표	1279	1168	111	20	1148	528	611	2	1	3	3
강원도	평창군	평창읍	소계	7000	5134	1866	23	5111	3084	1990	1	2	14	20
강원도	평창군	평창읍	평창읍제1투	1871	1373	498	6	1367	831	530	0	2	0	4
강원도	평창군	평창읍	평창읍제2투	2680	1993	687	8	1985	1117	858	1	0	5	4
강원도	평창군	평창읍	평창읍제3투	319	230	89	1	229	162	63	0	0	2	2
강원도	평창군	평창읍	평창읍제4투	522	406	116	2	404	247	152	0	0	2	3
강원도	평창군	평창읍	평창읍제5투	557	378	179	3	375	262	113	0	0	0	0
강원도	평창군	평창읍	평창읍제6투	580	415	165	1	414	269	140	0	0	2	3
강원도	평창군	평창읍	평창읍제7투	471	339	132	2	337	196	134	0	0	3	4
강원도	평창군	미탄면	소계	1537	1093	444	8	1085	692	384	0	0	1	8
강원도	평창군	미탄면	미탄면제1투	1347	970	377	7	963	616	339	0	0	1	7
강원도	평창군	미탄면	미탄면제2투	190	123	67	1	122	76	45	0	0	0	1
강원도	평창군	방림면	소계	2126	1538	588	1	1537	998	525	0	2	4	8
강원도	평창군	방림면	방림면제1투	782	576	206	1	575	376	196	0	0	0	3
강원도	평창군	방림면	방림면제2투	440	326	114	0	326	210	112	0	0	1	3
강원도	평창군	방림면	방림면제3투	904	636	268	0	636	412	217	0	2	3	2
강원도	평창군	대화면	소계	4653	3310	1343	20	3290	2054	1203	0	0	8	25
강원도	평창군	대화면	대화면제1투	2306	1667	639	9	1658	1004	642	0	0	2	10
강원도	평창군	대화면	대화면제2투	822	543	279	2	541	339	197	0	0	0	5
강원도	평창군	대화면	대화면제3투	1197	863	334	8	855	531	314	0	0	5	5
강원도	평창군	대화면	대화면제4투	328	237	91	1	236	180	50	0	0	1	5
강원도	평창군	봉평면	소계	4497	3121	1376	11	3110	2003	1093	1	1	4	8
강원도	평창군	봉평면	봉평면제1투	2086	1561	525	7	1554	1033	512	1	1	4	3
강원도	평창군	봉평면	봉평면제2투	916	605	311	4	601	375	224	0	0	0	2
강원도	평창군	봉평면	봉평면제3투	1495	955	540	0	955	595	357	0	0	0	3
강원도	평창군	용평면	소계	2524	1804	720	16	1788	1204	574	0	0	4	6
강원도	평창군	용평면	용평면제1투	579	408	171	3	405	257	145	0	0	2	1
강원도	평창군	용평면	용평면제2투	654	470	184	7	463	315	146	0	0	0	2
강원도	평창군	용평면	용평면제3투	1291	926	365	6	920	632	283	0	0	2	3
강원도	평창군	진부면	소계	7707	5464	2243	17	5447	3528	1895	1	2	8	13
강원도	평창군	진부면	진부면제1투	1505	1068	437	1	1067	686	378	0	0	1	2
강원도	평창군	진부면	진부면제2투	1942	1404	538	4	1400	869	526	0	1	1	3
강원도	평창군	진부면	진부면제3투	2365	1663	702	4	1659	1079	572	0	1	4	3
강원도	평창군	진부면	진부면제4투	488	343	145	1	342	244	95	0	0	1	2
강원도	평창군	진부면	진부면제5투	574	399	175	3	396	276	118	1	0	0	1
강원도	평창군	진부면	진부면제6투	474	341	133	2	339	208	129	0	0	1	1
강원도	평창군	진부면	진부면제7투	359	246	113	2	244	166	77	0	0	0	1
강원도	평창군	대관령면	소계	5052	3383	1669	13	3370	2283	1070	1	0	7	9
강원도	평창군	대관령면	대관령면제1투	2196	1456	740	3	1453	1028	417	1	0	3	4
강원도	평창군	대관령면	대관령면제2투	2395	1602	793	8	1594	1045	546	0	0	3	0
강원도	평창군	대관령면	대관령면제3투	461	325	136	2	323	210	107	0	0	1	5
강원도	화천군	계	계	20345	15228	5117	126	15102	9838	5139	20	11	45	49
강원도	화천군	재외투표	재외투표	44	26	18	0	26	14	12	0	0	0	0
강원도	화천군	국내부재자투표	국내부재자투표	1471	1357	114	37	1320	740	555	6	4	8	7
강원도	화천군	화천읍	소계	6333	4645	1688	20	4625	3073	1524	3	3	11	11
강원도	화천군	화천읍	화천읍제1투	2208	1636	572	11	1625	1094	522	0	0	4	5
강원도	화천군	화천읍	화천읍제2투	2551	1872	679	6	1866	1202	650	1	3	7	3
강원도	화천군	화천읍	화천읍제3투	680	498	182	3	495	372	119	1	0	0	3
강원도	화천군	화천읍	화천읍제4투	894	639	255	0	639	405	233	1	0	0	0
강원도	화천군	간동면	소계	2215	1668	547	10	1658	1084	559	1	0	7	7
강원도	화천군	간동면	간동면제1투	814	604	210	3	601	392	200	0	0	5	4
강원도	화천군	간동면	간동면제2투	658	495	163	3	492	328	163	0	0	0	1
강원도	화천군	간동면	간동면제3투	556	427	129	3	424	261	159	1	0	2	1
강원도	화천군	간동면	간동면제4투	187	142	45	1	141	103	37	0	0	0	1
강원도	화천군	하남면	소계	1945	1457	488	9	1448	943	494	1	0	4	6
강원도	화천군	하남면	하남면제1투	935	696	239	3	693	448	238	0	0	2	5
강원도	화천군	하남면	하남면제2투	704	524	180	6	518	308	207	1	0	1	1
강원도	화천군	하남면	하남면제3투	306	237	69	0	237	187	49	0	0	1	0
강원도	화천군	상서면	소계	3340	2418	922	13	2405	1594	795	2	0	4	10
강원도	화천군	상서면	상서면제1투	579	426	153	1	425	287	136	0	0	0	2
강원도	화천군	상서면	상서면제2투	399	293	106	3	290	185	102	0	0	0	3
강원도	화천군	상서면	상서면제3투	427	319	108	0	319	220	99	0	0	0	0
강원도	화천군	상서면	상서면제4투	927	649	278	4	645	432	207	1	0	2	3
강원도	화천군	상서면	상서면제5투	472	344	128	2	342	204	135	1	0	1	1
강원도	화천군	상서면	상서면제6투	536	387	149	3	384	266	116	0	0	1	1
강원도	화천군	사내면	소계	4997	3657	1340	37	3620	2390	1200	7	4	11	8
강원도	화천군	사내면	사내면제1투	2989	2176	813	24	2152	1394	740	4	3	7	4
강원도	화천군	사내면	사내면제2투	707	521	186	2	519	329	187	1	0	2	0
강원도	화천군	사내면	사내면제3투	575	446	129	4	442	325	113	1	0	1	2
강원도	화천군	사내면	사내면제4투	726	514	212	7	507	342	160	1	1	1	2
강원도	양구군	계	계	18033	13665	4368	71	13594	8547	4957	3	13	33	41
강원도	양구군	재외투표	재외투표	36	23	13	0	23	9	14	0	0	0	0
강원도	양구군	국내부재자투표	국내부재자투표	980	894	86	16	878	494	372	0	4	3	5
강원도	양구군	양구읍	소계	9483	6989	2494	25	6964	4412	2515	1	3	17	16
강원도	양구군	양구읍	양구읍제1투	580	425	155	2	423	289	133	0	0	0	1
강원도	양구군	양구읍	양구읍제2투	770	586	184	6	580	339	236	0	2	1	2
강원도	양구군	양구읍	양구읍제3투	1624	1244	380	2	1242	788	450	1	0	2	1
강원도	양구군	양구읍	양구읍제4투	1465	1077	388	1	1076	671	399	0	0	4	2
강원도	양구군	양구읍	양구읍제5투	1851	1310	541	6	1304	846	449	0	1	4	4
강원도	양구군	양구읍	양구읍제6투	2817	2051	766	6	2045	1266	769	0	0	6	4
강원도	양구군	양구읍	양구읍제7투	144	123	21	0	123	83	39	0	0	0	1
강원도	양구군	양구읍	양구읍제8투	232	173	59	2	171	130	40	0	0	0	1
강원도	양구군	남면	소계	3164	2414	750	11	2403	1569	818	1	3	8	4
강원도	양구군	남면	남면제1투	463	362	101	3	359	236	123	0	0	0	0
강원도	양구군	남면	남면제2투	1508	1120	388	2	1118	719	390	0	2	5	2
강원도	양구군	남면	남면제3투	794	617	177	5	612	412	195	1	1	1	2
강원도	양구군	남면	남면제4투	399	315	84	1	314	202	110	0	0	2	0
강원도	양구군	동면	소계	1902	1471	431	10	1461	941	510	0	1	3	6
강원도	양구군	동면	동면제1투	569	435	134	1	434	298	133	0	0	1	2
강원도	양구군	동면	동면제2투	942	727	215	7	720	464	249	0	1	2	4
강원도	양구군	동면	동면제3투	391	309	82	2	307	179	128	0	0	0	0
강원도	양구군	방산면	소계	1298	1014	284	4	1010	672	331	0	1	0	6
강원도	양구군	방산면	방산면제1투	407	313	94	0	313	218	92	0	1	0	2
강원도	양구군	방산면	방산면제2투	419	343	76	2	341	206	132	0	0	0	3
강원도	양구군	방산면	방산면제3투	472	358	114	2	356	248	107	0	0	0	1
강원도	양구군	해안면	소계	1170	860	310	5	855	450	397	1	1	2	4
강원도	양구군	해안면	해안면투표소	1170	860	310	5	855	450	397	1	1	2	4
강원도	철원군	계	계	38508	28063	10445	103	27960	18289	9536	10	15	53	57
강원도	철원군	재외투표	재외투표	102	67	35	0	67	33	34	0	0	0	0
강원도	철원군	국내부재자투표	국내부재자투표	1765	1604	161	20	1584	844	726	1	5	5	3
강원도	철원군	철원읍	소계	4207	3073	1134	11	3062	1972	1083	1	2	1	3
강원도	철원군	철원읍	철원읍제1투	1034	738	296	1	737	482	253	0	0	1	1
강원도	철원군	철원읍	철원읍제2투	1269	953	316	6	947	603	341	1	1	0	1
강원도	철원군	철원읍	철원읍제3투	240	177	63	1	176	115	61	0	0	0	0
강원도	철원군	철원읍	철원읍제4투	508	368	140	1	367	201	165	0	0	0	1
강원도	철원군	철원읍	철원읍제5투	1156	837	319	2	835	571	263	0	1	0	0
강원도	철원군	김화읍	소계	2784	2145	639	5	2140	1488	639	0	2	6	5
강원도	철원군	김화읍	김화읍제1투	709	523	186	2	521	364	153	0	1	2	1
강원도	철원군	김화읍	김화읍제2투	223	182	41	1	181	117	64	0	0	0	0
강원도	철원군	김화읍	김화읍제3투	1489	1160	329	1	1159	828	323	0	0	4	4
강원도	철원군	김화읍	김화읍제4투	363	280	83	1	279	179	99	0	1	0	0
강원도	철원군	갈말읍	소계	10043	7158	2885	25	7133	4729	2366	2	2	13	21
강원도	철원군	갈말읍	갈말읍제1투	1289	843	446	1	842	542	295	0	0	2	3
강원도	철원군	갈말읍	갈말읍제2투	1209	915	294	4	911	578	328	0	2	2	1
강원도	철원군	갈말읍	갈말읍제3투	1327	737	590	12	725	500	218	1	0	1	5
강원도	철원군	갈말읍	갈말읍제4투	964	705	259	0	705	479	223	0	0	1	2
강원도	철원군	갈말읍	갈말읍제5투	898	682	216	3	679	481	195	0	0	1	2
강원도	철원군	갈말읍	갈말읍제6투	715	513	202	0	513	408	104	0	0	0	1
강원도	철원군	갈말읍	갈말읍제7투	2196	1711	485	2	1709	1036	668	0	0	3	2
강원도	철원군	갈말읍	갈말읍제8투	1266	906	360	3	903	580	317	1	0	1	4
강원도	철원군	갈말읍	갈말읍제9투	179	146	33	0	146	125	18	0	0	2	1
강원도	철원군	동송읍	소계	12886	9056	3830	28	9028	5855	3132	5	3	18	15
강원도	철원군	동송읍	동송읍제1투	3230	2289	941	9	2280	1452	817	2	0	3	6
강원도	철원군	동송읍	동송읍제2투	1452	1030	422	3	1027	676	347	1	0	3	0
강원도	철원군	동송읍	동송읍제3투	1893	1339	554	5	1334	820	506	2	1	3	2
강원도	철원군	동송읍	동송읍제4투	1502	1065	437	0	1065	689	374	0	1	1	0
강원도	철원군	동송읍	동송읍제5투	496	350	146	1	349	222	127	0	0	0	0
강원도	철원군	동송읍	동송읍제6투	1042	771	271	2	769	509	257	0	0	1	2
강원도	철원군	동송읍	동송읍제7투	645	448	197	4	444	330	112	0	0	1	1
강원도	철원군	동송읍	동송읍제8투	1592	1016	576	1	1015	661	351	0	1	2	0
강원도	철원군	동송읍	동송읍제9투	692	485	207	2	483	319	158	0	0	3	3
강원도	철원군	동송읍	동송읍제10투	342	263	79	1	262	177	83	0	0	1	1
강원도	철원군	서면	소계	4848	3569	1279	10	3559	2439	1105	1	1	5	8
강원도	철원군	서면	서면제1투	1651	1267	384	4	1263	876	381	0	0	1	5
강원도	철원군	서면	서면제2투	1501	1081	420	3	1078	710	361	0	1	3	3
강원도	철원군	서면	서면제3투	1696	1221	475	3	1218	853	363	1	0	1	0
강원도	철원군	근남면	소계	1761	1303	458	4	1299	870	422	0	0	5	2
강원도	철원군	근남면	근남면제1투	327	233	94	0	233	163	69	0	0	1	0
강원도	철원군	근남면	근남면제2투	962	709	253	3	706	453	248	0	0	3	2
강원도	철원군	근남면	근남면제3투	472	361	111	1	360	254	105	0	0	1	0
강원도	철원군	근북면	소계	112	88	24	0	88	59	29	0	0	0	0
강원도	철원군	근북면	근북면투표소	112	88	24	0	88	59	29	0	0	0	0
충청북도	청주시상당구	계	계	185497	141798	43699	448	141350	76695	64194	49	71	173	168
충청북도	청주시상당구	재외투표	재외투표	581	406	175	1	405	165	238	0	0	1	1
충청북도	청주시상당구	국내부재자투표	국내부재자투표	5361	4978	383	76	4902	2338	2520	7	7	6	24
충청북도	청주시상당구	중앙동	소계	5308	3876	1432	7	3869	2406	1454	0	2	4	3
충청북도	청주시상당구	중앙동	중앙동제1투	2261	1644	617	2	1642	1006	634	0	0	1	1
충청북도	청주시상당구	중앙동	중앙동제2투	3047	2232	815	5	2227	1400	820	0	2	3	2
충청북도	청주시상당구	성안동	소계	6306	4474	1832	11	4463	2921	1523	1	2	9	7
충청북도	청주시상당구	성안동	성안동제1투	3203	2186	1017	4	2182	1404	769	1	0	5	3
충청북도	청주시상당구	성안동	성안동제2투	3103	2288	815	7	2281	1517	754	0	2	4	4
충청북도	청주시상당구	우암동	소계	11406	8309	3097	20	8289	4969	3300	1	4	6	9
충청북도	청주시상당구	우암동	우암동제1투	2763	1906	857	3	1903	1143	754	1	0	2	3
충청북도	청주시상당구	우암동	우암동제2투	2511	1893	618	5	1888	1092	792	0	1	0	3
충청북도	청주시상당구	우암동	우암동제3투	2731	2028	703	4	2024	1261	757	0	3	2	1
충청북도	청주시상당구	우암동	우암동제4투	3401	2482	919	8	2474	1473	997	0	0	2	2
충청북도	청주시상당구	내덕제1동	소계	9103	6824	2279	19	6805	4178	2602	5	2	11	7
충청북도	청주시상당구	내덕제1동	내덕제1동제1투	3143	2256	887	9	2247	1377	867	0	0	2	1
충청북도	청주시상당구	내덕제1동	내덕제1동제2투	2992	2292	700	6	2286	1412	859	4	2	3	6
충청북도	청주시상당구	내덕제1동	내덕제1동제3투	2968	2276	692	4	2272	1389	876	1	0	6	0
충청북도	청주시상당구	내덕제2동	소계	10310	7611	2699	23	7588	4366	3203	0	3	8	8
충청북도	청주시상당구	내덕제2동	내덕제2동제1투	3414	2443	971	8	2435	1456	975	0	1	1	2
충청북도	청주시상당구	내덕제2동	내덕제2동제2투	3184	2289	895	9	2280	1260	1010	0	2	6	2
충청북도	청주시상당구	내덕제2동	내덕제2동제3투	3712	2879	833	6	2873	1650	1218	0	0	1	4
충청북도	청주시상당구	율량·사천동	소계	32090	24872	7218	49	24823	12842	11915	4	9	34	19
충청북도	청주시상당구	율량·사천동	율량·사천동제1투	3686	2804	882	8	2796	1472	1316	1	1	2	4
충청북도	청주시상당구	율량·사천동	율량·사천동제2투	3610	2722	888	6	2716	1390	1320	1	0	4	1
충청북도	청주시상당구	율량·사천동	율량·사천동제3투	3954	3103	851	4	3099	1641	1453	0	2	2	1
충청북도	청주시상당구	율량·사천동	율량·사천동제4투	4685	3715	970	5	3710	1944	1757	1	0	6	2
충청북도	청주시상당구	율량·사천동	율량·사천동제5투	4150	3070	1080	7	3063	1565	1488	0	1	6	3
충청북도	청주시상당구	율량·사천동	율량·사천동제6투	4626	3735	891	7	3728	1800	1912	0	4	7	5
충청북도	청주시상당구	율량·사천동	율량·사천동제7투	4302	3303	999	5	3298	1682	1609	0	1	4	2
충청북도	청주시상당구	율량·사천동	율량·사천동제8투	3077	2420	657	7	2413	1348	1060	1	0	3	1
충청북도	청주시상당구	탑·대성동	소계	9060	6803	2257	17	6786	4054	2709	2	3	12	6
충청북도	청주시상당구	탑·대성동	탑·대성동제1투	3202	2409	793	5	2404	1526	873	0	0	2	3
충청북도	청주시상당구	탑·대성동	탑·대성동제2투	3212	2496	716	4	2492	1403	1079	2	0	6	2
충청북도	청주시상당구	탑·대성동	탑·대성동제3투	2646	1898	748	8	1890	1125	757	0	3	4	1
충청북도	청주시상당구	영운동	소계	10015	7437	2578	20	7417	4267	3122	4	3	7	14
충청북도	청주시상당구	영운동	영운동제1투	3433	2532	901	8	2524	1549	964	3	2	3	3
충청북도	청주시상당구	영운동	영운동제2투	3518	2559	959	5	2554	1363	1179	1	1	2	8
충청북도	청주시상당구	영운동	영운동제3투	3064	2346	718	7	2339	1355	979	0	0	2	3
충청북도	청주시상당구	금천동	소계	24590	19273	5317	46	19227	9950	9231	3	7	13	23
충청북도	청주시상당구	금천동	금천동제1투	2877	2054	823	5	2049	1311	732	1	1	2	2
충청북도	청주시상당구	금천동	금천동제2투	2655	1979	676	6	1973	1072	891	2	1	2	5
충청북도	청주시상당구	금천동	금천동제3투	3400	2764	636	8	2756	1522	1229	0	0	2	3
충청북도	청주시상당구	금천동	금천동제4투	2772	2099	673	10	2089	1167	918	0	0	0	4
충청북도	청주시상당구	금천동	금천동제5투	3055	2417	638	5	2412	1267	1139	0	3	2	1
충청북도	청주시상당구	금천동	금천동제6투	4028	3120	908	5	3115	1441	1668	0	2	1	3
충청북도	청주시상당구	금천동	금천동제7투	2964	2431	533	2	2429	1013	1409	0	0	2	5
충청북도	청주시상당구	금천동	금천동제8투	2839	2409	430	5	2404	1157	1245	0	0	2	0
충청북도	청주시상당구	용담·명암·산성동	소계	8510	6749	1761	13	6736	3630	3091	4	2	6	3
충청북도	청주시상당구	용담·명암·산성동	용담·명암·산성동제1투	4012	3059	953	7	3052	1743	1302	3	1	1	2
충청북도	청주시상당구	용담·명암·산성동	용담·명암·산성동제2투	4498	3690	808	6	3684	1887	1789	1	1	5	1
충청북도	청주시상당구	용암제1동	소계	30276	22793	7483	62	22731	11685	10976	5	13	34	18
충청북도	청주시상당구	용암제1동	용암제1동제1투	4210	3181	1029	4	3177	1790	1380	1	2	4	0
충청북도	청주시상당구	용암제1동	용암제1동제2투	5287	4146	1141	10	4136	2210	1910	0	3	10	3
충청북도	청주시상당구	용암제1동	용암제1동제3투	4047	2973	1074	8	2965	1528	1425	2	5	3	2
충청북도	청주시상당구	용암제1동	용암제1동제4투	3509	2584	925	20	2564	1516	1040	2	1	4	1
충청북도	청주시상당구	용암제1동	용암제1동제5투	4117	3173	944	5	3168	1400	1759	0	1	3	5
충청북도	청주시상당구	용암제1동	용암제1동제6투	5171	3514	1657	9	3505	1727	1769	0	0	5	4
충청북도	청주시상당구	용암제1동	용암제1동제7투	3935	3222	713	6	3216	1514	1693	0	1	5	3
충청북도	청주시상당구	용암제2동	소계	19330	15003	4327	73	14930	7487	7381	12	14	18	18
충청북도	청주시상당구	용암제2동	용암제2동제1투	3660	2618	1042	5	2613	1316	1287	1	3	3	3
충청북도	청주시상당구	용암제2동	용암제2동제2투	4254	3478	776	10	3468	1713	1744	2	0	5	4
충청북도	청주시상당구	용암제2동	용암제2동제3투	4022	3294	728	10	3284	1594	1678	1	3	4	4
충청북도	청주시상당구	용암제2동	용암제2동제4투	3108	2269	839	38	2231	1335	877	8	5	1	5
충청북도	청주시상당구	용암제2동	용암제2동제5투	4286	3344	942	10	3334	1529	1795	0	3	5	2
충청북도	청주시상당구	오근장동	소계	3251	2390	861	11	2379	1437	929	1	0	4	8
충청북도	청주시상당구	오근장동	오근장동투표소	3251	2390	861	11	2379	1437	929	1	0	4	8
충청북도	청주시흥덕구	계	계	322399	245334	77065	639	244695	124308	119523	90	129	348	297
충청북도	청주시흥덕구	재외투표	재외투표	1043	735	308	3	732	246	480	0	3	3	0
충청북도	청주시흥덕구	국내부재자투표	국내부재자투표	8967	8345	622	101	8244	3810	4356	14	11	21	32
충청북도	청주시흥덕구	사직제1동	소계	8489	6285	2204	23	6262	3845	2391	2	7	7	10
충청북도	청주시흥덕구	사직제1동	사직제1동제1투	2711	1869	842	7	1862	1186	667	1	4	2	2
충청북도	청주시흥덕구	사직제1동	사직제1동제2투	2531	1884	647	4	1880	1166	707	1	0	1	5
충청북도	청주시흥덕구	사직제1동	사직제1동제3투	3247	2532	715	12	2520	1493	1017	0	3	4	3
충청북도	청주시흥덕구	사직제2동	소계	12446	10038	2408	26	10012	5292	4685	3	8	14	10
충청북도	청주시흥덕구	사직제2동	사직제2동제1투	1994	1448	546	5	1443	885	555	0	0	1	2
충청북도	청주시흥덕구	사직제2동	사직제2동제2투	2782	2032	750	9	2023	1146	866	1	1	4	5
충청북도	청주시흥덕구	사직제2동	사직제2동제3투	3756	3201	555	8	3193	1639	1544	0	2	7	1
충청북도	청주시흥덕구	사직제2동	사직제2동제4투	3914	3357	557	4	3353	1622	1720	2	5	2	2
충청북도	청주시흥덕구	사창동	소계	13640	9795	3845	18	9777	5362	4386	2	7	10	10
충청북도	청주시흥덕구	사창동	사창동제1투	3494	2291	1203	3	2288	1163	1117	0	2	5	1
충청북도	청주시흥덕구	사창동	사창동제2투	3774	2981	793	2	2979	1599	1375	0	1	3	1
충청북도	청주시흥덕구	사창동	사창동제3투	3939	2779	1160	7	2772	1617	1144	1	3	1	6
충청북도	청주시흥덕구	사창동	사창동제4투	2433	1744	689	6	1738	983	750	1	1	1	2
충청북도	청주시흥덕구	모충동	소계	15849	11358	4491	22	11336	6410	4894	4	7	10	11
충청북도	청주시흥덕구	모충동	모충동제1투	4447	3117	1330	6	3111	1720	1380	0	3	2	6
충청북도	청주시흥덕구	모충동	모충동제2투	3114	2157	957	4	2153	1240	908	1	1	1	2
충청북도	청주시흥덕구	모충동	모충동제3투	4622	3449	1173	6	3443	1876	1558	2	3	3	1
충청북도	청주시흥덕구	모충동	모충동제4투	3666	2635	1031	6	2629	1574	1048	1	0	4	2
충청북도	청주시흥덕구	운천·신봉동	소계	16468	12378	4090	62	12316	6607	5656	5	7	20	21
충청북도	청주시흥덕구	운천·신봉동	운천·신봉동제1투	2950	2093	857	6	2087	1199	883	0	0	2	3
충청북도	청주시흥덕구	운천·신봉동	운천·신봉동제2투	3511	2647	864	5	2642	1393	1241	1	2	4	1
충청북도	청주시흥덕구	운천·신봉동	운천·신봉동제3투	3905	2938	967	8	2930	1514	1410	0	0	2	4
충청북도	청주시흥덕구	운천·신봉동	운천·신봉동제4투	2369	1741	628	7	1734	981	748	0	0	5	0
충청북도	청주시흥덕구	운천·신봉동	운천·신봉동제5투	3733	2959	774	36	2923	1520	1374	4	5	7	13
충청북도	청주시흥덕구	산남동	소계	20442	16361	4081	21	16340	7592	8694	7	8	30	9
충청북도	청주시흥덕구	산남동	산남동제1투	3529	2564	965	2	2562	1296	1259	0	0	5	2
충청북도	청주시흥덕구	산남동	산남동제2투	3579	2899	680	10	2889	1620	1260	1	4	3	1
충청북도	청주시흥덕구	산남동	산남동제3투	4457	3644	813	3	3641	1488	2137	3	0	10	3
충청북도	청주시흥덕구	산남동	산남동제4투	4770	3818	952	5	3813	1777	2027	2	2	3	2
충청북도	청주시흥덕구	산남동	산남동제5투	4107	3436	671	1	3435	1411	2011	1	2	9	1
충청북도	청주시흥덕구	분평동	소계	24868	20078	4790	28	20050	9518	10454	10	9	39	20
충청북도	청주시흥덕구	분평동	분평동제1투	1050	794	256	1	793	475	311	1	0	2	4
충청북도	청주시흥덕구	분평동	분평동제2투	4184	3266	918	0	3266	1514	1741	0	1	8	2
충청북도	청주시흥덕구	분평동	분평동제3투	3936	3101	835	5	3096	1378	1704	2	3	6	3
충청북도	청주시흥덕구	분평동	분평동제4투	3726	2989	737	8	2981	1276	1683	2	3	13	4
충청북도	청주시흥덕구	분평동	분평동제5투	4051	3372	679	6	3366	1745	1611	2	2	2	4
충청북도	청주시흥덕구	분평동	분평동제6투	3693	3041	652	5	3036	1422	1608	0	0	4	2
충청북도	청주시흥덕구	분평동	분평동제7투	4228	3515	713	3	3512	1708	1796	3	0	4	1
충청북도	청주시흥덕구	수곡제1동	소계	13762	10241	3521	25	10216	5661	4522	1	3	15	14
충청북도	청주시흥덕구	수곡제1동	수곡제1동제1투	3326	2455	871	6	2449	1291	1153	0	0	3	2
충청북도	청주시흥덕구	수곡제1동	수곡제1동제2투	3569	2638	931	6	2632	1371	1250	0	1	6	4
충청북도	청주시흥덕구	수곡제1동	수곡제1동제3투	3651	2699	952	9	2690	1570	1110	0	1	4	5
충청북도	청주시흥덕구	수곡제1동	수곡제1동제4투	3216	2449	767	4	2445	1429	1009	1	1	2	3
충청북도	청주시흥덕구	수곡제2동	소계	13433	10200	3233	27	10173	5615	4513	2	7	18	18
충청북도	청주시흥덕구	수곡제2동	수곡제2동제1투	3507	2597	910	3	2594	1392	1194	1	0	5	2
충청북도	청주시흥덕구	수곡제2동	수곡제2동제2투	3716	2878	838	5	2873	1538	1323	0	2	4	6
충청북도	청주시흥덕구	수곡제2동	수곡제2동제3투	3409	2595	814	5	2590	1432	1150	1	0	4	3
충청북도	청주시흥덕구	수곡제2동	수곡제2동제4투	2801	2130	671	14	2116	1253	846	0	5	5	7
충청북도	청주시흥덕구	성화·개신·죽림동	소계	34987	27317	7670	57	27260	13176	13998	8	14	37	27
충청북도	청주시흥덕구	성화·개신·죽림동	성화·개신·죽림동제1투	4458	3261	1197	6	3255	1470	1775	2	2	1	5
충청북도	청주시흥덕구	성화·개신·죽림동	성화·개신·죽림동제2투	3990	3228	762	8	3220	1788	1425	0	5	1	1
충청북도	청주시흥덕구	성화·개신·죽림동	성화·개신·죽림동제3투	3620	2855	765	4	2851	1589	1257	0	0	3	2
충청북도	청주시흥덕구	성화·개신·죽림동	성화·개신·죽림동제4투	4278	3572	706	5	3567	1603	1954	2	3	3	2
충청북도	청주시흥덕구	성화·개신·죽림동	성화·개신·죽림동제5투	4054	3257	797	7	3250	1483	1757	2	1	5	2
충청북도	청주시흥덕구	성화·개신·죽림동	성화·개신·죽림동제6투	2406	1912	494	3	1909	943	958	0	0	6	2
충청북도	청주시흥덕구	성화·개신·죽림동	성화·개신·죽림동제7투	3615	2551	1064	7	2544	1249	1287	0	2	3	3
충청북도	청주시흥덕구	성화·개신·죽림동	성화·개신·죽림동제8투	3203	2618	585	3	2615	1239	1367	1	1	5	2
충청북도	청주시흥덕구	성화·개신·죽림동	성화·개신·죽림동제9투	3635	2566	1069	12	2554	1181	1362	0	0	6	5
충청북도	청주시흥덕구	성화·개신·죽림동	성화·개신·죽림동제10투	1728	1497	231	2	1495	631	856	1	0	4	3
충청북도	청주시흥덕구	복대제1동	소계	32439	24317	8122	56	24261	11166	13027	6	9	35	18
충청북도	청주시흥덕구	복대제1동	복대제1동제1투	3662	2684	978	6	2678	975	1699	0	0	3	1
충청북도	청주시흥덕구	복대제1동	복대제1동제2투	3252	2742	510	7	2735	1259	1470	0	0	5	1
충청북도	청주시흥덕구	복대제1동	복대제1동제3투	3345	2544	801	8	2536	1235	1291	1	0	3	6
충청북도	청주시흥덕구	복대제1동	복대제1동제4투	2008	1402	606	3	1399	745	648	1	2	3	0
충청북도	청주시흥덕구	복대제1동	복대제1동제5투	2930	1925	1005	3	1922	1096	816	0	2	6	2
충청북도	청주시흥덕구	복대제1동	복대제1동제6투	4051	2489	1562	9	2480	1136	1337	1	1	3	2
충청북도	청주시흥덕구	복대제1동	복대제1동제7투	3467	2789	678	5	2784	1087	1691	2	0	1	3
충청북도	청주시흥덕구	복대제1동	복대제1동제8투	4145	3247	898	10	3237	1567	1658	0	1	9	2
충청북도	청주시흥덕구	복대제1동	복대제1동제9투	2370	1869	501	4	1865	714	1149	1	0	0	1
충청북도	청주시흥덕구	복대제1동	복대제1동제10투	3209	2626	583	1	2625	1352	1268	0	3	2	0
충청북도	청주시흥덕구	복대제2동	소계	15697	11196	4501	29	11167	6237	4893	6	3	10	18
충청북도	청주시흥덕구	복대제2동	복대제2동제1투	3667	2712	955	7	2705	1510	1185	2	0	4	4
충청북도	청주시흥덕구	복대제2동	복대제2동제2투	2685	1906	779	3	1903	1094	805	1	0	2	1
충청북도	청주시흥덕구	복대제2동	복대제2동제3투	3502	2412	1090	6	2406	1319	1082	1	2	0	2
충청북도	청주시흥덕구	복대제2동	복대제2동제4투	2874	2066	808	8	2058	1136	912	1	1	3	5
충청북도	청주시흥덕구	복대제2동	복대제2동제5투	2969	2100	869	5	2095	1178	909	1	0	1	6
충청북도	청주시흥덕구	가경동	소계	39307	30361	8946	48	30313	14984	15252	7	11	31	28
충청북도	청주시흥덕구	가경동	가경동제1투	2331	1564	767	2	1562	910	644	1	2	3	2
충청북도	청주시흥덕구	가경동	가경동제2투	3360	2684	676	5	2679	1547	1124	2	0	3	3
충청북도	청주시흥덕구	가경동	가경동제3투	4107	3170	937	3	3167	1633	1522	1	1	2	8
충청북도	청주시흥덕구	가경동	가경동제4투	3933	3168	765	7	3161	1517	1637	0	0	4	3
충청북도	청주시흥덕구	가경동	가경동제5투	4432	3254	1178	6	3248	1607	1634	0	2	3	2
충청북도	청주시흥덕구	가경동	가경동제6투	4161	3342	819	5	3337	1579	1752	1	2	2	1
충청북도	청주시흥덕구	가경동	가경동제7투	3748	2800	948	3	2797	1431	1360	1	0	2	3
충청북도	청주시흥덕구	가경동	가경동제8투	4673	3719	954	5	3714	1635	2073	0	2	2	2
충청북도	청주시흥덕구	가경동	가경동제9투	4081	3140	941	5	3135	1487	1636	1	2	6	3
충청북도	청주시흥덕구	가경동	가경동제10투	4481	3520	961	7	3513	1638	1870	0	0	4	1
충청북도	청주시흥덕구	봉명제1동	소계	9802	6571	3231	20	6551	3547	2981	2	4	8	9
충청북도	청주시흥덕구	봉명제1동	봉명제1동제1투	3218	2050	1168	6	2044	1093	946	0	0	0	5
충청북도	청주시흥덕구	봉명제1동	봉명제1동제2투	3515	2377	1138	5	2372	1325	1043	0	0	2	2
충청북도	청주시흥덕구	봉명제1동	봉명제1동제3투	3069	2144	925	9	2135	1129	992	2	4	6	2
충청북도	청주시흥덕구	봉명제2·송정동	소계	20699	14826	5873	35	14791	7315	7436	4	3	19	14
충청북도	청주시흥덕구	봉명제2·송정동	봉명제2·송정동제1투	4287	3025	1262	6	3019	1703	1304	2	0	5	5
충청북도	청주시흥덕구	봉명제2·송정동	봉명제2·송정동제2투	3811	2570	1241	14	2556	1367	1184	0	0	4	1
충청북도	청주시흥덕구	봉명제2·송정동	봉명제2·송정동제3투	4455	3156	1299	6	3150	1601	1545	0	1	3	0
충청북도	청주시흥덕구	봉명제2·송정동	봉명제2·송정동제4투	3292	2437	855	3	2434	960	1465	0	1	2	6
충청북도	청주시흥덕구	봉명제2·송정동	봉명제2·송정동제5투	4854	3638	1216	6	3632	1684	1938	2	1	5	2
충청북도	청주시흥덕구	강서제1동	소계	16758	12530	4228	35	12495	6558	5889	6	6	16	20
충청북도	청주시흥덕구	강서제1동	강서제1동제1투	3750	2692	1058	9	2683	1463	1212	0	2	2	4
충청북도	청주시흥덕구	강서제1동	강서제1동제2투	1082	822	260	3	819	545	269	1	0	0	4
충청북도	청주시흥덕구	강서제1동	강서제1동제3투	1420	1056	364	4	1052	656	386	1	1	4	4
충청북도	청주시흥덕구	강서제1동	강서제1동제4투	3705	2872	833	4	2868	1241	1619	0	1	4	3
충청북도	청주시흥덕구	강서제1동	강서제1동제5투	2165	1551	614	6	1545	836	699	2	2	4	2
충청북도	청주시흥덕구	강서제1동	강서제1동제6투	4636	3537	1099	9	3528	1817	1704	2	0	2	3
충청북도	청주시흥덕구	강서제2동	소계	3303	2402	901	3	2399	1367	1016	1	2	5	8
충청북도	청주시흥덕구	강서제2동	강서제2동제1투	2128	1546	582	2	1544	786	751	1	1	2	3
충청북도	청주시흥덕구	강서제2동	강서제2동제2투	1175	856	319	1	855	581	265	0	1	3	5
충청북도	청주시청원구	계	계	121564	91243	30321	410	90833	46968	43359	43	52	149	262
충청북도	청주시청원구	재외투표	재외투표	430	296	134	2	294	118	175	0	0	1	0
충청북도	청주시청원구	국내부재자투표	국내부재자투표	3206	2920	286	100	2820	1411	1354	15	8	20	12
충청북도	청주시청원구	내수읍	소계	16697	12030	4667	44	11986	6490	5433	3	4	21	35
충청북도	청주시청원구	내수읍	내수읍제1투	2985	2224	761	8	2216	1144	1061	0	0	6	5
충청북도	청주시청원구	내수읍	내수읍제2투	1770	1234	536	3	1231	762	459	1	0	2	7
충청북도	청주시청원구	내수읍	내수읍제3투	980	762	218	3	759	475	278	0	0	1	5
충청북도	청주시청원구	내수읍	내수읍제4투	3682	2721	961	8	2713	1351	1351	1	2	5	3
충청북도	청주시청원구	내수읍	내수읍제5투	2292	1681	611	6	1675	929	741	0	1	1	3
충청북도	청주시청원구	내수읍	내수읍제6투	3328	2253	1075	9	2244	1173	1060	1	0	4	6
충청북도	청주시청원구	내수읍	내수읍제7투	1660	1155	505	7	1148	656	483	0	1	2	6
충청북도	청주시청원구	오창읍	소계	32298	24570	7728	55	24515	10504	13934	4	8	28	37
충청북도	청주시청원구	오창읍	오창읍제1투	3075	2186	889	8	2178	1346	818	0	0	4	10
충청북도	청주시청원구	오창읍	오창읍제2투	2714	1966	748	8	1958	1068	876	0	2	6	6
충청북도	청주시청원구	오창읍	오창읍제3투	1028	756	272	4	752	441	305	1	0	1	4
충청북도	청주시청원구	오창읍	오창읍제4투	3336	2636	700	7	2629	1176	1444	0	2	1	6
충청북도	청주시청원구	오창읍	오창읍제5투	2606	2196	410	1	2195	930	1257	1	0	4	3
충청북도	청주시청원구	오창읍	오창읍제6투	2796	2343	453	3	2340	876	1461	0	0	1	2
충청북도	청주시청원구	오창읍	오창읍제7투	3193	2625	568	2	2623	965	1652	1	0	4	1
충청북도	청주시청원구	오창읍	오창읍제8투	2883	2352	531	4	2348	862	1481	0	2	3	0
충청북도	청주시청원구	오창읍	오창읍제9투	3019	2513	506	4	2509	928	1578	0	0	2	1
충청북도	청주시청원구	오창읍	오창읍제10투	2724	1807	917	7	1800	676	1122	0	0	0	2
충청북도	청주시청원구	오창읍	오창읍제11투	4924	3190	1734	7	3183	1236	1940	1	2	2	2
충청북도	청주시청원구	낭성면	소계	2125	1611	514	8	1603	1087	502	0	0	3	11
충청북도	청주시청원구	낭성면	낭성면투표소	2125	1611	514	8	1603	1087	502	0	0	3	11
충청북도	청주시청원구	미원면	소계	4756	3510	1246	21	3489	2295	1161	1	2	8	22
충청북도	청주시청원구	미원면	미원면제1투	1961	1380	581	10	1370	906	456	0	1	4	3
충청북도	청주시청원구	미원면	미원면제2투	2016	1521	495	10	1511	972	518	0	1	4	16
충청북도	청주시청원구	미원면	미원면제3투	779	609	170	1	608	417	187	1	0	0	3
충청북도	청주시청원구	가덕면	소계	3894	2961	933	24	2937	1771	1135	4	1	6	20
충청북도	청주시청원구	가덕면	가덕면제1투	1592	1213	379	7	1206	726	474	0	0	1	5
충청북도	청주시청원구	가덕면	가덕면제2투	1034	787	247	4	783	448	325	0	0	3	7
충청북도	청주시청원구	가덕면	가덕면제3투	1268	961	307	13	948	597	336	4	1	2	8
충청북도	청주시청원구	남일면	소계	6227	4765	1462	18	4747	2728	1992	1	0	10	16
충청북도	청주시청원구	남일면	남일면제1투	2912	2225	687	7	2218	1281	926	0	0	4	7
충청북도	청주시청원구	남일면	남일면제2투	994	758	236	1	757	469	283	0	0	2	3
충청북도	청주시청원구	남일면	남일면제3투	2321	1782	539	10	1772	978	783	1	0	4	6
충청북도	청주시청원구	남이면	소계	6384	4654	1730	16	4638	2788	1818	1	4	8	19
충청북도	청주시청원구	남이면	남이면제1투	3397	2361	1036	9	2352	1357	984	0	1	4	6
충청북도	청주시청원구	남이면	남이면제2투	1158	915	243	3	912	555	345	0	2	3	7
충청북도	청주시청원구	남이면	남이면제3투	1829	1378	451	4	1374	876	489	1	1	1	6
충청북도	청주시청원구	문의면	소계	4153	3051	1102	24	3027	1837	1163	0	6	8	13
충청북도	청주시청원구	문의면	문의면제1투	3234	2374	860	20	2354	1435	902	0	3	7	7
충청북도	청주시청원구	문의면	문의면제2투	919	677	242	4	673	402	261	0	3	1	6
충청북도	청주시청원구	현도면	소계	3642	2691	951	9	2682	1689	975	2	3	7	6
충청북도	청주시청원구	현도면	현도면제1투	2270	1707	563	4	1703	1087	606	0	2	3	5
충청북도	청주시청원구	현도면	현도면제2투	1372	984	388	5	979	602	369	2	1	4	1
충청북도	청주시청원구	강내면	소계	8692	6613	2079	20	6593	3323	3237	6	4	5	18
충청북도	청주시청원구	강내면	강내면제1투	3595	2710	885	9	2701	1264	1424	3	3	2	5
충청북도	청주시청원구	강내면	강내면제2투	1951	1478	473	2	1476	827	635	3	1	2	8
충청북도	청주시청원구	강내면	강내면제3투	3146	2425	721	9	2416	1232	1178	0	0	1	5
충청북도	청주시청원구	오송읍	소계	16126	12117	4009	28	12089	5624	6432	2	5	14	12
충청북도	청주시청원구	오송읍	오송읍제1투	1688	1168	520	3	1165	645	518	0	0	1	1
충청북도	청주시청원구	오송읍	오송읍제2투	2763	1975	788	2	1973	1134	833	0	2	2	2
충청북도	청주시청원구	오송읍	오송읍제3투	2106	1511	595	10	1501	769	723	0	1	3	5
충청북도	청주시청원구	오송읍	오송읍제4투	2849	2144	705	5	2139	836	1300	1	0	2	0
충청북도	청주시청원구	오송읍	오송읍제5투	2452	2033	419	1	2032	746	1282	0	2	2	0
충청북도	청주시청원구	오송읍	오송읍제6투	1976	1612	364	2	1610	563	1044	0	0	1	2
충청북도	청주시청원구	오송읍	오송읍제7투	2292	1674	618	5	1669	931	732	1	0	3	2
충청북도	청주시청원구	옥산면	소계	8073	5865	2208	20	5845	3115	2700	1	4	6	19
충청북도	청주시청원구	옥산면	옥산면제1투	2982	2174	808	9	2165	1252	901	1	0	2	9
충청북도	청주시청원구	옥산면	옥산면제2투	2133	1585	548	8	1577	878	687	0	3	3	6
충청북도	청주시청원구	옥산면	옥산면제3투	2958	2106	852	3	2103	985	1112	0	1	1	4
충청북도	청주시청원구	북이면	소계	4861	3589	1272	21	3568	2188	1348	3	3	4	22
충청북도	청주시청원구	북이면	북이면제1투	1286	954	332	4	950	550	392	2	0	1	5
충청북도	청주시청원구	북이면	북이면제2투	1023	757	266	6	751	480	263	0	2	2	4
충청북도	청주시청원구	북이면	북이면제3투	1278	952	326	4	948	585	354	1	0	0	8
충청북도	청주시청원구	북이면	북이면제4투	1274	926	348	7	919	573	339	0	1	1	5
충청북도	충주시	계	계	166618	122824	43794	399	122425	73561	48264	45	70	212	273
충청북도	충주시	재외투표	재외투표	480	331	149	1	330	123	202	1	0	3	1
충청북도	충주시	국내부재자투표	국내부재자투표	4895	4501	394	65	4436	2077	2320	5	10	7	17
충청북도	충주시	주덕읍	소계	5014	3524	1490	12	3512	2263	1225	2	3	5	14
충청북도	충주시	주덕읍	주덕읍제1투	1695	1158	537	5	1153	761	380	2	2	1	7
충청북도	충주시	주덕읍	주덕읍제2투	1834	1284	550	4	1280	812	463	0	1	2	2
충청북도	충주시	주덕읍	주덕읍제3투	1485	1082	403	3	1079	690	382	0	0	2	5
충청북도	충주시	살미면	소계	1970	1430	540	13	1417	888	514	0	0	7	8
충청북도	충주시	살미면	살미면투표소	1970	1430	540	13	1417	888	514	0	0	7	8
충청북도	충주시	수안보면	소계	2963	2172	791	12	2160	1420	721	2	3	6	8
충청북도	충주시	수안보면	수안보면제1투	2247	1650	597	12	1638	1111	515	0	3	4	5
충청북도	충주시	수안보면	수안보면제2투	716	522	194	0	522	309	206	2	0	2	3
충청북도	충주시	대소원면	소계	4338	3011	1327	18	2993	1987	981	4	1	6	14
충청북도	충주시	대소원면	대소원면제1투	1839	1280	559	6	1274	878	382	3	0	3	8
충청북도	충주시	대소원면	대소원면제2투	2008	1369	639	6	1363	855	501	0	1	1	5
충청북도	충주시	대소원면	대소원면제3투	491	362	129	6	356	254	98	1	0	2	1
충청북도	충주시	신니면	소계	3103	2335	768	8	2327	1468	838	0	0	11	10
충청북도	충주시	신니면	신니면제1투	1739	1332	407	5	1327	860	454	0	0	6	7
충청북도	충주시	신니면	신니면제2투	1364	1003	361	3	1000	608	384	0	0	5	3
충청북도	충주시	노은면	소계	2187	1593	594	12	1581	1027	539	0	1	4	10
충청북도	충주시	노은면	노은면투표소	2187	1593	594	12	1581	1027	539	0	1	4	10
충청북도	충주시	앙성면	소계	3922	2815	1107	6	2809	1987	801	4	3	3	11
충청북도	충주시	앙성면	앙성면제1투	784	575	209	0	575	417	151	1	0	2	4
충청북도	충주시	앙성면	앙성면제2투	2420	1733	687	5	1728	1200	519	3	2	1	3
충청북도	충주시	앙성면	앙성면제3투	718	507	211	1	506	370	131	0	1	0	4
충청북도	충주시	가금면	소계	2433	1768	665	12	1756	1205	536	3	0	3	9
충청북도	충주시	가금면	가금면제1투	862	628	234	2	626	441	179	1	0	2	3
충청북도	충주시	가금면	가금면제2투	1571	1140	431	10	1130	764	357	2	0	1	6
충청북도	충주시	금가면	소계	3373	2525	848	12	2513	1562	930	1	2	7	11
충청북도	충주시	금가면	금가면제1투	1463	1110	353	9	1101	693	398	0	1	1	8
충청북도	충주시	금가면	금가면제2투	1910	1415	495	3	1412	869	532	1	1	6	3
충청북도	충주시	동량면	소계	3627	2693	934	6	2687	1760	908	2	2	6	9
충청북도	충주시	동량면	동량면제1투	1720	1272	448	4	1268	875	384	1	0	4	4
충청북도	충주시	동량면	동량면제2투	1907	1421	486	2	1419	885	524	1	2	2	5
충청북도	충주시	산척면	소계	2366	1792	574	12	1780	1207	544	2	3	7	17
충청북도	충주시	산척면	산척면투표소	2366	1792	574	12	1780	1207	544	2	3	7	17
충청북도	충주시	엄정면	소계	3117	2300	817	10	2290	1593	679	1	0	7	10
충청북도	충주시	엄정면	엄정면투표소	3117	2300	817	10	2290	1593	679	1	0	7	10
충청북도	충주시	소태면	소계	1751	1288	463	7	1281	828	439	1	4	4	5
충청북도	충주시	소태면	소태면제1투	993	714	279	4	710	433	269	0	3	1	4
충청북도	충주시	소태면	소태면제2투	758	574	184	3	571	395	170	1	1	3	1
충청북도	충주시	성내·충인동	소계	2833	1924	909	2	1922	1337	580	0	1	3	1
충청북도	충주시	성내·충인동	성내·충인동제1투	849	644	205	0	644	466	178	0	0	0	0
충청북도	충주시	성내·충인동	성내·충인동제2투	1984	1280	704	2	1278	871	402	0	1	3	1
충청북도	충주시	교현·안림동	소계	18106	13243	4863	25	13218	8007	5165	4	5	19	18
충청북도	충주시	교현·안림동	교현·안림동제1투	2223	1586	637	3	1583	979	595	1	1	6	1
충청북도	충주시	교현·안림동	교현·안림동제2투	2764	2008	756	6	2002	1256	740	0	2	0	4
충청북도	충주시	교현·안림동	교현·안림동제3투	2992	2270	722	5	2265	1338	920	1	1	4	1
충청북도	충주시	교현·안림동	교현·안림동제4투	2712	1856	856	3	1853	1226	621	0	0	1	5
충청북도	충주시	교현·안림동	교현·안림동제5투	3759	2798	961	4	2794	1621	1164	1	1	3	4
충청북도	충주시	교현·안림동	교현·안림동제6투	3656	2725	931	4	2721	1587	1125	1	0	5	3
충청북도	충주시	교현2동	소계	7342	5163	2179	13	5150	3222	1909	2	2	11	4
충청북도	충주시	교현2동	교현2동제1투	1685	1186	499	4	1182	784	395	1	0	1	1
충청북도	충주시	교현2동	교현2동제2투	2725	1827	898	3	1824	1146	672	0	1	4	1
충청북도	충주시	교현2동	교현2동제3투	2932	2150	782	6	2144	1292	842	1	1	6	2
충청북도	충주시	용산동	소계	12132	8939	3193	12	8927	4888	4003	2	7	15	12
충청북도	충주시	용산동	용산동제1투	2657	1927	730	1	1926	1114	799	0	0	4	9
충청북도	충주시	용산동	용산동제2투	2078	1406	672	4	1402	856	539	0	1	3	3
충청북도	충주시	용산동	용산동제3투	2626	1995	631	5	1990	1155	829	1	3	2	0
충청북도	충주시	용산동	용산동제4투	4771	3611	1160	2	3609	1763	1836	1	3	6	0
충청북도	충주시	지현동	소계	4788	3564	1224	9	3555	2301	1235	1	1	11	6
충청북도	충주시	지현동	지현동제1투	2328	1758	570	8	1750	1132	609	1	1	4	3
충청북도	충주시	지현동	지현동제2투	2460	1806	654	1	1805	1169	626	0	0	7	3
충청북도	충주시	문화동	소계	9624	7115	2509	25	7090	4696	2374	0	5	8	7
충청북도	충주시	문화동	문화동제1투	2328	1623	705	4	1619	1146	467	0	2	2	2
충청북도	충주시	문화동	문화동제2투	2491	2018	473	5	2013	1338	673	0	1	1	0
충청북도	충주시	문화동	문화동제3투	2445	1782	663	12	1770	1136	624	0	2	3	5
충청북도	충주시	문화동	문화동제4투	2360	1692	668	4	1688	1076	610	0	0	2	0
충청북도	충주시	호암·직동	소계	8062	5951	2111	17	5934	3124	2792	1	5	4	8
충청북도	충주시	호암·직동	호암·직동제1투	4345	3353	992	9	3344	1739	1595	1	2	2	5
충청북도	충주시	호암·직동	호암·직동제2투	1608	1134	474	6	1128	636	487	0	1	1	3
충청북도	충주시	호암·직동	호암·직동제3투	2109	1464	645	2	1462	749	710	0	2	1	0
충청북도	충주시	달천동	소계	3872	2653	1219	9	2644	1668	965	1	1	4	5
충청북도	충주시	달천동	달천동제1투	2563	1756	807	5	1751	1130	615	1	1	0	4
충청북도	충주시	달천동	달천동제2투	1309	897	412	4	893	538	350	0	0	4	1
충청북도	충주시	봉방동	소계	6921	4922	1999	15	4907	3167	1720	2	0	8	10
충청북도	충주시	봉방동	봉방동제1투	2282	1620	662	6	1614	1026	582	1	0	2	3
충청북도	충주시	봉방동	봉방동제2투	1939	1416	523	0	1416	925	485	0	0	2	4
충청북도	충주시	봉방동	봉방동제3투	2700	1886	814	9	1877	1216	653	1	0	4	3
충청북도	충주시	칠금·금릉동	소계	12815	9795	3020	19	9776	5418	4336	1	4	9	8
충청북도	충주시	칠금·금릉동	칠금·금릉동제1투	1146	819	327	1	818	524	293	0	0	0	1
충청북도	충주시	칠금·금릉동	칠금·금릉동제2투	1851	1391	460	4	1387	810	574	0	0	2	1
충청북도	충주시	칠금·금릉동	칠금·금릉동제3투	3108	2323	785	5	2318	1273	1038	0	1	3	3
충청북도	충주시	칠금·금릉동	칠금·금릉동제4투	3107	2297	810	6	2291	1219	1069	1	0	0	2
충청북도	충주시	칠금·금릉동	칠금·금릉동제5투	3603	2965	638	3	2962	1592	1362	0	3	4	1
충청북도	충주시	연수동	소계	29400	21640	7760	42	21598	12229	9302	2	7	26	32
충청북도	충주시	연수동	연수동제1투	3067	2187	880	3	2184	1345	835	0	0	1	3
충청북도	충주시	연수동	연수동제2투	2702	1882	820	5	1877	1007	867	0	0	1	2
충청북도	충주시	연수동	연수동제3투	3483	2742	741	1	2741	1444	1295	0	0	1	1
충청북도	충주시	연수동	연수동제4투	2494	1885	609	3	1882	1086	787	1	2	4	2
충청북도	충주시	연수동	연수동제5투	2089	1517	572	3	1514	946	563	0	1	3	1
충청북도	충주시	연수동	연수동제6투	2884	1897	987	10	1887	1233	636	1	1	2	14
충청북도	충주시	연수동	연수동제7투	2540	1903	637	2	1901	936	960	0	0	4	1
충청북도	충주시	연수동	연수동제8투	2629	1997	632	7	1990	1093	892	0	1	3	1
충청북도	충주시	연수동	연수동제9투	2695	1929	766	3	1926	1076	847	0	0	2	1
충청북도	충주시	연수동	연수동제10투	2354	1809	545	3	1806	992	806	0	0	3	5
충청북도	충주시	연수동	연수동제11투	2463	1892	571	2	1890	1071	814	0	2	2	1
충청북도	충주시	목행·용탄동	소계	5184	3837	1347	5	3832	2109	1706	1	0	8	8
충청북도	충주시	목행·용탄동	목행·용탄동제1투	3220	2451	769	2	2449	1239	1202	0	0	5	3
충청북도	충주시	목행·용탄동	목행·용탄동제2투	1964	1386	578	3	1383	870	504	1	0	3	5
충청북도	제천시	계	계	110855	82747	28108	361	82386	50284	31682	32	42	151	195
충청북도	제천시	재외투표	재외투표	295	202	93	3	199	75	121	0	0	1	2
충청북도	제천시	국내부재자투표	국내부재자투표	3246	2965	281	55	2910	1344	1537	7	5	8	9
충청북도	제천시	봉양읍	소계	6267	4680	1587	39	4641	2871	1735	2	3	9	21
충청북도	제천시	봉양읍	봉양읍제1투	3859	2836	1023	29	2807	1750	1035	1	3	4	14
충청북도	제천시	봉양읍	봉양읍제2투	1519	1177	342	4	1173	705	464	0	0	2	2
충청북도	제천시	봉양읍	봉양읍제3투	889	667	222	6	661	416	236	1	0	3	5
충청북도	제천시	금성면	소계	1829	1370	459	4	1366	896	461	0	2	4	3
충청북도	제천시	금성면	금성면제1투	865	653	212	3	650	432	214	0	0	3	1
충청북도	제천시	금성면	금성면제2투	964	717	247	1	716	464	247	0	2	1	2
충청북도	제천시	청풍면	소계	1119	828	291	5	823	620	195	0	0	4	4
충청북도	제천시	청풍면	청풍면제1투	931	685	246	3	682	514	161	0	0	3	4
충청북도	제천시	청풍면	청풍면제2투	188	143	45	2	141	106	34	0	0	1	0
충청북도	제천시	수산면	소계	1889	1367	522	6	1361	978	370	1	3	3	6
충청북도	제천시	수산면	수산면제1투	1576	1126	450	6	1120	812	298	0	3	3	4
충청북도	제천시	수산면	수산면제2투	313	241	72	0	241	166	72	1	0	0	2
충청북도	제천시	덕산면	소계	2049	1506	543	11	1495	967	501	1	2	7	17
충청북도	제천시	덕산면	덕산면제1투	1598	1173	425	6	1167	747	398	1	1	7	13
충청북도	제천시	덕산면	덕산면제2투	451	333	118	5	328	220	103	0	1	0	4
충청북도	제천시	한수면	소계	681	509	172	2	507	348	157	0	0	0	2
충청북도	제천시	한수면	한수면투표소	681	509	172	2	507	348	157	0	0	0	2
충청북도	제천시	백운면	소계	2883	2127	756	14	2113	1362	736	1	0	5	9
충청북도	제천시	백운면	백운면제1투	1941	1421	520	7	1414	895	509	1	0	3	6
충청북도	제천시	백운면	백운면제2투	942	706	236	7	699	467	227	0	0	2	3
충청북도	제천시	송학면	소계	4453	3280	1173	17	3263	2186	1050	1	3	6	17
충청북도	제천시	송학면	송학면제1투	2536	1830	706	11	1819	1211	594	1	2	4	7
충청북도	제천시	송학면	송학면제2투	1434	1090	344	4	1086	746	331	0	1	2	6
충청북도	제천시	송학면	송학면제3투	483	360	123	2	358	229	125	0	0	0	4
충청북도	제천시	교동	소계	13754	10497	3257	23	10474	5928	4505	2	4	19	16
충청북도	제천시	교동	교동제1투	2402	1847	555	3	1844	1212	616	1	0	8	7
충청북도	제천시	교동	교동제2투	4775	3533	1242	6	3527	1822	1695	1	1	4	4
충청북도	제천시	교동	교동제3투	3029	2342	687	7	2335	1264	1064	0	1	5	1
충청북도	제천시	교동	교동제4투	3548	2775	773	7	2768	1630	1130	0	2	2	4
충청북도	제천시	의암동	소계	7161	5507	1654	11	5496	3077	2400	2	1	5	11
충청북도	제천시	의암동	의암동제1투	3725	2998	727	2	2996	1588	1397	1	0	4	6
충청북도	제천시	의암동	의암동제2투	1492	1095	397	2	1093	635	455	1	0	1	1
충청북도	제천시	의암동	의암동제3투	1944	1414	530	7	1407	854	548	0	1	0	4
충청북도	제천시	인성동	소계	5806	4220	1586	9	4211	2865	1335	1	2	4	4
충청북도	제천시	인성동	인성동제1투	3676	2685	991	6	2679	1784	888	1	2	1	3
충청북도	제천시	인성동	인성동제2투	2130	1535	595	3	1532	1081	447	0	0	3	1
충청북도	제천시	남현동	소계	5214	3800	1414	18	3782	2547	1224	2	0	4	5
충청북도	제천시	남현동	남현동제1투	1838	1329	509	9	1320	940	377	0	0	1	2
충청북도	제천시	남현동	남현동제2투	3376	2471	905	9	2462	1607	847	2	0	3	3
충청북도	제천시	영서동	소계	6851	4930	1921	12	4918	3258	1635	3	4	9	9
충청북도	제천시	영서동	영서동제1투	2026	1431	595	4	1427	986	435	0	0	5	1
충청북도	제천시	영서동	영서동제2투	3393	2454	939	5	2449	1643	792	0	3	3	8
충청북도	제천시	영서동	영서동제3투	1432	1045	387	3	1042	629	408	3	1	1	0
충청북도	제천시	용두동	소계	13591	10051	3540	31	10020	5641	4340	3	7	18	11
충청북도	제천시	용두동	용두동제1투	3335	2578	757	8	2570	1474	1087	2	2	4	1
충청북도	제천시	용두동	용두동제2투	3032	1996	1036	9	1987	1030	950	1	1	3	2
충청북도	제천시	용두동	용두동제3투	4103	2902	1201	11	2891	1825	1050	0	3	6	7
충청북도	제천시	용두동	용두동제4투	3121	2575	546	3	2572	1312	1253	0	1	5	1
충청북도	제천시	신백동	소계	9975	7337	2638	44	7293	4083	3164	5	2	20	19
충청북도	제천시	신백동	신백동제1투	2539	1967	572	5	1962	1002	952	0	1	4	3
충청북도	제천시	신백동	신백동제2투	2455	1640	815	3	1637	1022	608	1	0	5	1
충청북도	제천시	신백동	신백동제3투	2776	2111	665	5	2106	1037	1062	0	0	4	3
충청북도	제천시	신백동	신백동제4투	1348	986	362	18	968	629	321	3	1	6	8
충청북도	제천시	신백동	신백동제5투	857	633	224	13	620	393	221	1	0	1	4
충청북도	제천시	청전동	소계	15569	11695	3874	36	11659	7438	4184	1	1	16	19
충청북도	제천시	청전동	청전동제1투	3012	2322	690	8	2314	1469	839	0	0	3	3
충청북도	제천시	청전동	청전동제2투	2422	1863	559	2	1861	1161	696	0	0	3	1
충청북도	제천시	청전동	청전동제3투	1771	1268	503	2	1266	849	411	0	1	3	2
충청북도	제천시	청전동	청전동제4투	3195	2211	984	13	2198	1421	768	0	0	2	7
충청북도	제천시	청전동	청전동제5투	3008	2385	623	3	2382	1504	873	1	0	1	3
충청북도	제천시	청전동	청전동제6투	2161	1646	515	8	1638	1034	597	0	0	4	3
충청북도	제천시	화산동	소계	8223	5876	2347	21	5855	3800	2032	0	3	9	11
충청북도	제천시	화산동	화산동제1투	2547	1871	676	7	1864	1198	656	0	1	5	4
충청북도	제천시	화산동	화산동제2투	3222	2246	976	5	2241	1390	845	0	0	2	4
충청북도	제천시	화산동	화산동제3투	2454	1759	695	9	1750	1212	531	0	2	2	3
충청북도	단양군	계	계	26486	19763	6723	120	19643	12957	6510	12	8	51	105
충청북도	단양군	재외투표	재외투표	83	60	23	0	60	29	31	0	0	0	0
충청북도	단양군	국내부재자투표	국내부재자투표	961	890	71	11	879	416	457	0	2	2	2
충청북도	단양군	단양읍	소계	8559	6365	2194	15	6350	4037	2286	3	1	8	15
충청북도	단양군	단양읍	단양읍제1투	2806	2090	716	5	2085	1273	805	0	0	4	3
충청북도	단양군	단양읍	단양읍제2투	2123	1579	544	3	1576	1061	513	0	0	1	1
충청북도	단양군	단양읍	단양읍제3투	3630	2696	934	7	2689	1703	968	3	1	3	11
충청북도	단양군	매포읍	소계	5248	3877	1371	16	3861	2568	1258	4	1	8	22
충청북도	단양군	매포읍	매포읍제1투	2931	2153	778	9	2144	1458	674	0	1	4	7
충청북도	단양군	매포읍	매포읍제2투	1402	1014	388	5	1009	622	374	3	0	2	8
충청북도	단양군	매포읍	매포읍제3투	915	710	205	2	708	488	210	1	0	2	7
충청북도	단양군	단성면	소계	1540	1095	445	9	1086	766	315	0	0	1	4
충청북도	단양군	단성면	단성면제1투	1161	805	356	5	800	573	224	0	0	0	3
충청북도	단양군	단성면	단성면제2투	379	290	89	4	286	193	91	0	0	1	1
충청북도	단양군	대강면	소계	2233	1638	595	13	1625	1214	400	1	1	1	8
충청북도	단양군	대강면	대강면제1투	1727	1257	470	10	1247	933	306	1	1	1	5
충청북도	단양군	대강면	대강면제2투	506	381	125	3	378	281	94	0	0	0	3
충청북도	단양군	가곡면	소계	1854	1358	496	17	1341	839	483	1	0	5	13
충청북도	단양군	가곡면	가곡면투표소	1854	1358	496	17	1341	839	483	1	0	5	13
충청북도	단양군	영춘면	소계	2995	2295	700	13	2282	1644	603	1	0	14	20
충청북도	단양군	영춘면	영춘면제1투	1913	1466	447	7	1459	1120	319	1	0	7	12
충청북도	단양군	영춘면	영춘면제2투	166	133	33	0	133	81	49	0	0	2	1
충청북도	단양군	영춘면	영춘면제3투	916	696	220	6	690	443	235	0	0	5	7
충청북도	단양군	어상천면	소계	1632	1164	468	9	1155	715	420	0	1	6	13
충청북도	단양군	어상천면	어상천면투표소	1632	1164	468	9	1155	715	420	0	1	6	13
충청북도	단양군	적성면	소계	1381	1021	360	17	1004	729	257	2	2	6	8
충청북도	단양군	적성면	적성면제1투	677	502	175	12	490	346	133	2	1	2	6
충청북도	단양군	적성면	적성면제2투	704	519	185	5	514	383	124	0	1	4	2
충청북도	영동군	계	계	42754	32044	10710	210	31834	20397	11169	20	35	57	156
충청북도	영동군	재외투표	재외투표	199	142	57	0	142	83	58	0	0	0	1
충청북도	영동군	국내부재자투표	국내부재자투표	1629	1461	168	32	1429	686	722	4	9	4	4
충청북도	영동군	영동읍	소계	16430	12243	4187	46	12197	7343	4793	3	12	16	30
충청북도	영동군	영동읍	영동읍제1투	3043	2228	815	3	2225	1354	858	1	0	5	7
충청북도	영동군	영동읍	영동읍제2투	2858	2203	655	11	2192	1375	808	1	1	2	5
충청북도	영동군	영동읍	영동읍제3투	1475	1133	342	4	1129	723	400	0	2	2	2
충청북도	영동군	영동읍	영동읍제4투	3172	2406	766	13	2393	1466	918	0	1	2	6
충청북도	영동군	영동읍	영동읍제5투	2586	1730	856	5	1725	889	822	1	3	4	6
충청북도	영동군	영동읍	영동읍제6투	3296	2543	753	10	2533	1536	987	0	5	1	4
충청북도	영동군	용산면	소계	3075	2252	823	18	2234	1468	736	1	2	9	18
충청북도	영동군	용산면	용산면투표소	3075	2252	823	18	2234	1468	736	1	2	9	18
충청북도	영동군	황간면	소계	4018	2978	1040	17	2961	1920	1027	1	0	4	9
충청북도	영동군	황간면	황간면제1투	2342	1727	615	7	1720	1099	616	0	0	2	3
충청북도	영동군	황간면	황간면제2투	1676	1251	425	10	1241	821	411	1	0	2	6
충청북도	영동군	추풍령면	소계	2156	1630	526	11	1619	1193	415	1	1	1	8
충청북도	영동군	추풍령면	추풍령면투표소	2156	1630	526	11	1619	1193	415	1	1	1	8
충청북도	영동군	매곡면	소계	1844	1369	475	8	1361	1018	328	1	1	3	10
충청북도	영동군	매곡면	매곡면투표소	1844	1369	475	8	1361	1018	328	1	1	3	10
충청북도	영동군	상촌면	소계	2154	1637	517	16	1621	1113	495	1	1	2	9
충청북도	영동군	상촌면	상촌면투표소	2154	1637	517	16	1621	1113	495	1	1	2	9
충청북도	영동군	양강면	소계	2899	2107	792	13	2094	1395	673	3	5	4	14
충청북도	영동군	양강면	양강면투표소	2899	2107	792	13	2094	1395	673	3	5	4	14
충청북도	영동군	용화면	소계	885	693	192	8	685	437	237	0	0	1	10
충청북도	영동군	용화면	용화면투표소	885	693	192	8	685	437	237	0	0	1	10
충청북도	영동군	학산면	소계	2671	1935	736	18	1917	1331	565	0	3	4	14
충청북도	영동군	학산면	학산면제1투	2152	1553	599	15	1538	1076	446	0	1	4	11
충청북도	영동군	학산면	학산면제2투	519	382	137	3	379	255	119	0	2	0	3
충청북도	영동군	양산면	소계	1782	1352	430	12	1340	918	409	2	0	4	7
충청북도	영동군	양산면	양산면투표소	1782	1352	430	12	1340	918	409	2	0	4	7
충청북도	영동군	심천면	소계	3012	2245	767	11	2234	1492	711	3	1	5	22
충청북도	영동군	심천면	심천면제1투	2506	1853	653	7	1846	1250	569	3	1	4	19
충청북도	영동군	심천면	심천면제2투	506	392	114	4	388	242	142	0	0	1	3
충청북도	보은군	계	계	29519	22431	7088	172	22259	13783	8261	17	13	56	129
충청북도	보은군	재외투표	재외투표	94	63	31	0	63	37	26	0	0	0	0
충청북도	보은군	국내부재자투표	국내부재자투표	1059	955	104	28	927	456	455	5	1	5	5
충청북도	보은군	보은읍	소계	11796	8909	2887	48	8861	5365	3439	7	3	19	28
충청북도	보은군	보은읍	보은읍제1투	2386	1748	638	14	1734	1092	634	3	0	2	3
충청북도	보은군	보은읍	보은읍제2투	1326	989	337	9	980	655	318	1	0	3	3
충청북도	보은군	보은읍	보은읍제3투	2972	2263	709	8	2255	1312	933	0	2	1	7
충청북도	보은군	보은읍	보은읍제4투	3335	2553	782	9	2544	1478	1049	1	1	7	8
충청북도	보은군	보은읍	보은읍제5투	1777	1356	421	8	1348	828	505	2	0	6	7
충청북도	보은군	속리산면	소계	1899	1379	520	3	1376	854	512	0	1	2	7
충청북도	보은군	속리산면	속리산면제1투	1635	1183	452	1	1182	736	439	0	1	1	5
충청북도	보은군	속리산면	속리산면제2투	264	196	68	2	194	118	73	0	0	1	2
충청북도	보은군	장안면	소계	1148	864	284	4	860	532	316	1	1	3	7
충청북도	보은군	장안면	장안면투표소	1148	864	284	4	860	532	316	1	1	3	7
충청북도	보은군	마로면	소계	2270	1733	537	14	1719	1127	567	1	1	7	16
충청북도	보은군	마로면	마로면제1투	1580	1195	385	11	1184	791	376	0	1	6	10
충청북도	보은군	마로면	마로면제2투	690	538	152	3	535	336	191	1	0	1	6
충청북도	보은군	탄부면	소계	1779	1352	427	12	1340	867	458	1	1	3	10
충청북도	보은군	탄부면	탄부면투표소	1779	1352	427	12	1340	867	458	1	1	3	10
충청북도	보은군	삼승면	소계	2216	1671	545	16	1655	1015	629	0	0	2	9
충청북도	보은군	삼승면	삼승면투표소	2216	1671	545	16	1655	1015	629	0	0	2	9
충청북도	보은군	수한면	소계	1649	1255	394	7	1248	856	378	0	1	1	12
충청북도	보은군	수한면	수한면투표소	1649	1255	394	7	1248	856	378	0	1	1	12
충청북도	보은군	회남면	소계	693	523	170	6	517	334	176	1	0	4	2
충청북도	보은군	회남면	회남면투표소	693	523	170	6	517	334	176	1	0	4	2
충청북도	보은군	회인면	소계	1682	1284	398	12	1272	828	426	0	1	2	15
충청북도	보은군	회인면	회인면투표소	1682	1284	398	12	1272	828	426	0	1	2	15
충청북도	보은군	내북면	소계	1639	1198	441	10	1188	689	481	1	1	7	9
충청북도	보은군	내북면	내북면제1투	942	689	253	5	684	375	299	0	0	4	6
충청북도	보은군	내북면	내북면제2투	697	509	188	5	504	314	182	1	1	3	3
충청북도	보은군	산외면	소계	1595	1245	350	12	1233	823	398	0	2	1	9
충청북도	보은군	산외면	산외면제1투	1016	786	230	7	779	510	264	0	1	1	3
충청북도	보은군	산외면	산외면제2투	579	459	120	5	454	313	134	0	1	0	6
충청북도	옥천군	계	계	44412	34030	10382	230	33800	21799	11691	21	36	64	189
충청북도	옥천군	재외투표	재외투표	141	88	53	1	87	43	44	0	0	0	0
충청북도	옥천군	국내부재자투표	국내부재자투표	1727	1537	190	63	1474	800	623	6	11	13	21
충청북도	옥천군	옥천읍	소계	22283	17074	5209	50	17024	10523	6422	5	10	17	47
충청북도	옥천군	옥천읍	옥천읍제1투	4068	2988	1080	7	2981	1711	1262	0	1	3	4
충청북도	옥천군	옥천읍	옥천읍제2투	2555	1990	565	7	1983	1286	691	0	1	0	5
충청북도	옥천군	옥천읍	옥천읍제3투	3479	2736	743	10	2726	1575	1133	1	3	4	10
충청북도	옥천군	옥천읍	옥천읍제4투	2679	2069	610	4	2065	1353	703	1	1	4	3
충청북도	옥천군	옥천읍	옥천읍제5투	1625	1211	414	9	1202	773	417	1	2	1	8
충청북도	옥천군	옥천읍	옥천읍제6투	885	679	206	3	676	468	203	0	0	0	5
충청북도	옥천군	옥천읍	옥천읍제7투	3033	2358	675	4	2354	1436	913	0	0	3	2
충청북도	옥천군	옥천읍	옥천읍제8투	3959	3043	916	6	3037	1921	1100	2	2	2	10
충청북도	옥천군	동이면	소계	2954	2256	698	15	2241	1564	644	4	1	10	18
충청북도	옥천군	동이면	동이면제1투	1936	1481	455	12	1469	1019	433	1	0	5	11
충청북도	옥천군	동이면	동이면제2투	398	306	92	1	305	219	80	2	0	1	3
충청북도	옥천군	동이면	동이면제3투	620	469	151	2	467	326	131	1	1	4	4
충청북도	옥천군	안남면	소계	1305	1006	299	14	992	651	323	0	3	4	11
충청북도	옥천군	안남면	안남면투표소	1305	1006	299	14	992	651	323	0	3	4	11
충청북도	옥천군	안내면	소계	1906	1444	462	11	1433	1033	383	1	1	3	12
충청북도	옥천군	안내면	안내면투표소	1906	1444	462	11	1433	1033	383	1	1	3	12
충청북도	옥천군	청성면	소계	2287	1710	577	23	1687	1147	507	0	3	3	27
충청북도	옥천군	청성면	청성면제1투	995	720	275	17	703	445	242	0	3	2	11
충청북도	옥천군	청성면	청성면제2투	800	633	167	4	629	438	182	0	0	1	8
충청북도	옥천군	청성면	청성면제3투	492	357	135	2	355	264	83	0	0	0	8
충청북도	옥천군	청산면	소계	3062	2301	761	18	2283	1622	635	1	2	5	18
충청북도	옥천군	청산면	청산면제1투	1465	1087	378	5	1082	761	317	1	1	1	1
충청북도	옥천군	청산면	청산면제2투	595	454	141	6	448	299	137	0	1	1	10
충청북도	옥천군	청산면	청산면제3투	1002	760	242	7	753	562	181	0	0	3	7
충청북도	옥천군	이원면	소계	4054	3012	1042	16	2996	2018	959	4	3	2	10
충청북도	옥천군	이원면	이원면제1투	1555	1165	390	5	1160	753	401	2	1	0	3
충청북도	옥천군	이원면	이원면제2투	1187	875	312	5	870	593	271	1	1	1	3
충청북도	옥천군	이원면	이원면제3투	1312	972	340	6	966	672	287	1	1	1	4
충청북도	옥천군	군서면	소계	2107	1604	503	10	1594	1110	470	0	1	3	10
충청북도	옥천군	군서면	군서면투표소	2107	1604	503	10	1594	1110	470	0	1	3	10
충청북도	옥천군	군북면	소계	2586	1998	588	9	1989	1288	681	0	1	4	15
충청북도	옥천군	군북면	군북면제1투	1669	1270	399	4	1266	791	466	0	1	2	6
충청북도	옥천군	군북면	군북면제2투	362	271	91	0	271	175	91	0	0	2	3
충청북도	옥천군	군북면	군북면제3투	555	457	98	5	452	322	124	0	0	0	6
충청북도	음성군	계	계	74727	52943	21784	317	52626	30459	21825	40	34	108	160
충청북도	음성군	재외투표	재외투표	195	141	54	2	139	64	75	0	0	0	0
충청북도	음성군	국내부재자투표	국내부재자투표	2532	2328	204	93	2235	1154	1023	13	12	13	20
충청북도	음성군	음성읍	소계	14318	10281	4037	32	10249	6106	4084	3	3	22	31
충청북도	음성군	음성읍	음성읍제1투	2971	2142	829	4	2138	1216	914	0	2	3	3
충청북도	음성군	음성읍	음성읍제2투	2993	2271	722	7	2264	1409	842	1	0	4	8
충청북도	음성군	음성읍	음성읍제3투	4680	3335	1345	15	3320	1864	1442	2	1	6	5
충청북도	음성군	음성읍	음성읍제4투	879	534	345	1	533	347	177	0	0	4	5
충청북도	음성군	음성읍	음성읍제5투	2795	1999	796	5	1994	1270	709	0	0	5	10
충청북도	음성군	금왕읍	소계	15842	11203	4639	41	11162	6077	5049	2	3	13	18
충청북도	음성군	금왕읍	금왕읍제1투	4564	3190	1374	11	3179	1789	1382	2	0	2	4
충청북도	음성군	금왕읍	금왕읍제2투	4313	2996	1317	9	2987	1517	1462	0	2	5	1
충청북도	음성군	금왕읍	금왕읍제3투	3453	2529	924	7	2522	1273	1242	0	1	4	2
충청북도	음성군	금왕읍	금왕읍제4투	1441	1022	419	12	1010	579	427	0	0	1	3
충청북도	음성군	금왕읍	금왕읍제5투	2071	1466	605	2	1464	919	536	0	0	1	8
충청북도	음성군	소이면	소계	2838	2135	703	11	2124	1294	813	3	1	5	8
충청북도	음성군	소이면	소이면투표소	2838	2135	703	11	2124	1294	813	3	1	5	8
충청북도	음성군	원남면	소계	2810	2078	732	10	2068	1262	790	0	0	3	13
충청북도	음성군	원남면	원남면제1투	1764	1294	470	6	1288	825	452	0	0	1	10
충청북도	음성군	원남면	원남면제2투	1046	784	262	4	780	437	338	0	0	2	3
충청북도	음성군	맹동면	소계	4071	2529	1542	42	2487	1462	969	10	7	16	23
충청북도	음성군	맹동면	맹동면제1투	3132	1833	1299	35	1798	1052	694	10	6	15	21
충청북도	음성군	맹동면	맹동면제2투	939	696	243	7	689	410	275	0	1	1	2
충청북도	음성군	대소면	소계	12534	8644	3890	32	8612	4543	4041	2	5	10	11
충청북도	음성군	대소면	대소면제1투	2951	2108	843	10	2098	1179	910	1	0	3	5
충청북도	음성군	대소면	대소면제2투	1570	1065	505	5	1060	584	473	1	0	1	1
충청북도	음성군	대소면	대소면제3투	4192	2913	1279	11	2902	1440	1454	0	3	3	2
충청북도	음성군	대소면	대소면제4투	3821	2558	1263	6	2552	1340	1204	0	2	3	3
충청북도	음성군	삼성면	소계	6701	4583	2118	23	4560	2749	1787	3	1	6	14
충청북도	음성군	삼성면	삼성면제1투	3871	2573	1298	12	2561	1507	1042	1	0	3	8
충청북도	음성군	삼성면	삼성면제2투	2830	2010	820	11	1999	1242	745	2	1	3	6
충청북도	음성군	생극면	소계	4018	2839	1179	10	2829	1860	952	0	0	6	11
충청북도	음성군	생극면	생극면제1투	2754	1925	829	8	1917	1256	649	0	0	3	9
충청북도	음성군	생극면	생극면제2투	1264	914	350	2	912	604	303	0	0	3	2
충청북도	음성군	감곡면	소계	8868	6182	2686	21	6161	3888	2242	4	2	14	11
충청북도	음성군	감곡면	감곡면제1투	4067	2767	1300	9	2758	1606	1139	1	2	7	3
충청북도	음성군	감곡면	감곡면제2투	3256	2295	961	7	2288	1515	762	1	0	6	4
충청북도	음성군	감곡면	감곡면제3투	1545	1120	425	5	1115	767	341	2	0	1	4
충청북도	진천군	계	계	50295	36543	13752	161	36382	20614	15560	18	25	59	106
충청북도	진천군	재외투표	재외투표	109	71	38	1	70	23	47	0	0	0	0
충청북도	진천군	국내부재자투표	국내부재자투표	1289	1177	112	22	1155	560	577	7	4	4	3
충청북도	진천군	진천읍	소계	21595	15670	5925	50	15620	8652	6907	4	8	19	30
충청북도	진천군	진천읍	진천읍제1투	3244	2253	991	6	2247	1342	899	1	3	2	0
충청북도	진천군	진천읍	진천읍제2투	1206	910	296	6	904	560	336	0	1	2	5
충청북도	진천군	진천읍	진천읍제3투	3299	2382	917	2	2380	1225	1145	0	1	4	5
충청북도	진천군	진천읍	진천읍제4투	2707	1979	728	8	1971	1188	773	1	0	3	6
충청북도	진천군	진천읍	진천읍제5투	3142	2256	886	5	2251	1132	1116	0	1	1	1
충청북도	진천군	진천읍	진천읍제6투	3416	2511	905	13	2498	1340	1146	2	2	2	6
충청북도	진천군	진천읍	진천읍제7투	2094	1533	561	6	1527	809	714	0	0	2	2
충청북도	진천군	진천읍	진천읍제8투	2487	1846	641	4	1842	1056	778	0	0	3	5
충청북도	진천군	덕산면	소계	4790	3464	1326	16	3448	2053	1364	0	3	10	18
충청북도	진천군	덕산면	덕산면제1투	3479	2499	980	4	2495	1493	985	0	1	6	10
충청북도	진천군	덕산면	덕산면제2투	1311	965	346	12	953	560	379	0	2	4	8
충청북도	진천군	초평면	소계	3053	2303	750	13	2290	1343	931	2	0	3	11
충청북도	진천군	초평면	초평면제1투	2025	1541	484	5	1536	872	650	2	0	3	9
충청북도	진천군	초평면	초평면제2투	1028	762	266	8	754	471	281	0	0	0	2
충청북도	진천군	문백면	소계	3319	2456	863	7	2449	1537	896	1	3	4	8
충청북도	진천군	문백면	문백면제1투	2171	1596	575	4	1592	1018	565	1	1	3	4
충청북도	진천군	문백면	문백면제2투	1148	860	288	3	857	519	331	0	2	1	4
충청북도	진천군	백곡면	소계	1902	1449	453	8	1441	938	490	0	1	2	10
충청북도	진천군	백곡면	백곡면투표소	1902	1449	453	8	1441	938	490	0	1	2	10
충청북도	진천군	이월면	소계	6251	4456	1795	19	4437	2461	1948	2	3	10	13
충청북도	진천군	이월면	이월면제1투	3240	2272	968	6	2266	1268	987	0	0	5	6
충청북도	진천군	이월면	이월면제2투	3011	2184	827	13	2171	1193	961	2	3	5	7
충청북도	진천군	광혜원면	소계	7987	5497	2490	25	5472	3047	2400	2	3	7	13
충청북도	진천군	광혜원면	광혜원면제1투	3533	2377	1156	15	2362	1425	922	2	1	3	9
충청북도	진천군	광혜원면	광혜원면제2투	4454	3120	1334	10	3110	1622	1478	0	2	4	4
충청북도	괴산군	계	계	32990	24502	8488	172	24330	15442	8646	16	18	61	147
충청북도	괴산군	재외투표	재외투표	101	72	29	2	70	32	38	0	0	0	0
충청북도	괴산군	국내부재자투표	국내부재자투표	1018	936	82	17	919	432	473	1	0	8	5
충청북도	괴산군	괴산읍	소계	7463	5579	1884	30	5549	3399	2122	2	4	9	13
충청북도	괴산군	괴산읍	괴산읍제1투	3148	2383	765	14	2369	1466	892	1	0	2	8
충청북도	괴산군	괴산읍	괴산읍제2투	2528	1898	630	9	1889	1146	734	1	3	3	2
충청북도	괴산군	괴산읍	괴산읍제3투	1787	1298	489	7	1291	787	496	0	1	4	3
충청북도	괴산군	감물면	소계	1705	1283	422	10	1273	852	410	0	0	3	8
충청북도	괴산군	감물면	감물면투표소	1705	1283	422	10	1273	852	410	0	0	3	8
충청북도	괴산군	장연면	소계	1743	1283	460	14	1269	829	421	4	2	3	10
충청북도	괴산군	장연면	장연면투표소	1743	1283	460	14	1269	829	421	4	2	3	10
충청북도	괴산군	연풍면	소계	2159	1601	558	9	1592	1129	445	1	0	1	16
충청북도	괴산군	연풍면	연풍면투표소	2159	1601	558	9	1592	1129	445	1	0	1	16
충청북도	괴산군	칠성면	소계	2578	1934	644	8	1926	1231	674	2	2	6	11
충청북도	괴산군	칠성면	칠성면투표소	2578	1934	644	8	1926	1231	674	2	2	6	11
충청북도	괴산군	문광면	소계	1845	1352	493	11	1341	803	518	0	2	7	11
충청북도	괴산군	문광면	문광면투표소	1845	1352	493	11	1341	803	518	0	2	7	11
충청북도	괴산군	청천면	소계	4512	3327	1185	30	3297	2204	1050	2	5	10	26
충청북도	괴산군	청천면	청천면제1투	1583	1132	451	13	1119	764	346	1	2	2	4
충청북도	괴산군	청천면	청천면제2투	606	465	141	4	461	315	138	0	0	3	5
충청북도	괴산군	청천면	청천면제3투	928	727	201	6	721	460	252	0	2	1	6
충청북도	괴산군	청천면	청천면제4투	466	345	121	4	341	226	110	0	0	1	4
충청북도	괴산군	청천면	청천면제5투	929	658	271	3	655	439	204	1	1	3	7
충청북도	괴산군	청안면	소계	3005	2128	877	15	2113	1335	755	2	1	2	18
충청북도	괴산군	청안면	청안면제1투	1769	1252	517	9	1243	769	464	1	0	1	8
충청북도	괴산군	청안면	청안면제2투	1236	876	360	6	870	566	291	1	1	1	10
충청북도	괴산군	사리면	소계	2543	1904	639	2	1902	1271	609	2	0	4	16
충청북도	괴산군	사리면	사리면제1투	1728	1304	424	1	1303	874	415	1	0	2	11
충청북도	괴산군	사리면	사리면제2투	815	600	215	1	599	397	194	1	0	2	5
충청북도	괴산군	소수면	소계	1698	1198	500	12	1186	669	509	0	0	5	3
충청북도	괴산군	소수면	소수면투표소	1698	1198	500	12	1186	669	509	0	0	5	3
충청북도	괴산군	불정면	소계	2620	1905	715	12	1893	1256	622	0	2	3	10
충청북도	괴산군	불정면	불정면투표소	2620	1905	715	12	1893	1256	622	0	2	3	10
충청북도	증평군	계	계	26716	19576	7140	86	19490	11175	8223	7	9	22	54
충청북도	증평군	재외투표	재외투표	62	45	17	0	45	22	23	0	0	0	0
충청북도	증평군	국내부재자투표	국내부재자투표	774	730	44	12	718	375	335	4	0	1	3
충청북도	증평군	증평읍	소계	23887	17287	6600	66	17221	9833	7315	2	9	21	41
충청북도	증평군	증평읍	증평읍제1투	2609	2040	569	5	2035	1055	972	0	2	3	3
충청북도	증평군	증평읍	증평읍제2투	2571	1829	742	9	1820	1090	718	2	1	2	7
충청북도	증평군	증평읍	증평읍제3투	2067	1497	570	7	1490	910	572	0	1	1	6
충청북도	증평군	증평읍	증평읍제4투	2875	2085	790	3	2082	1273	804	0	1	3	1
충청북도	증평군	증평읍	증평읍제5투	2935	2145	790	2	2143	1225	909	0	2	3	4
충청북도	증평군	증평읍	증평읍제6투	2318	1719	599	8	1711	824	882	0	2	1	2
충청북도	증평군	증평읍	증평읍제7투	1447	1040	407	9	1031	699	326	0	0	2	4
충청북도	증평군	증평읍	증평읍제8투	3680	2614	1066	7	2607	1390	1210	0	0	3	4
충청북도	증평군	증평읍	증평읍제9투	3385	2318	1067	16	2302	1367	922	0	0	3	10
충청북도	증평군	도안면	소계	1993	1514	479	8	1506	945	550	1	0	0	10
충청북도	증평군	도안면	도안면투표소	1993	1514	479	8	1506	945	550	1	0	0	10
충청남도	천안시서북구	계	계	242354	176358	65996	494	175864	87555	87706	53	97	255	198
충청남도	천안시서북구	재외투표	재외투표	748	497	251	0	497	199	296	0	0	0	2
충청남도	천안시서북구	국내부재자투표	국내부재자투표	5706	5267	439	72	5195	2524	2610	10	11	17	23
충청남도	천안시서북구	성환읍	소계	22965	16370	6595	72	16298	9663	6568	5	13	27	22
충청남도	천안시서북구	성환읍	성환읍제1투	2487	1749	738	6	1743	1052	684	0	1	4	2
충청남도	천안시서북구	성환읍	성환읍제2투	3664	2409	1255	10	2399	1504	888	0	2	4	1
충청남도	천안시서북구	성환읍	성환읍제3투	1742	1349	393	4	1345	744	598	0	2	0	1
충청남도	천안시서북구	성환읍	성환읍제4투	1047	788	259	6	782	538	239	0	0	3	2
충청남도	천안시서북구	성환읍	성환읍제5투	1429	1042	387	7	1035	695	336	0	2	1	1
충청남도	천안시서북구	성환읍	성환읍제6투	2362	1706	656	11	1695	1095	592	1	0	4	3
충청남도	천안시서북구	성환읍	성환읍제7투	3229	2238	991	9	2229	1339	876	2	2	4	6
충청남도	천안시서북구	성환읍	성환읍제8투	875	669	206	2	667	434	228	0	0	3	2
충청남도	천안시서북구	성환읍	성환읍제9투	3526	2436	1090	9	2427	1340	1077	2	3	2	3
충청남도	천안시서북구	성환읍	성환읍제10투	2604	1984	620	8	1976	922	1050	0	1	2	1
충청남도	천안시서북구	성거읍	소계	15358	10849	4509	17	10832	5653	5146	3	5	14	11
충청남도	천안시서북구	성거읍	성거읍제1투	3637	2380	1257	8	2372	1185	1177	0	2	4	4
충청남도	천안시서북구	성거읍	성거읍제2투	2419	1722	697	3	1719	982	730	0	0	1	6
충청남도	천안시서북구	성거읍	성거읍제3투	3617	2876	741	3	2873	1207	1662	1	2	1	0
충청남도	천안시서북구	성거읍	성거읍제4투	3452	2470	982	2	2468	1427	1032	2	1	5	1
충청남도	천안시서북구	성거읍	성거읍제5투	2233	1401	832	1	1400	852	545	0	0	3	0
충청남도	천안시서북구	직산읍	소계	16789	11608	5181	41	11567	6170	5341	5	8	23	20
충청남도	천안시서북구	직산읍	직산읍제1투	1977	1438	539	8	1430	954	460	0	2	6	8
충청남도	천안시서북구	직산읍	직산읍제2투	3404	2420	984	5	2415	1213	1194	1	1	4	2
충청남도	천안시서북구	직산읍	직산읍제3투	3095	2088	1007	13	2075	1222	842	2	0	3	6
충청남도	천안시서북구	직산읍	직산읍제4투	2735	1888	847	6	1882	972	903	0	1	3	3
충청남도	천안시서북구	직산읍	직산읍제5투	2863	1795	1068	6	1789	841	943	0	1	4	0
충청남도	천안시서북구	직산읍	직산읍제6투	2715	1979	736	3	1976	968	999	2	3	3	1
충청남도	천안시서북구	입장면	소계	8651	6007	2644	31	5976	3681	2264	0	6	6	19
충청남도	천안시서북구	입장면	입장면제1투	2961	2000	961	4	1996	1205	785	0	2	1	3
충청남도	천안시서북구	입장면	입장면제2투	1323	985	338	6	979	609	363	0	0	2	5
충청남도	천안시서북구	입장면	입장면제3투	3380	2287	1093	14	2273	1375	888	0	2	2	6
충청남도	천안시서북구	입장면	입장면제4투	987	735	252	7	728	492	228	0	2	1	5
충청남도	천안시서북구	성정1동	소계	15270	9749	5521	20	9729	5522	4167	5	6	21	8
충청남도	천안시서북구	성정1동	성정1동제1투	2457	1625	832	7	1618	1021	587	1	1	4	4
충청남도	천안시서북구	성정1동	성정1동제2투	4892	2904	1988	5	2899	1465	1423	1	3	4	3
충청남도	천안시서북구	성정1동	성정1동제3투	3329	2018	1311	3	2015	1090	917	2	1	4	1
충청남도	천안시서북구	성정1동	성정1동제4투	2310	1439	871	2	1437	938	493	0	1	5	0
충청남도	천안시서북구	성정1동	성정1동제5투	2282	1763	519	3	1760	1008	747	1	0	4	0
충청남도	천안시서북구	성정2동	소계	19953	12280	7673	34	12246	6072	6147	5	2	10	10
충청남도	천안시서북구	성정2동	성정2동제1투	5134	3076	2058	10	3066	1416	1643	1	0	4	2
충청남도	천안시서북구	성정2동	성정2동제2투	3163	2380	783	5	2375	1337	1032	1	1	2	2
충청남도	천안시서북구	성정2동	성정2동제3투	4185	2377	1808	10	2367	1102	1260	1	0	1	3
충청남도	천안시서북구	성정2동	성정2동제4투	4419	2472	1947	5	2467	1210	1254	1	1	1	0
충청남도	천안시서북구	성정2동	성정2동제5투	3052	1975	1077	4	1971	1007	958	1	0	2	3
충청남도	천안시서북구	쌍용1동	소계	12480	9252	3228	18	9234	5011	4194	3	5	15	6
충청남도	천안시서북구	쌍용1동	쌍용1동제1투	3126	2278	848	6	2272	1235	1029	2	1	3	2
충청남도	천안시서북구	쌍용1동	쌍용1동제2투	3673	2542	1131	5	2537	1398	1132	1	2	4	0
충청남도	천안시서북구	쌍용1동	쌍용1동제3투	2506	1998	508	4	1994	1043	946	0	2	1	2
충청남도	천안시서북구	쌍용1동	쌍용1동제4투	3175	2434	741	3	2431	1335	1087	0	0	7	2
충청남도	천안시서북구	쌍용2동	소계	29348	22753	6595	47	22706	10554	12091	4	14	29	14
충청남도	천안시서북구	쌍용2동	쌍용2동제1투	4536	3310	1226	8	3302	1663	1633	0	1	4	1
충청남도	천안시서북구	쌍용2동	쌍용2동제2투	3412	2642	770	7	2635	1299	1328	0	3	3	2
충청남도	천안시서북구	쌍용2동	쌍용2동제3투	2892	2016	876	2	2014	791	1216	1	2	2	2
충청남도	천안시서북구	쌍용2동	쌍용2동제4투	4779	3797	982	10	3787	1668	2107	1	4	5	2
충청남도	천안시서북구	쌍용2동	쌍용2동제5투	2220	1642	578	3	1639	630	1002	0	2	4	1
충청남도	천안시서북구	쌍용2동	쌍용2동제6투	3494	2756	738	4	2752	1259	1484	1	1	4	3
충청남도	천안시서북구	쌍용2동	쌍용2동제7투	3555	3030	525	7	3023	1422	1597	1	0	2	1
충청남도	천안시서북구	쌍용2동	쌍용2동제8투	4460	3560	900	6	3554	1822	1724	0	1	5	2
충청남도	천안시서북구	쌍용3동	소계	15989	12237	3752	36	12201	5985	6167	5	5	19	20
충청남도	천안시서북구	쌍용3동	쌍용3동제1투	3393	2699	694	10	2689	1451	1229	1	1	4	3
충청남도	천안시서북구	쌍용3동	쌍용3동제2투	2794	1953	841	13	1940	1065	854	2	2	8	9
충청남도	천안시서북구	쌍용3동	쌍용3동제3투	2095	1593	502	3	1590	807	778	2	0	0	3
충청남도	천안시서북구	쌍용3동	쌍용3동제4투	2795	2097	698	4	2093	804	1284	0	1	1	3
충청남도	천안시서북구	쌍용3동	쌍용3동제5투	2806	2187	619	2	2185	873	1309	0	0	2	1
충청남도	천안시서북구	쌍용3동	쌍용3동제6투	2106	1708	398	4	1704	985	713	0	1	4	1
충청남도	천안시서북구	백석동	소계	34514	27303	7211	39	27264	12441	14752	3	10	41	17
충청남도	천안시서북구	백석동	백석동제1투	5163	4188	975	10	4178	1935	2231	0	2	8	2
충청남도	천안시서북구	백석동	백석동제2투	4110	3341	769	6	3335	1364	1969	0	0	0	2
충청남도	천안시서북구	백석동	백석동제3투	5026	3827	1199	6	3821	1767	2042	0	3	6	3
충청남도	천안시서북구	백석동	백석동제4투	4330	3264	1066	3	3261	1501	1748	1	1	7	3
충청남도	천안시서북구	백석동	백석동제5투	2411	1913	498	2	1911	1011	896	0	0	4	0
충청남도	천안시서북구	백석동	백석동제6투	3593	2806	787	3	2803	1323	1471	2	0	4	3
충청남도	천안시서북구	백석동	백석동제7투	4363	3474	889	4	3470	1508	1954	0	1	5	2
충청남도	천안시서북구	백석동	백석동제8투	3259	2585	674	3	2582	1144	1431	0	1	4	2
충청남도	천안시서북구	백석동	백석동제9투	2259	1905	354	2	1903	888	1010	0	2	3	0
충청남도	천안시서북구	부성동	소계	44583	32186	12397	67	32119	14080	17963	5	12	33	26
충청남도	천안시서북구	부성동	부성동제1투	2314	1808	506	4	1804	791	1006	0	2	3	2
충청남도	천안시서북구	부성동	부성동제2투	2959	2043	916	5	2038	1183	845	1	0	2	7
충청남도	천안시서북구	부성동	부성동제3투	1694	1174	520	7	1167	751	410	0	1	2	3
충청남도	천안시서북구	부성동	부성동제4투	4054	2944	1110	6	2938	1203	1729	0	2	2	2
충청남도	천안시서북구	부성동	부성동제5투	3177	2571	606	5	2566	1230	1331	1	0	1	3
충청남도	천안시서북구	부성동	부성동제6투	4594	3087	1507	3	3084	1194	1886	0	0	3	1
충청남도	천안시서북구	부성동	부성동제7투	4886	3288	1598	6	3282	1293	1981	0	2	4	2
충청남도	천안시서북구	부성동	부성동제8투	2915	2374	541	4	2370	1106	1255	1	0	6	2
충청남도	천안시서북구	부성동	부성동제9투	5010	3363	1647	9	3354	1348	1997	1	3	4	1
충청남도	천안시서북구	부성동	부성동제10투	3411	2444	967	3	2441	976	1463	0	0	1	1
충청남도	천안시서북구	부성동	부성동제11투	1764	1382	382	3	1379	590	787	0	0	1	1
충청남도	천안시서북구	부성동	부성동제12투	3110	2301	809	6	2295	961	1331	1	1	1	0
충청남도	천안시서북구	부성동	부성동제13투	4695	3407	1288	6	3401	1454	1942	0	1	3	1
충청남도	천안시동남구	계	계	199108	144876	54232	427	144449	78289	65604	47	49	213	247
충청남도	천안시동남구	재외투표	재외투표	687	468	219	1	467	166	301	0	0	0	0
충청남도	천안시동남구	국내부재자투표	국내부재자투표	4465	4140	325	70	4070	1980	2058	8	4	7	13
충청남도	천안시동남구	목천읍	소계	19260	13561	5699	31	13530	6887	6592	2	3	20	26
충청남도	천안시동남구	목천읍	목천읍제1투	2910	2034	876	1	2033	1192	835	0	1	3	2
충청남도	천안시동남구	목천읍	목천읍제2투	1699	1251	448	1	1250	743	502	0	0	1	4
충청남도	천안시동남구	목천읍	목천읍제3투	762	533	229	7	526	371	149	0	0	2	4
충청남도	천안시동남구	목천읍	목천읍제4투	1009	737	272	2	735	472	258	0	0	1	4
충청남도	천안시동남구	목천읍	목천읍제5투	3023	1998	1025	4	1994	1032	957	0	0	2	3
충청남도	천안시동남구	목천읍	목천읍제6투	3393	2480	913	6	2474	1076	1387	2	1	5	3
충청남도	천안시동남구	목천읍	목천읍제7투	1658	1197	461	3	1194	557	634	0	0	1	2
충청남도	천안시동남구	목천읍	목천읍제8투	4806	3331	1475	7	3324	1444	1870	0	1	5	4
충청남도	천안시동남구	풍세면	소계	4022	2950	1072	11	2939	1929	984	2	2	6	16
충청남도	천안시동남구	풍세면	풍세면제1투	1536	1125	411	4	1121	718	394	0	0	4	5
충청남도	천안시동남구	풍세면	풍세면제2투	837	616	221	2	614	419	187	1	1	1	5
충청남도	천안시동남구	풍세면	풍세면제3투	1649	1209	440	5	1204	792	403	1	1	1	6
충청남도	천안시동남구	광덕면	소계	3880	2760	1120	18	2742	1806	916	0	0	6	14
충청남도	천안시동남구	광덕면	광덕면제1투	1500	1002	498	6	996	700	292	0	0	1	3
충청남도	천안시동남구	광덕면	광덕면제2투	1436	1085	351	8	1077	693	373	0	0	4	7
충청남도	천안시동남구	광덕면	광덕면제3투	944	673	271	4	669	413	251	0	0	1	4
충청남도	천안시동남구	북면	소계	4113	2784	1329	10	2774	1696	1057	1	1	8	11
충청남도	천안시동남구	북면	북면제1투	2635	1735	900	6	1729	997	723	1	1	2	5
충청남도	천안시동남구	북면	북면제2투	730	508	222	0	508	332	169	0	0	3	4
충청남도	천안시동남구	북면	북면제3투	748	541	207	4	537	367	165	0	0	3	2
충청남도	천안시동남구	성남면	소계	3250	2365	885	12	2353	1537	791	1	1	6	17
충청남도	천안시동남구	성남면	성남면제1투	1152	875	277	2	873	585	283	0	0	1	4
충청남도	천안시동남구	성남면	성남면제2투	2098	1490	608	10	1480	952	508	1	1	5	13
충청남도	천안시동남구	수신면	소계	2192	1614	578	8	1606	1059	528	1	1	0	17
충청남도	천안시동남구	수신면	수신면제1투	1427	1063	364	5	1058	700	348	0	1	0	9
충청남도	천안시동남구	수신면	수신면제2투	765	551	214	3	548	359	180	1	0	0	8
충청남도	천안시동남구	병천면	소계	5470	3841	1629	12	3829	2334	1475	1	1	3	15
충청남도	천안시동남구	병천면	병천면제1투	3133	2154	979	5	2149	1273	870	1	0	1	4
충청남도	천안시동남구	병천면	병천면제2투	1520	1085	435	7	1078	678	393	0	1	1	5
충청남도	천안시동남구	병천면	병천면제3투	817	602	215	0	602	383	212	0	0	1	6
충청남도	천안시동남구	동면	소계	2174	1602	572	20	1582	1086	470	2	1	6	17
충청남도	천안시동남구	동면	동면투표소	2174	1602	572	20	1582	1086	470	2	1	6	17
충청남도	천안시동남구	중앙동	소계	5296	3645	1651	8	3637	2469	1158	3	1	6	0
충청남도	천안시동남구	중앙동	중앙동제1투	1677	1124	553	1	1123	752	368	1	1	1	0
충청남도	천안시동남구	중앙동	중앙동제2투	1707	1207	500	2	1205	859	342	0	0	4	0
충청남도	천안시동남구	중앙동	중앙동제3투	1912	1314	598	5	1309	858	448	2	0	1	0
충청남도	천안시동남구	문성동	소계	4426	2835	1591	6	2829	1737	1085	0	0	3	4
충청남도	천안시동남구	문성동	문성동제1투	1831	1086	745	1	1085	686	397	0	0	1	1
충청남도	천안시동남구	문성동	문성동제2투	2595	1749	846	5	1744	1051	688	0	0	2	3
충청남도	천안시동남구	원성1동	소계	8468	5946	2522	13	5933	3657	2255	2	2	12	5
충청남도	천안시동남구	원성1동	원성1동제1투	2697	1919	778	5	1914	1138	773	0	1	0	2
충청남도	천안시동남구	원성1동	원성1동제2투	2165	1430	735	4	1426	875	537	2	1	8	3
충청남도	천안시동남구	원성1동	원성1동제3투	2196	1549	647	3	1546	984	559	0	0	3	0
충청남도	천안시동남구	원성1동	원성1동제4투	1410	1048	362	1	1047	660	386	0	0	1	0
충청남도	천안시동남구	원성2동	소계	10438	7313	3125	25	7288	4484	2780	1	5	11	7
충청남도	천안시동남구	원성2동	원성2동제1투	2085	1493	592	6	1487	954	526	0	0	4	3
충청남도	천안시동남구	원성2동	원성2동제2투	3046	2223	823	10	2213	1351	855	1	2	1	3
충청남도	천안시동남구	원성2동	원성2동제3투	2250	1548	702	3	1545	917	623	0	1	4	0
충청남도	천안시동남구	원성2동	원성2동제4투	3057	2049	1008	6	2043	1262	776	0	2	2	1
충청남도	천안시동남구	봉명동	소계	16749	11117	5632	24	11093	6061	4998	1	5	14	14
충청남도	천안시동남구	봉명동	봉명동제1투	2930	1708	1222	1	1707	895	801	0	2	5	4
충청남도	천안시동남구	봉명동	봉명동제2투	3524	2289	1235	7	2282	1289	989	0	0	0	4
충청남도	천안시동남구	봉명동	봉명동제3투	2019	1261	758	3	1258	768	486	0	0	3	1
충청남도	천안시동남구	봉명동	봉명동제4투	2222	1497	725	4	1493	943	545	1	2	2	0
충청남도	천안시동남구	봉명동	봉명동제5투	3537	2563	974	6	2557	1359	1191	0	1	4	2
충청남도	천안시동남구	봉명동	봉명동제6투	2517	1799	718	3	1796	807	986	0	0	0	3
충청남도	천안시동남구	일봉동	소계	17189	12916	4273	29	12887	6731	6130	1	0	14	11
충청남도	천안시동남구	일봉동	일봉동제1투	3998	2669	1329	14	2655	1529	1116	1	0	4	5
충청남도	천안시동남구	일봉동	일봉동제2투	2982	2221	761	7	2214	1203	1010	0	0	0	1
충청남도	천안시동남구	일봉동	일봉동제3투	3132	2251	881	2	2249	1275	967	0	0	4	3
충청남도	천안시동남구	일봉동	일봉동제4투	4117	3379	738	4	3375	1663	1708	0	0	4	0
충청남도	천안시동남구	일봉동	일봉동제5투	2960	2396	564	2	2394	1061	1329	0	0	2	2
충청남도	천안시동남구	신방동	소계	28765	21822	6943	29	21793	10160	11577	8	5	27	16
충청남도	천안시동남구	신방동	신방동제1투	2924	2327	597	2	2325	1180	1140	0	0	2	3
충청남도	천안시동남구	신방동	신방동제2투	3177	2602	575	4	2598	1195	1396	1	0	5	1
충청남도	천안시동남구	신방동	신방동제3투	3846	3092	754	7	3085	1336	1742	2	1	1	3
충청남도	천안시동남구	신방동	신방동제4투	3004	2463	541	2	2461	1123	1332	1	0	4	1
충청남도	천안시동남구	신방동	신방동제5투	2987	1867	1120	0	1867	893	972	0	0	2	0
충청남도	천안시동남구	신방동	신방동제6투	3184	1933	1251	3	1930	908	1015	0	1	4	2
충청남도	천안시동남구	신방동	신방동제7투	1575	1115	460	3	1112	585	521	0	1	4	1
충청남도	천안시동남구	신방동	신방동제8투	3383	2739	644	5	2734	1408	1319	3	1	1	2
충청남도	천안시동남구	신방동	신방동제9투	4685	3684	1001	3	3681	1532	2140	1	1	4	3
충청남도	천안시동남구	청룡동	소계	31640	24131	7509	51	24080	12522	11482	10	6	34	26
충청남도	천안시동남구	청룡동	청룡동제1투	3272	2364	908	3	2361	1415	936	4	1	3	2
충청남도	천안시동남구	청룡동	청룡동제2투	3017	2341	676	3	2338	1358	969	1	0	5	5
충청남도	천안시동남구	청룡동	청룡동제3투	5050	4000	1050	7	3993	1912	2075	0	0	4	2
충청남도	천안시동남구	청룡동	청룡동제4투	4786	3789	997	6	3783	1897	1877	0	1	2	6
충청남도	천안시동남구	청룡동	청룡동제5투	4433	3193	1240	6	3187	1891	1284	1	1	6	4
충청남도	천안시동남구	청룡동	청룡동제6투	1441	942	499	8	934	626	301	0	1	2	4
충청남도	천안시동남구	청룡동	청룡동제7투	4215	3377	838	9	3368	1563	1794	3	2	5	1
충청남도	천안시동남구	청룡동	청룡동제8투	2099	1618	481	4	1614	673	933	1	0	5	2
충청남도	천안시동남구	청룡동	청룡동제9투	3327	2507	820	5	2502	1187	1313	0	0	2	0
충청남도	천안시동남구	신안동	소계	26624	19066	7558	49	19017	9988	8967	3	11	30	18
충청남도	천안시동남구	신안동	신안동제1투	3391	2233	1158	6	2227	1176	1047	0	0	3	1
충청남도	천안시동남구	신안동	신안동제2투	2227	1469	758	4	1465	855	604	0	0	1	5
충청남도	천안시동남구	신안동	신안동제3투	2735	1819	916	7	1812	991	817	0	1	0	3
충청남도	천안시동남구	신안동	신안동제4투	3514	2701	813	6	2695	1466	1217	1	1	6	4
충청남도	천안시동남구	신안동	신안동제5투	4024	3103	921	6	3097	1477	1607	1	6	4	2
충청남도	천안시동남구	신안동	신안동제6투	3400	2482	918	6	2476	1189	1284	0	0	3	0
충청남도	천안시동남구	신안동	신안동제7투	1550	917	633	5	912	531	377	1	1	1	1
충청남도	천안시동남구	신안동	신안동제8투	3025	2165	860	6	2159	987	1162	0	1	8	1
충청남도	천안시동남구	신안동	신안동제9투	2758	2177	581	3	2174	1316	852	0	1	4	1
충청남도	공주시	계	계	96127	70778	25349	358	70420	39883	30141	39	30	109	218
충청남도	공주시	재외투표	재외투표	288	203	85	2	201	86	113	0	0	2	0
충청남도	공주시	국내부재자투표	국내부재자투표	2793	2575	218	43	2532	1178	1329	6	7	5	7
충청남도	공주시	유구읍	소계	7408	5264	2144	32	5232	3538	1665	1	0	8	20
충청남도	공주시	유구읍	유구읍제1투	2034	1422	612	5	1417	967	445	1	0	3	1
충청남도	공주시	유구읍	유구읍제2투	1621	1179	442	6	1173	778	392	0	0	0	3
충청남도	공주시	유구읍	유구읍제3투	2219	1602	617	12	1590	1118	461	0	0	2	9
충청남도	공주시	유구읍	유구읍제4투	1534	1061	473	9	1052	675	367	0	0	3	7
충청남도	공주시	이인면	소계	3394	2503	891	13	2490	1561	907	1	1	3	17
충청남도	공주시	이인면	이인면제1투	1895	1387	508	2	1385	908	468	1	0	2	6
충청남도	공주시	이인면	이인면제2투	1499	1116	383	11	1105	653	439	0	1	1	11
충청남도	공주시	탄천면	소계	3071	2139	932	25	2114	1271	817	3	3	6	14
충청남도	공주시	탄천면	탄천면제1투	2022	1393	629	20	1373	841	515	2	1	3	11
충청남도	공주시	탄천면	탄천면제2투	1049	746	303	5	741	430	302	1	2	3	3
충청남도	공주시	계룡면	소계	5589	3984	1605	21	3963	2386	1552	3	2	7	13
충청남도	공주시	계룡면	계룡면제1투	2041	1448	593	12	1436	811	615	0	1	2	7
충청남도	공주시	계룡면	계룡면제2투	586	417	169	2	415	262	150	0	0	1	2
충청남도	공주시	계룡면	계룡면제3투	1106	807	299	1	806	531	268	3	0	2	2
충청남도	공주시	계룡면	계룡면제4투	1856	1312	544	6	1306	782	519	0	1	2	2
충청남도	공주시	반포면	소계	4153	3005	1148	33	2972	1774	1166	4	2	11	15
충청남도	공주시	반포면	반포면제1투	2458	1774	684	26	1748	1019	708	4	2	6	9
충청남도	공주시	반포면	반포면제2투	1695	1231	464	7	1224	755	458	0	0	5	6
충청남도	공주시	의당면	소계	4620	3298	1322	14	3284	1806	1459	2	1	5	11
충청남도	공주시	의당면	의당면제1투	2524	1737	787	7	1730	910	813	0	1	2	4
충청남도	공주시	의당면	의당면제2투	885	688	197	4	684	371	308	0	0	3	2
충청남도	공주시	의당면	의당면제3투	1211	873	338	3	870	525	338	2	0	0	5
충청남도	공주시	정안면	소계	4678	3353	1325	15	3338	2101	1207	3	1	6	20
충청남도	공주시	정안면	정안면제1투	1612	1190	422	6	1184	815	363	1	0	2	3
충청남도	공주시	정안면	정안면제2투	1089	777	312	7	770	468	294	1	1	1	5
충청남도	공주시	정안면	정안면제3투	1977	1386	591	2	1384	818	550	1	0	3	12
충청남도	공주시	우성면	소계	5235	3839	1396	21	3818	2238	1556	3	0	3	18
충청남도	공주시	우성면	우성면제1투	1150	828	322	7	821	522	295	0	0	0	4
충청남도	공주시	우성면	우성면제2투	1306	961	345	1	960	552	401	1	0	0	6
충청남도	공주시	우성면	우성면제3투	1693	1276	417	7	1269	660	601	2	0	3	3
충청남도	공주시	우성면	우성면제4투	1086	774	312	6	768	504	259	0	0	0	5
충청남도	공주시	사곡면	소계	2944	2197	747	16	2181	1342	808	3	2	5	21
충청남도	공주시	사곡면	사곡면제1투	1800	1336	464	8	1328	840	470	1	1	4	12
충청남도	공주시	사곡면	사곡면제2투	1144	861	283	8	853	502	338	2	1	1	9
충청남도	공주시	신풍면	소계	3018	2161	857	8	2153	1396	741	0	0	0	16
충청남도	공주시	신풍면	신풍면제1투	2093	1485	608	5	1480	989	481	0	0	0	10
충청남도	공주시	신풍면	신풍면제2투	925	676	249	3	673	407	260	0	0	0	6
충청남도	공주시	중학동	소계	5302	3844	1458	11	3833	2183	1634	2	2	6	6
충청남도	공주시	중학동	중학동제1투	1176	799	377	7	792	456	332	0	1	1	2
충청남도	공주시	중학동	중학동제2투	1312	952	360	1	951	556	390	1	1	2	1
충청남도	공주시	중학동	중학동제3투	1410	1056	354	1	1055	595	456	1	0	1	2
충청남도	공주시	중학동	중학동제4투	1404	1037	367	2	1035	576	456	0	0	2	1
충청남도	공주시	웅진동	소계	7569	5541	2028	20	5521	3168	2334	1	3	9	6
충청남도	공주시	웅진동	웅진동제1투	1273	847	426	1	846	496	349	0	0	1	0
충청남도	공주시	웅진동	웅진동제2투	1685	1205	480	6	1199	713	481	1	0	4	0
충청남도	공주시	웅진동	웅진동제3투	2693	2076	617	6	2070	1207	853	0	2	4	4
충청남도	공주시	웅진동	웅진동제4투	1918	1413	505	7	1406	752	651	0	1	0	2
충청남도	공주시	금학동	소계	4684	3433	1251	22	3411	1865	1535	1	0	5	5
충청남도	공주시	금학동	금학동제1투	3188	2404	784	6	2398	1198	1192	0	0	3	5
충청남도	공주시	금학동	금학동제2투	1496	1029	467	16	1013	667	343	1	0	2	0
충청남도	공주시	옥룡동	소계	8720	6216	2504	26	6190	3439	2727	3	3	8	10
충청남도	공주시	옥룡동	옥룡동제1투	1756	1332	424	3	1329	752	577	0	0	0	0
충청남도	공주시	옥룡동	옥룡동제2투	1286	880	406	3	877	517	355	0	1	1	3
충청남도	공주시	옥룡동	옥룡동제3투	2424	1686	738	7	1679	918	756	0	0	3	2
충청남도	공주시	옥룡동	옥룡동제4투	2039	1446	593	7	1439	741	692	1	0	2	3
충청남도	공주시	옥룡동	옥룡동제5투	1215	872	343	6	866	511	347	2	2	2	2
충청남도	공주시	신관동	소계	14932	11085	3847	24	11061	5558	5478	1	2	11	11
충청남도	공주시	신관동	신관동제1투	3041	2280	761	0	2280	1190	1087	0	1	2	0
충청남도	공주시	신관동	신관동제2투	3230	2529	701	8	2521	1219	1293	1	1	3	4
충청남도	공주시	신관동	신관동제3투	2716	2018	698	7	2011	947	1057	0	0	2	5
충청남도	공주시	신관동	신관동제4투	3103	2107	996	4	2103	999	1101	0	0	2	1
충청남도	공주시	신관동	신관동제5투	2842	2151	691	5	2146	1203	940	0	0	2	1
충청남도	공주시	월송동	소계	7729	6138	1591	12	6126	2993	3113	2	1	9	8
충청남도	공주시	월송동	월송동제1투	3780	3005	775	6	2999	1339	1651	2	0	4	3
충청남도	공주시	월송동	월송동제2투	3050	2459	591	3	2456	1245	1204	0	0	4	3
충청남도	공주시	월송동	월송동제3투	899	674	225	3	671	409	258	0	1	1	2
충청남도	보령시	계	계	86140	62879	23261	342	62537	38636	23493	33	34	108	233
충청남도	보령시	재외투표	재외투표	198	146	52	0	146	60	85	0	0	0	1
충청남도	보령시	국내부재자투표	국내부재자투표	3006	2675	331	42	2633	1215	1393	4	3	10	8
충청남도	보령시	웅천읍	소계	6168	4395	1773	27	4368	2974	1364	0	0	7	23
충청남도	보령시	웅천읍	웅천읍제1투	2282	1616	666	4	1612	1079	528	0	0	1	4
충청남도	보령시	웅천읍	웅천읍제2투	2304	1633	671	13	1620	1131	474	0	0	4	11
충청남도	보령시	웅천읍	웅천읍제3투	1582	1146	436	10	1136	764	362	0	0	2	8
충청남도	보령시	주포면	소계	1521	1090	431	4	1086	673	401	1	0	4	7
충청남도	보령시	주포면	주포면투표소	1521	1090	431	4	1086	673	401	1	0	4	7
충청남도	보령시	주교면	소계	4758	3297	1461	46	3251	1993	1215	3	4	12	24
충청남도	보령시	주교면	주교면제1투	2800	1913	887	38	1875	1127	718	2	4	9	15
충청남도	보령시	주교면	주교면제2투	1958	1384	574	8	1376	866	497	1	0	3	9
충청남도	보령시	오천면	소계	4559	3048	1511	22	3026	2100	900	5	3	3	15
충청남도	보령시	오천면	오천면제1투	1278	924	354	4	920	623	290	1	1	1	4
충청남도	보령시	오천면	오천면제2투	657	472	185	2	470	321	146	0	1	0	2
충청남도	보령시	오천면	오천면제3투	293	188	105	2	186	122	64	0	0	0	0
충청남도	보령시	오천면	오천면제4투	920	592	328	9	583	441	134	1	1	0	6
충청남도	보령시	오천면	오천면제5투	380	220	160	1	219	155	62	0	0	1	1
충청남도	보령시	오천면	오천면제6투	168	117	51	1	116	94	21	0	0	0	1
충청남도	보령시	오천면	오천면제7투	191	153	38	2	151	86	63	2	0	0	0
충청남도	보령시	오천면	오천면제8투	153	93	60	0	93	68	24	0	0	1	0
충청남도	보령시	오천면	오천면제9투	164	103	61	0	103	80	22	0	0	0	1
충청남도	보령시	오천면	오천면제10투	355	186	169	1	185	110	74	1	0	0	0
충청남도	보령시	천북면	소계	3484	2511	973	18	2493	1484	981	2	0	4	22
충청남도	보령시	천북면	천북면제1투	2364	1699	665	10	1689	999	674	2	0	2	12
충청남도	보령시	천북면	천북면제2투	1120	812	308	8	804	485	307	0	0	2	10
충청남도	보령시	청소면	소계	2756	2068	688	12	2056	1449	588	3	2	5	9
충청남도	보령시	청소면	청소면제1투	1847	1387	460	9	1378	989	374	3	2	3	7
충청남도	보령시	청소면	청소면제2투	909	681	228	3	678	460	214	0	0	2	2
충청남도	보령시	청라면	소계	3755	2742	1013	12	2730	1881	824	5	5	5	10
충청남도	보령시	청라면	청라면제1투	1333	970	363	5	965	673	283	2	2	2	3
충청남도	보령시	청라면	청라면제2투	1350	996	354	5	991	691	291	1	2	1	5
충청남도	보령시	청라면	청라면제3투	1072	776	296	2	774	517	250	2	1	2	2
충청남도	보령시	남포면	소계	4804	3454	1350	27	3427	2237	1152	0	3	4	31
충청남도	보령시	남포면	남포면제1투	1811	1307	504	11	1296	843	443	0	0	2	8
충청남도	보령시	남포면	남포면제2투	1819	1304	515	9	1295	862	417	0	1	0	15
충청남도	보령시	남포면	남포면제3투	1174	843	331	7	836	532	292	0	2	2	8
충청남도	보령시	주산면	소계	2516	1932	584	16	1916	1235	661	1	1	3	15
충청남도	보령시	주산면	주산면제1투	1881	1463	418	10	1453	979	462	1	0	1	10
충청남도	보령시	주산면	주산면제2투	635	469	166	6	463	256	199	0	1	2	5
충청남도	보령시	미산면	소계	1727	1316	411	14	1302	926	365	0	0	1	10
충청남도	보령시	미산면	미산면제1투	606	456	150	5	451	316	131	0	0	1	3
충청남도	보령시	미산면	미산면제2투	586	452	134	5	447	316	126	0	0	0	5
충청남도	보령시	미산면	미산면제3투	535	408	127	4	404	294	108	0	0	0	2
충청남도	보령시	성주면	소계	2373	1616	757	6	1610	1011	588	1	1	3	6
충청남도	보령시	성주면	성주면제1투	1690	1131	559	5	1126	723	395	1	1	2	4
충청남도	보령시	성주면	성주면제2투	683	485	198	1	484	288	193	0	0	1	2
충청남도	보령시	대천1동	소계	12191	9126	3065	16	9110	5260	3825	3	2	13	7
충청남도	보령시	대천1동	대천1동제1투	2232	1577	655	3	1574	1077	493	1	0	2	1
충청남도	보령시	대천1동	대천1동제2투	3667	2773	894	4	2769	1422	1337	1	2	5	2
충청남도	보령시	대천1동	대천1동제3투	2323	1643	680	7	1636	1055	576	1	0	3	1
충청남도	보령시	대천1동	대천1동제4투	3969	3133	836	2	3131	1706	1419	0	0	3	3
충청남도	보령시	대천2동	소계	5676	4145	1531	10	4135	2666	1454	1	2	7	5
충청남도	보령시	대천2동	대천2동제1투	1939	1403	536	5	1398	910	485	1	1	0	1
충청남도	보령시	대천2동	대천2동제2투	1120	805	315	0	805	599	202	0	0	2	2
충청남도	보령시	대천2동	대천2동제3투	2617	1937	680	5	1932	1157	767	0	1	5	2
충청남도	보령시	대천3동	소계	9854	7171	2683	26	7145	4197	2921	2	3	9	13
충청남도	보령시	대천3동	대천3동제1투	2697	1869	828	6	1863	1187	669	0	2	1	4
충청남도	보령시	대천3동	대천3동제2투	2258	1775	483	6	1769	917	841	2	0	6	3
충청남도	보령시	대천3동	대천3동제3투	2606	1838	768	7	1831	1138	690	0	0	1	2
충청남도	보령시	대천3동	대천3동제4투	2293	1689	604	7	1682	955	721	0	1	1	4
충청남도	보령시	대천4동	소계	10615	7872	2743	30	7842	4432	3379	1	3	12	15
충청남도	보령시	대천4동	대천4동제1투	1294	890	404	8	882	552	325	0	0	2	3
충청남도	보령시	대천4동	대천4동제2투	2235	1736	499	7	1729	1015	712	0	1	1	0
충청남도	보령시	대천4동	대천4동제3투	2555	1832	723	9	1823	1098	712	1	0	3	9
충청남도	보령시	대천4동	대천4동제4투	4531	3414	1117	6	3408	1767	1630	0	2	6	3
충청남도	보령시	대천5동	소계	6179	4275	1904	14	4261	2843	1397	1	2	6	12
충청남도	보령시	대천5동	대천5동제1투	1745	1236	509	6	1230	842	384	0	0	0	4
충청남도	보령시	대천5동	대천5동제2투	2142	1411	731	4	1407	924	477	0	1	4	1
충청남도	보령시	대천5동	대천5동제3투	2292	1628	664	4	1624	1077	536	1	1	2	7
충청남도	아산시	계	계	212382	154698	57684	500	154198	81388	72189	51	101	232	237
충청남도	아산시	재외투표	재외투표	615	417	198	2	415	165	248	0	0	2	0
충청남도	아산시	국내부재자투표	국내부재자투표	4604	4252	352	90	4162	2085	2030	6	12	19	10
충청남도	아산시	염치읍	소계	6144	4273	1871	17	4256	2625	1612	2	1	6	10
충청남도	아산시	염치읍	염치읍제1투	1582	1130	452	11	1119	712	401	1	0	2	3
충청남도	아산시	염치읍	염치읍제2투	1928	1323	605	3	1320	756	558	0	1	2	3
충청남도	아산시	염치읍	염치읍제3투	2634	1820	814	3	1817	1157	653	1	0	2	4
충청남도	아산시	배방읍	소계	44689	33756	10933	79	33677	14710	18876	11	6	46	28
충청남도	아산시	배방읍	배방읍제1투	924	680	244	1	679	461	215	0	0	0	3
충청남도	아산시	배방읍	배방읍제2투	4098	2751	1347	12	2739	1512	1221	2	0	1	3
충청남도	아산시	배방읍	배방읍제3투	2289	1828	461	2	1826	730	1091	1	0	4	0
충청남도	아산시	배방읍	배방읍제4투	3367	2785	582	8	2777	1135	1635	0	1	5	1
충청남도	아산시	배방읍	배방읍제5투	5058	3406	1652	8	3398	1148	2242	1	1	5	1
충청남도	아산시	배방읍	배방읍제6투	2498	2000	498	0	2000	838	1158	0	1	2	1
충청남도	아산시	배방읍	배방읍제7투	3760	2736	1024	8	2728	1054	1669	1	0	3	1
충청남도	아산시	배방읍	배방읍제8투	1809	1252	557	5	1247	791	445	3	0	3	5
충청남도	아산시	배방읍	배방읍제9투	3775	3099	676	3	3096	1246	1844	0	1	3	2
충청남도	아산시	배방읍	배방읍제10투	1259	882	377	2	880	547	326	0	0	3	4
충청남도	아산시	배방읍	배방읍제11투	2032	1430	602	4	1426	654	767	1	1	2	1
충청남도	아산시	배방읍	배방읍제12투	4040	3172	868	9	3163	1354	1806	1	0	1	1
충청남도	아산시	배방읍	배방읍제13투	3759	2898	861	7	2891	1208	1675	1	1	4	2
충청남도	아산시	배방읍	배방읍제14투	2808	2354	454	2	2352	1041	1307	0	0	4	0
충청남도	아산시	배방읍	배방읍제15투	1593	1338	255	3	1335	559	774	0	0	1	1
충청남도	아산시	배방읍	배방읍제16투	1620	1145	475	5	1140	432	701	0	0	5	2
충청남도	아산시	송악면	소계	3234	2377	857	16	2361	1541	809	1	2	3	5
충청남도	아산시	송악면	송악면제1투	1608	1175	433	7	1168	773	393	0	1	1	0
충청남도	아산시	송악면	송악면제2투	1066	785	281	7	778	489	283	1	1	1	3
충청남도	아산시	송악면	송악면제3투	560	417	143	2	415	279	133	0	0	1	2
충청남도	아산시	탕정면	소계	13397	9442	3955	16	9426	3739	5659	2	6	9	11
충청남도	아산시	탕정면	탕정면제1투	2740	1784	956	4	1780	1025	749	0	0	4	2
충청남도	아산시	탕정면	탕정면제2투	3142	1990	1152	2	1988	917	1057	1	5	1	7
충청남도	아산시	탕정면	탕정면제3투	3202	1999	1203	2	1997	438	1558	0	0	0	1
충청남도	아산시	탕정면	탕정면제4투	4313	3669	644	8	3661	1359	2295	1	1	4	1
충청남도	아산시	음봉면	소계	12191	8449	3742	23	8426	4402	3990	3	4	12	15
충청남도	아산시	음봉면	음봉면제1투	1708	1208	500	4	1204	791	406	1	1	1	4
충청남도	아산시	음봉면	음봉면제2투	3394	2311	1083	2	2309	1083	1220	1	1	1	3
충청남도	아산시	음봉면	음봉면제3투	1481	1108	373	5	1103	714	383	0	0	2	4
충청남도	아산시	음봉면	음봉면제4투	3932	2877	1055	10	2867	1421	1435	0	2	5	4
충청남도	아산시	음봉면	음봉면제5투	1676	945	731	2	943	393	546	1	0	3	0
충청남도	아산시	둔포면	소계	8542	5996	2546	20	5976	3886	2060	1	5	12	12
충청남도	아산시	둔포면	둔포면제1투	2019	1394	625	2	1392	930	457	0	1	0	4
충청남도	아산시	둔포면	둔포면제2투	1068	777	291	3	774	544	228	0	0	1	1
충청남도	아산시	둔포면	둔포면제3투	1584	1116	468	7	1109	745	361	0	0	1	2
충청남도	아산시	둔포면	둔포면제4투	1291	915	376	0	915	594	318	1	0	1	1
충청남도	아산시	둔포면	둔포면제5투	2580	1794	786	8	1786	1073	696	0	4	9	4
충청남도	아산시	영인면	소계	5581	4094	1487	21	4073	2604	1446	2	2	2	17
충청남도	아산시	영인면	영인면제1투	1820	1254	566	4	1250	776	472	0	0	0	2
충청남도	아산시	영인면	영인면제2투	1286	1004	282	3	1001	644	352	0	0	0	5
충청남도	아산시	영인면	영인면제3투	1644	1220	424	9	1211	805	393	2	2	2	7
충청남도	아산시	영인면	영인면제4투	831	616	215	5	611	379	229	0	0	0	3
충청남도	아산시	인주면	소계	6578	4605	1973	17	4588	2493	2061	2	5	12	15
충청남도	아산시	인주면	인주면제1투	1971	1381	590	8	1373	725	638	1	3	2	4
충청남도	아산시	인주면	인주면제2투	2580	1739	841	4	1735	1040	679	1	1	8	6
충청남도	아산시	인주면	인주면제3투	2027	1485	542	5	1480	728	744	0	1	2	5
충청남도	아산시	선장면	소계	3392	2506	886	9	2497	1816	661	0	2	7	11
충청남도	아산시	선장면	선장면제1투	1269	940	329	4	936	693	239	0	0	2	2
충청남도	아산시	선장면	선장면제2투	1103	773	330	5	768	554	208	0	1	1	4
충청남도	아산시	선장면	선장면제3투	1020	793	227	0	793	569	214	0	1	4	5
충청남도	아산시	도고면	소계	4356	3247	1109	16	3231	2300	914	2	1	4	10
충청남도	아산시	도고면	도고면제1투	2099	1557	542	7	1550	1065	478	1	1	1	4
충청남도	아산시	도고면	도고면제2투	1187	879	308	4	875	594	278	1	0	2	0
충청남도	아산시	도고면	도고면제3투	1070	811	259	5	806	641	158	0	0	1	6
충청남도	아산시	신창면	소계	15560	10751	4809	38	10713	5896	4777	2	12	10	16
충청남도	아산시	신창면	신창면제1투	1697	1171	526	6	1165	781	377	1	1	2	3
충청남도	아산시	신창면	신창면제2투	1020	735	285	3	732	505	225	0	0	0	2
충청남도	아산시	신창면	신창면제3투	2024	1344	680	9	1335	844	489	0	0	0	2
충청남도	아산시	신창면	신창면제4투	2948	2008	940	5	2003	1094	899	0	4	1	5
충청남도	아산시	신창면	신창면제5투	4238	3067	1171	9	3058	1533	1512	1	3	7	2
충청남도	아산시	신창면	신창면제6투	3633	2426	1207	6	2420	1139	1275	0	4	0	2
충청남도	아산시	온양1동	소계	5494	3763	1731	6	3757	2450	1294	2	3	1	7
충청남도	아산시	온양1동	온양1동제1투	1165	784	381	3	781	554	221	2	1	0	3
충청남도	아산시	온양1동	온양1동제2투	3109	2228	881	3	2225	1373	847	0	2	1	2
충청남도	아산시	온양1동	온양1동제3투	1220	751	469	0	751	523	226	0	0	0	2
충청남도	아산시	온양2동	소계	6929	4724	2205	10	4714	2954	1752	1	1	4	2
충청남도	아산시	온양2동	온양2동제1투	2624	1851	773	3	1848	1171	673	1	0	3	0
충청남도	아산시	온양2동	온양2동제2투	2314	1613	701	5	1608	1011	595	0	0	1	1
충청남도	아산시	온양2동	온양2동제3투	1991	1260	731	2	1258	772	484	0	1	0	1
충청남도	아산시	온양3동	소계	22976	17115	5861	27	17088	9296	7735	3	12	24	18
충청남도	아산시	온양3동	온양3동제1투	4214	3188	1026	3	3185	1666	1510	0	1	6	2
충청남도	아산시	온양3동	온양3동제2투	4219	2843	1376	3	2840	1747	1082	1	1	5	4
충청남도	아산시	온양3동	온양3동제3투	3819	2904	915	3	2901	1460	1425	0	4	5	7
충청남도	아산시	온양3동	온양3동제4투	494	375	119	2	373	268	104	0	0	0	1
충청남도	아산시	온양3동	온양3동제5투	4307	3232	1075	6	3226	1863	1354	1	5	1	2
충청남도	아산시	온양3동	온양3동제6투	3863	2910	953	7	2903	1579	1316	1	0	6	1
충청남도	아산시	온양3동	온양3동제7투	2060	1663	397	3	1660	713	944	0	1	1	1
충청남도	아산시	온양4동	소계	14917	10596	4321	25	10571	5659	4856	5	13	19	19
충청남도	아산시	온양4동	온양4동제1투	3315	2531	784	6	2525	1327	1183	1	4	6	4
충청남도	아산시	온양4동	온양4동제2투	4146	3101	1045	6	3095	1612	1463	2	4	8	6
충청남도	아산시	온양4동	온양4동제3투	2269	1578	691	4	1574	1012	555	0	1	3	3
충청남도	아산시	온양4동	온양4동제4투	2964	1827	1137	6	1821	935	876	1	4	1	4
충청남도	아산시	온양4동	온양4동제5투	2223	1559	664	3	1556	773	779	1	0	1	2
충청남도	아산시	온양5동	소계	14854	10794	4060	17	10777	5897	4841	2	4	22	11
충청남도	아산시	온양5동	온양5동제1투	4572	3227	1345	7	3220	1719	1493	0	1	5	2
충청남도	아산시	온양5동	온양5동제2투	3719	2652	1067	4	2648	1568	1068	1	2	7	2
충청남도	아산시	온양5동	온양5동제3투	2106	1524	582	2	1522	858	659	0	0	2	3
충청남도	아산시	온양5동	온양5동제4투	4457	3391	1066	4	3387	1752	1621	1	1	8	4
충청남도	아산시	온양6동	소계	18329	13541	4788	51	13490	6870	6568	4	10	18	20
충청남도	아산시	온양6동	온양6동제1투	1525	1040	485	10	1030	703	320	0	0	0	7
충청남도	아산시	온양6동	온양6동제2투	2772	2074	698	2	2072	1008	1062	1	0	0	1
충청남도	아산시	온양6동	온양6동제3투	1717	1196	521	12	1184	812	360	1	2	3	6
충청남도	아산시	온양6동	온양6동제4투	3551	2458	1093	6	2452	1243	1200	0	0	7	2
충청남도	아산시	온양6동	온양6동제5투	2699	1875	824	5	1870	903	960	0	5	2	0
충청남도	아산시	온양6동	온양6동제6투	3006	2314	692	9	2305	1191	1103	0	2	5	4
충청남도	아산시	온양6동	온양6동제7투	3059	2584	475	7	2577	1010	1563	2	1	1	0
충청남도	서산시	계	계	126399	92671	33728	449	92222	53072	38595	40	74	160	281
충청남도	서산시	재외투표	재외투표	342	214	128	1	213	81	131	0	0	1	0
충청남도	서산시	국내부재자투표	국내부재자투표	4103	3726	377	98	3628	1640	1932	11	9	6	30
충청남도	서산시	대산읍	소계	12202	8814	3388	34	8780	4641	4085	1	5	25	23
충청남도	서산시	대산읍	대산읍제1투	2899	1946	953	8	1938	1104	820	1	2	5	6
충청남도	서산시	대산읍	대산읍제2투	920	635	285	3	632	411	211	0	0	4	6
충청남도	서산시	대산읍	대산읍제3투	1458	1082	376	4	1078	506	566	0	1	3	2
충청남도	서산시	대산읍	대산읍제4투	2136	1681	455	4	1677	688	984	0	0	5	0
충청남도	서산시	대산읍	대산읍제5투	2991	2115	876	9	2106	1239	855	0	1	6	5
충청남도	서산시	대산읍	대산읍제6투	1798	1355	443	6	1349	693	649	0	1	2	4
충청남도	서산시	인지면	소계	5824	4300	1524	16	4284	2627	1630	1	0	8	18
충청남도	서산시	인지면	인지면제1투	3899	2884	1015	6	2878	1619	1242	1	0	4	12
충청남도	서산시	인지면	인지면제2투	939	694	245	3	691	498	185	0	0	4	4
충청남도	서산시	인지면	인지면제3투	986	722	264	7	715	510	203	0	0	0	2
충청남도	서산시	부석면	소계	5262	3834	1428	35	3799	2451	1315	4	4	3	22
충청남도	서산시	부석면	부석면제1투	1881	1396	485	16	1380	926	442	2	2	0	8
충청남도	서산시	부석면	부석면제2투	1443	1036	407	9	1027	657	358	1	1	2	8
충청남도	서산시	부석면	부석면제3투	857	625	232	3	622	403	217	0	0	0	2
충청남도	서산시	부석면	부석면제4투	1081	777	304	7	770	465	298	1	1	1	4
충청남도	서산시	팔봉면	소계	3035	2276	759	18	2258	1498	735	2	0	4	19
충청남도	서산시	팔봉면	팔봉면제1투	1900	1432	468	17	1415	901	500	2	0	1	11
충청남도	서산시	팔봉면	팔봉면제2투	1006	751	255	1	750	515	226	0	0	3	6
충청남도	서산시	팔봉면	팔봉면제3투	129	93	36	0	93	82	9	0	0	0	2
충청남도	서산시	지곡면	소계	6614	4654	1960	12	4642	2595	2012	1	7	10	17
충청남도	서산시	지곡면	지곡면제1투	3316	2346	970	4	2342	1563	758	0	3	5	13
충청남도	서산시	지곡면	지곡면제2투	3298	2308	990	8	2300	1032	1254	1	4	5	4
충청남도	서산시	성연면	소계	2257	1692	565	15	1677	1067	594	1	0	1	14
충청남도	서산시	성연면	성연면투표소	2257	1692	565	15	1677	1067	594	1	0	1	14
충청남도	서산시	음암면	소계	8263	6089	2174	23	6066	3479	2542	0	10	18	17
충청남도	서산시	음암면	음암면제1투	2450	1772	678	8	1764	1081	663	0	2	8	10
충청남도	서산시	음암면	음암면제2투	2792	2036	756	5	2031	1174	847	0	5	4	1
충청남도	서산시	음암면	음암면제3투	1833	1396	437	3	1393	657	726	0	3	5	2
충청남도	서산시	음암면	음암면제4투	1188	885	303	7	878	567	306	0	0	1	4
충청남도	서산시	운산면	소계	4906	3515	1391	19	3496	2350	1113	6	0	5	22
충청남도	서산시	운산면	운산면제1투	2523	1766	757	7	1759	1197	554	1	0	1	6
충청남도	서산시	운산면	운산면제2투	805	581	224	2	579	411	160	2	0	1	5
충청남도	서산시	운산면	운산면제3투	1578	1168	410	10	1158	742	399	3	0	3	11
충청남도	서산시	해미면	소계	6787	4760	2027	24	4736	3160	1537	2	3	13	21
충청남도	서산시	해미면	해미면제1투	1983	1411	572	6	1405	936	458	2	1	2	6
충청남도	서산시	해미면	해미면제2투	2045	1478	567	11	1467	1034	418	0	1	4	10
충청남도	서산시	해미면	해미면제3투	2759	1871	888	7	1864	1190	661	0	1	7	5
충청남도	서산시	고북면	소계	6205	4551	1654	27	4524	2673	1818	1	4	7	21
충청남도	서산시	고북면	고북면제1투	2464	1781	683	11	1770	1179	580	0	2	3	6
충청남도	서산시	고북면	고북면제2투	2338	1724	614	6	1718	889	819	1	1	3	5
충청남도	서산시	고북면	고북면제3투	1403	1046	357	10	1036	605	419	0	1	1	10
충청남도	서산시	부춘동	소계	14033	10230	3803	33	10197	5522	4641	2	11	12	9
충청남도	서산시	부춘동	부춘동제1투	1070	754	316	3	751	478	270	0	0	1	2
충청남도	서산시	부춘동	부춘동제2투	2743	1970	773	9	1961	1097	857	0	3	2	2
충청남도	서산시	부춘동	부춘동제3투	3680	2780	900	9	2771	1504	1258	0	3	4	2
충청남도	서산시	부춘동	부춘동제4투	3080	2296	784	4	2292	1016	1270	1	4	0	1
충청남도	서산시	부춘동	부춘동제5투	3460	2430	1030	8	2422	1427	986	1	1	5	2
충청남도	서산시	동문1동	소계	12190	8846	3344	27	8819	5038	3760	0	6	8	7
충청남도	서산시	동문1동	동문1동제1투	4366	3097	1269	9	3088	1629	1453	0	3	2	1
충청남도	서산시	동문1동	동문1동제2투	3366	2293	1073	8	2285	1550	726	0	2	3	4
충청남도	서산시	동문1동	동문1동제3투	3575	2794	781	8	2786	1378	1402	0	1	3	2
충청남도	서산시	동문1동	동문1동제4투	883	662	221	2	660	481	179	0	0	0	0
충청남도	서산시	동문2동	소계	7826	5607	2219	14	5593	3396	2182	1	2	4	8
충청남도	서산시	동문2동	동문2동제1투	1469	961	508	4	957	611	342	0	1	1	2
충청남도	서산시	동문2동	동문2동제2투	2363	1656	707	5	1651	1092	551	1	1	2	4
충청남도	서산시	동문2동	동문2동제3투	3994	2990	1004	5	2985	1693	1289	0	0	1	2
충청남도	서산시	수석동	소계	11087	8222	2865	18	8204	4700	3464	3	6	19	12
충청남도	서산시	수석동	수석동제1투	1988	1517	471	3	1514	819	687	0	1	5	2
충청남도	서산시	수석동	수석동제2투	4198	3137	1061	9	3128	1808	1309	1	0	7	3
충청남도	서산시	수석동	수석동제3투	1542	1036	506	1	1035	639	393	0	0	2	1
충청남도	서산시	수석동	수석동제4투	3359	2532	827	5	2527	1434	1075	2	5	5	6
충청남도	서산시	석남동	소계	15463	11341	4122	35	11306	6154	5104	4	7	16	21
충청남도	서산시	석남동	석남동제1투	4525	3427	1098	5	3422	1819	1597	0	0	2	4
충청남도	서산시	석남동	석남동제2투	5732	4129	1603	14	4115	2070	2025	2	7	4	7
충청남도	서산시	석남동	석남동제3투	3631	2677	954	9	2668	1526	1129	2	0	7	4
충청남도	서산시	석남동	석남동제4투	1575	1108	467	7	1101	739	353	0	0	3	6
충청남도	태안군	계	계	52880	38078	14802	216	37862	24128	13435	19	31	52	197
충청남도	태안군	재외투표	재외투표	126	80	46	1	79	26	53	0	0	0	0
충청남도	태안군	국내부재자투표	국내부재자투표	1678	1496	182	31	1465	657	789	3	3	6	7
충청남도	태안군	태안읍	소계	20686	14739	5947	46	14693	9179	5435	5	14	13	47
충청남도	태안군	태안읍	태안읍제1투	2249	1580	669	3	1577	1053	519	1	2	0	2
충청남도	태안군	태안읍	태안읍제2투	1484	1079	405	11	1068	677	381	1	0	1	8
충청남도	태안군	태안읍	태안읍제3투	1872	1365	507	6	1359	905	448	0	1	0	5
충청남도	태안군	태안읍	태안읍제4투	864	637	227	4	633	414	208	0	0	0	11
충청남도	태안군	태안읍	태안읍제5투	2983	2081	902	4	2077	1222	846	0	3	3	3
충청남도	태안군	태안읍	태안읍제6투	3751	2656	1095	9	2647	1594	1038	2	3	2	8
충청남도	태안군	태안읍	태안읍제7투	2872	1958	914	2	1956	1302	646	0	2	0	6
충청남도	태안군	태안읍	태안읍제8투	4611	3383	1228	7	3376	2012	1349	1	3	7	4
충청남도	태안군	안면읍	소계	7961	5580	2381	27	5553	3659	1848	1	3	10	32
충청남도	태안군	안면읍	안면읍제1투	3394	2362	1032	11	2351	1570	767	0	1	1	12
충청남도	태안군	안면읍	안면읍제2투	1539	1123	416	6	1117	700	404	0	0	4	9
충청남도	태안군	안면읍	안면읍제3투	2202	1487	715	8	1479	1021	447	1	1	2	7
충청남도	태안군	안면읍	안면읍제4투	826	608	218	2	606	368	230	0	1	3	4
충청남도	태안군	고남면	소계	2200	1551	649	10	1541	1018	507	0	0	4	12
충청남도	태안군	고남면	고남면투표소	2200	1551	649	10	1541	1018	507	0	0	4	12
충청남도	태안군	남면	소계	3868	2828	1040	17	2811	1730	1049	0	3	2	27
충청남도	태안군	남면	남면제1투	1534	1122	412	4	1118	695	412	0	2	0	9
충청남도	태안군	남면	남면제2투	1008	732	276	3	729	428	291	0	1	1	8
충청남도	태안군	남면	남면제3투	1326	974	352	10	964	607	346	0	0	1	10
충청남도	태안군	근흥면	소계	5042	3504	1538	23	3481	2392	1067	4	1	3	14
충청남도	태안군	근흥면	근흥면제1투	1869	1331	538	11	1320	952	358	1	0	2	7
충청남도	태안군	근흥면	근흥면제2투	1107	782	325	4	778	492	283	1	1	1	0
충청남도	태안군	근흥면	근흥면제3투	1999	1333	666	7	1326	894	423	2	0	0	7
충청남도	태안군	근흥면	근흥면제4투	67	58	9	1	57	54	3	0	0	0	0
충청남도	태안군	소원면	소계	5033	3617	1416	30	3587	2467	1089	4	1	5	21
충청남도	태안군	소원면	소원면제1투	2946	2113	833	16	2097	1443	632	3	0	5	14
충청남도	태안군	소원면	소원면제2투	2087	1504	583	14	1490	1024	457	1	1	0	7
충청남도	태안군	원북면	소계	4198	3124	1074	22	3102	1952	1118	1	4	8	19
충청남도	태안군	원북면	원북면제1투	2032	1518	514	10	1508	823	670	0	2	6	7
충청남도	태안군	원북면	원북면제2투	1118	810	308	6	804	560	235	1	0	1	7
충청남도	태안군	원북면	원북면제3투	1048	796	252	6	790	569	213	0	2	1	5
충청남도	태안군	이원면	소계	2088	1559	529	9	1550	1048	480	1	2	1	18
충청남도	태안군	이원면	이원면제1투	1160	881	279	6	875	607	253	1	1	1	12
충청남도	태안군	이원면	이원면제2투	928	678	250	3	675	441	227	0	1	0	6
충청남도	금산군	계	계	46588	33723	12865	198	33525	20470	12762	15	21	75	182
충청남도	금산군	재외투표	재외투표	127	87	40	0	87	46	41	0	0	0	0
충청남도	금산군	국내부재자투표	국내부재자투표	1103	1012	91	18	994	446	534	3	3	3	5
충청남도	금산군	금산읍	소계	18002	13143	4859	40	13103	7806	5244	2	6	11	34
충청남도	금산군	금산읍	금산읍제1투	2273	1486	787	4	1482	966	516	0	0	0	0
충청남도	금산군	금산읍	금산읍제2투	1991	1489	502	11	1478	897	565	0	2	4	10
충청남도	금산군	금산읍	금산읍제3투	4749	3468	1281	7	3461	1780	1669	0	0	4	8
충청남도	금산군	금산읍	금산읍제4투	1615	1212	403	4	1208	801	403	0	1	1	2
충청남도	금산군	금산읍	금산읍제5투	857	635	222	2	633	380	245	2	0	0	6
충청남도	금산군	금산읍	금산읍제6투	1925	1441	484	2	1439	874	563	0	0	1	1
충청남도	금산군	금산읍	금산읍제7투	2390	1765	625	5	1760	1072	684	0	2	0	2
충청남도	금산군	금산읍	금산읍제8투	2202	1647	555	5	1642	1036	599	0	1	1	5
충청남도	금산군	금성면	소계	3466	2476	990	35	2441	1545	876	2	2	6	10
충청남도	금산군	금성면	금성면제1투	2005	1472	533	13	1459	934	518	0	1	0	6
충청남도	금산군	금성면	금성면제2투	1461	1004	457	22	982	611	358	2	1	6	4
충청남도	금산군	제원면	소계	2838	2004	834	13	1991	1282	687	0	1	2	19
충청남도	금산군	제원면	제원면제1투	2093	1463	630	9	1454	952	482	0	1	2	17
충청남도	금산군	제원면	제원면제2투	745	541	204	4	537	330	205	0	0	0	2
충청남도	금산군	부리면	소계	2660	1884	776	16	1868	1184	658	2	0	6	18
충청남도	금산군	부리면	부리면제1투	1711	1192	519	10	1182	818	345	2	0	4	13
충청남도	금산군	부리면	부리면제2투	949	692	257	6	686	366	313	0	0	2	5
충청남도	금산군	군북면	소계	2275	1671	604	9	1662	1093	551	0	1	6	11
충청남도	금산군	군북면	군북면제1투	730	543	187	6	537	343	187	0	0	1	6
충청남도	금산군	군북면	군북면제2투	1090	790	300	3	787	532	253	0	1	1	0
충청남도	금산군	군북면	군북면제3투	455	338	117	0	338	218	111	0	0	4	5
충청남도	금산군	남일면	소계	2410	1812	598	18	1794	1194	561	2	3	10	24
충청남도	금산군	남일면	남일면제1투	1772	1328	444	14	1314	863	424	2	3	9	13
충청남도	금산군	남일면	남일면제2투	638	484	154	4	480	331	137	0	0	1	11
충청남도	금산군	남이면	소계	1901	1354	547	8	1346	823	502	0	0	3	18
충청남도	금산군	남이면	남이면제1투	1228	872	356	6	866	529	320	0	0	3	14
충청남도	금산군	남이면	남이면제2투	673	482	191	2	480	294	182	0	0	0	4
충청남도	금산군	진산면	소계	2978	2141	837	8	2133	1379	727	2	1	11	13
충청남도	금산군	진산면	진산면제1투	2097	1484	613	7	1477	989	473	2	0	6	7
충청남도	금산군	진산면	진산면제2투	881	657	224	1	656	390	254	0	1	5	6
충청남도	금산군	복수면	소계	3160	2218	942	10	2208	1338	851	1	0	10	8
충청남도	금산군	복수면	복수면제1투	1605	1105	500	6	1099	696	391	1	0	6	5
충청남도	금산군	복수면	복수면제2투	1555	1113	442	4	1109	642	460	0	0	4	3
충청남도	금산군	추부면	소계	5668	3921	1747	23	3898	2334	1530	1	4	7	22
충청남도	금산군	추부면	추부면제1투	2633	1769	864	13	1756	1028	721	0	2	2	3
충청남도	금산군	추부면	추부면제2투	1628	1144	484	6	1138	695	431	0	2	1	9
충청남도	금산군	추부면	추부면제3투	1407	1008	399	4	1004	611	378	1	0	4	10
충청남도	금산군	잘못 투입·구분된 투표지	잘못 투입·구분된 투표지	0	0	0	0	0	0	0	0	0	0	0
충청남도	논산시	계	계	103822	74521	29301	419	74102	39225	34402	51	41	147	236
충청남도	논산시	재외투표	재외투표	307	203	104	1	202	92	110	0	0	0	0
충청남도	논산시	국내부재자투표	국내부재자투표	3213	2881	332	39	2842	1246	1574	5	3	7	7
충청남도	논산시	강경읍	소계	8619	5870	2749	24	5846	2710	3112	3	1	6	14
충청남도	논산시	강경읍	강경읍제1투	1610	1008	602	5	1003	494	504	0	0	2	3
충청남도	논산시	강경읍	강경읍제2투	1081	791	290	3	788	384	400	0	0	1	3
충청남도	논산시	강경읍	강경읍제3투	3326	2345	981	10	2335	1033	1298	0	0	2	2
충청남도	논산시	강경읍	강경읍제4투	2602	1726	876	6	1720	799	910	3	1	1	6
충청남도	논산시	연무읍	소계	12835	8949	3886	43	8906	4570	4278	1	5	17	35
충청남도	논산시	연무읍	연무읍제1투	4428	3099	1329	8	3091	1606	1467	0	1	6	11
충청남도	논산시	연무읍	연무읍제2투	3646	2493	1153	8	2485	1334	1135	1	1	5	9
충청남도	논산시	연무읍	연무읍제3투	2609	1781	828	12	1769	909	852	0	1	3	4
충청남도	논산시	연무읍	연무읍제4투	2152	1576	576	15	1561	721	824	0	2	3	11
충청남도	논산시	성동면	소계	4444	3208	1236	19	3189	1827	1336	4	0	5	17
충청남도	논산시	성동면	성동면제1투	1229	859	370	3	856	503	345	2	0	2	4
충청남도	논산시	성동면	성동면제2투	1513	1094	419	9	1085	606	470	0	0	3	6
충청남도	논산시	성동면	성동면제3투	1702	1255	447	7	1248	718	521	2	0	0	7
충청남도	논산시	광석면	소계	4432	3321	1111	23	3298	1969	1302	5	1	8	13
충청남도	논산시	광석면	광석면제1투	1931	1450	481	15	1435	865	557	1	1	5	6
충청남도	논산시	광석면	광석면제2투	1002	761	241	1	760	435	317	1	0	1	6
충청남도	논산시	광석면	광석면제3투	1499	1110	389	7	1103	669	428	3	0	2	1
충청남도	논산시	노성면	소계	3249	2341	908	16	2325	1450	855	1	0	6	13
충청남도	논산시	노성면	노성면제1투	2029	1492	537	11	1481	985	486	1	0	3	6
충청남도	논산시	노성면	노성면제2투	1220	849	371	5	844	465	369	0	0	3	7
충청남도	논산시	상월면	소계	3530	2502	1028	25	2477	1420	1027	4	6	6	14
충청남도	논산시	상월면	상월면제1투	1882	1381	501	21	1360	804	534	4	4	4	10
충청남도	논산시	상월면	상월면제2투	1648	1121	527	4	1117	616	493	0	2	2	4
충청남도	논산시	부적면	소계	3570	2618	952	8	2610	1514	1077	0	1	8	10
충청남도	논산시	부적면	부적면제1투	1742	1253	489	2	1251	696	549	0	1	5	0
충청남도	논산시	부적면	부적면제2투	1004	740	264	5	735	452	278	0	0	1	4
충청남도	논산시	부적면	부적면제3투	824	625	199	1	624	366	250	0	0	2	6
충청남도	논산시	연산면	소계	5916	4257	1659	35	4222	2579	1607	4	4	13	15
충청남도	논산시	연산면	연산면제1투	2355	1728	627	6	1722	1007	701	1	0	6	7
충청남도	논산시	연산면	연산면제2투	2121	1469	652	17	1452	862	574	2	3	6	5
충청남도	논산시	연산면	연산면제3투	1440	1060	380	12	1048	710	332	1	1	1	3
충청남도	논산시	벌곡면	소계	2495	1784	711	13	1771	1076	676	2	0	9	8
충청남도	논산시	벌곡면	벌곡면제1투	1443	1025	418	7	1018	618	390	0	0	6	4
충청남도	논산시	벌곡면	벌곡면제2투	1052	759	293	6	753	458	286	2	0	3	4
충청남도	논산시	양촌면	소계	5378	3759	1619	56	3703	2029	1622	10	3	16	23
충청남도	논산시	양촌면	양촌면제1투	1783	1216	567	15	1201	658	537	0	0	2	4
충청남도	논산시	양촌면	양촌면제2투	1654	1178	476	11	1167	669	484	1	0	4	9
충청남도	논산시	양촌면	양촌면제3투	1941	1365	576	30	1335	702	601	9	3	10	10
충청남도	논산시	가야곡면	소계	3691	2638	1053	15	2623	1560	1038	5	1	8	11
충청남도	논산시	가야곡면	가야곡면제1투	1468	1038	430	6	1032	596	428	1	1	1	5
충청남도	논산시	가야곡면	가야곡면제2투	892	662	230	3	659	416	237	2	0	2	2
충청남도	논산시	가야곡면	가야곡면제3투	1331	938	393	6	932	548	373	2	0	5	4
충청남도	논산시	은진면	소계	4553	3166	1387	21	3145	1566	1561	1	3	8	6
충청남도	논산시	은진면	은진면제1투	1759	1228	531	13	1215	661	545	0	2	5	2
충청남도	논산시	은진면	은진면제2투	1011	727	284	1	726	450	272	1	0	1	2
충청남도	논산시	은진면	은진면제3투	1783	1211	572	7	1204	455	744	0	1	2	2
충청남도	논산시	채운면	소계	2453	1812	641	12	1800	968	815	2	1	2	12
충청남도	논산시	채운면	채운면제1투	1395	1011	384	9	1002	537	454	2	0	1	8
충청남도	논산시	채운면	채운면제2투	1058	801	257	3	798	431	361	0	1	1	4
충청남도	논산시	취암동	소계	21493	15409	6084	41	15368	7661	7658	2	8	21	18
충청남도	논산시	취암동	취암동제1투	3182	2130	1052	4	2126	1235	886	0	2	0	3
충청남도	논산시	취암동	취암동제2투	4615	3194	1421	12	3182	1422	1751	0	1	5	3
충청남도	논산시	취암동	취암동제3투	3638	2615	1023	4	2611	1380	1217	1	3	5	5
충청남도	논산시	취암동	취암동제4투	1760	1230	530	5	1225	763	456	1	2	1	2
충청남도	논산시	취암동	취암동제5투	2160	1552	608	2	1550	825	720	0	0	3	2
충청남도	논산시	취암동	취암동제6투	2575	1981	594	7	1974	904	1066	0	0	3	1
충청남도	논산시	취암동	취암동제7투	3563	2707	856	7	2700	1132	1562	0	0	4	2
충청남도	논산시	부창동	소계	13644	9803	3841	28	9775	4988	4754	2	4	7	20
충청남도	논산시	부창동	부창동제1투	3120	2294	826	6	2288	1080	1203	0	0	1	4
충청남도	논산시	부창동	부창동제2투	2397	1655	742	5	1650	992	652	0	0	0	6
충청남도	논산시	부창동	부창동제3투	3628	2487	1141	10	2477	1378	1090	1	1	2	5
충청남도	논산시	부창동	부창동제4투	4499	3367	1132	7	3360	1538	1809	1	3	4	5
충청남도	계룡시	계	계	29932	23661	6271	60	23601	13572	9934	4	15	48	28
충청남도	계룡시	재외투표	재외투표	146	94	52	1	93	38	55	0	0	0	0
충청남도	계룡시	국내부재자투표	국내부재자투표	1759	1594	165	20	1574	992	574	1	2	2	3
충청남도	계룡시	두마면	소계	5540	4356	1184	5	4351	2357	1971	1	7	8	7
충청남도	계룡시	두마면	두마면제1투	2861	2244	617	3	2241	1206	1022	1	2	4	6
충청남도	계룡시	두마면	두마면제2투	2679	2112	567	2	2110	1151	949	0	5	4	1
충청남도	계룡시	엄사면	소계	13009	9904	3105	21	9883	5453	4398	0	5	17	10
충청남도	계룡시	엄사면	엄사면제1투	2995	2247	748	4	2243	1272	962	0	3	3	3
충청남도	계룡시	엄사면	엄사면제2투	3030	2297	733	9	2288	1243	1037	0	0	7	1
충청남도	계룡시	엄사면	엄사면제3투	2573	2031	542	4	2027	1199	824	0	0	1	3
충청남도	계룡시	엄사면	엄사면제4투	3478	2632	846	3	2629	1335	1288	0	2	3	1
충청남도	계룡시	엄사면	엄사면제5투	933	697	236	1	696	404	287	0	0	3	2
충청남도	계룡시	신도안면	소계	3395	2797	598	1	2796	1959	824	2	0	8	3
충청남도	계룡시	신도안면	신도안면제1투	748	572	176	0	572	395	175	0	0	1	1
충청남도	계룡시	신도안면	신도안면제2투	2647	2225	422	1	2224	1564	649	2	0	7	2
충청남도	계룡시	금암동	소계	6083	4916	1167	12	4904	2773	2112	0	1	13	5
충청남도	계룡시	금암동	금암동제1투	3725	3016	709	7	3009	1635	1363	0	0	8	3
충청남도	계룡시	금암동	금암동제2투	2358	1900	458	5	1895	1138	749	0	1	5	2
충청남도	당진시	계	계	122452	87103	35349	327	86776	50429	35909	33	64	130	211
충청남도	당진시	재외투표	재외투표	297	189	108	1	188	63	124	0	0	1	0
충청남도	당진시	국내부재자투표	국내부재자투표	3253	2978	275	44	2934	1354	1553	3	5	4	15
충청남도	당진시	당진1동	소계	15096	10583	4513	19	10564	5714	4813	4	8	19	6
충청남도	당진시	당진1동	당진1동제1투	5069	3490	1579	7	3483	1716	1755	1	2	7	2
충청남도	당진시	당진1동	당진1동제2투	3041	2043	998	6	2037	1337	692	1	2	5	0
충청남도	당진시	당진1동	당진1동제3투	3964	2800	1164	4	2796	1581	1210	2	1	2	0
충청남도	당진시	당진1동	당진1동제4투	3022	2250	772	2	2248	1080	1156	0	3	5	4
충청남도	당진시	당진2동	소계	12429	8823	3606	26	8797	4778	3979	2	8	14	16
충청남도	당진시	당진2동	당진2동제1투	691	476	215	3	473	325	144	0	0	3	1
충청남도	당진시	당진2동	당진2동제2투	3656	2554	1102	6	2548	1478	1060	1	2	2	5
충청남도	당진시	당진2동	당진2동제3투	4100	2781	1319	14	2767	1648	1108	1	3	2	5
충청남도	당진시	당진2동	당진2동제4투	3982	3012	970	3	3009	1327	1667	0	3	7	5
충청남도	당진시	당진3동	소계	12132	9303	2829	21	9282	4543	4701	4	8	15	11
충청남도	당진시	당진3동	당진3동제1투	5084	3944	1140	11	3933	1970	1947	3	2	5	6
충청남도	당진시	당진3동	당진3동제2투	4235	3339	896	5	3334	1629	1689	0	6	7	3
충청남도	당진시	당진3동	당진3동제3투	2813	2020	793	5	2015	944	1065	1	0	3	2
충청남도	당진시	합덕읍	소계	8947	6317	2630	14	6303	4236	2035	1	2	11	18
충청남도	당진시	합덕읍	합덕읍제1투	1393	1019	374	3	1016	688	322	0	0	3	3
충청남도	당진시	합덕읍	합덕읍제2투	2011	1394	617	1	1393	947	442	0	0	1	3
충청남도	당진시	합덕읍	합덕읍제3투	2779	1848	931	3	1845	1237	603	0	0	3	2
충청남도	당진시	합덕읍	합덕읍제4투	1159	848	311	4	844	591	249	1	0	0	3
충청남도	당진시	합덕읍	합덕읍제5투	1605	1208	397	3	1205	773	419	0	2	4	7
충청남도	당진시	송악읍	소계	19217	12788	6429	32	12756	6999	5711	4	7	14	21
충청남도	당진시	송악읍	송악읍제1투	1553	1024	529	5	1019	661	352	1	0	1	4
충청남도	당진시	송악읍	송악읍제2투	1026	721	305	4	717	492	219	0	0	3	3
충청남도	당진시	송악읍	송악읍제3투	4042	2746	1296	6	2740	1530	1204	0	2	0	4
충청남도	당진시	송악읍	송악읍제4투	3170	1933	1237	2	1931	1248	672	2	2	3	4
충청남도	당진시	송악읍	송악읍제5투	4898	3401	1497	8	3393	1728	1655	1	1	4	4
충청남도	당진시	송악읍	송악읍제6투	4528	2963	1565	7	2956	1340	1609	0	2	3	2
충청남도	당진시	고대면	소계	5184	3717	1467	14	3703	2466	1213	1	1	4	18
충청남도	당진시	고대면	고대면제1투	2072	1458	614	5	1453	943	505	0	1	1	3
충청남도	당진시	고대면	고대면제2투	1923	1418	505	3	1415	987	415	1	0	2	10
충청남도	당진시	고대면	고대면제3투	1189	841	348	6	835	536	293	0	0	1	5
충청남도	당진시	석문면	소계	6710	4666	2044	19	4647	2889	1733	1	5	4	15
충청남도	당진시	석문면	석문면제1투	2111	1505	606	6	1499	865	625	1	4	1	3
충청남도	당진시	석문면	석문면제2투	3632	2466	1166	9	2457	1591	853	0	1	3	9
충청남도	당진시	석문면	석문면제3투	183	126	57	0	126	105	20	0	0	0	1
충청남도	당진시	석문면	석문면제4투	784	569	215	4	565	328	235	0	0	0	2
충청남도	당진시	대호지면	소계	2467	1770	697	9	1761	1157	588	0	0	6	10
충청남도	당진시	대호지면	대호지면제1투	1532	1081	451	7	1074	704	360	0	0	2	8
충청남도	당진시	대호지면	대호지면제2투	935	689	246	2	687	453	228	0	0	4	2
충청남도	당진시	정미면	소계	3261	2298	963	28	2270	1529	722	2	1	6	10
충청남도	당진시	정미면	정미면제1투	2176	1495	681	13	1482	1002	467	2	1	3	7
충청남도	당진시	정미면	정미면제2투	1085	803	282	15	788	527	255	0	0	3	3
충청남도	당진시	면천면	소계	3285	2371	914	10	2361	1590	753	2	2	3	11
충청남도	당진시	면천면	면천면제1투	2224	1604	620	4	1600	1106	482	1	1	3	7
충청남도	당진시	면천면	면천면제2투	1061	767	294	6	761	484	271	1	1	0	4
충청남도	당진시	순성면	소계	4940	3569	1371	20	3549	2289	1228	5	7	6	14
충청남도	당진시	순성면	순성면제1투	2735	1986	749	7	1979	1217	744	3	6	4	5
충청남도	당진시	순성면	순성면제2투	1006	733	273	5	728	495	228	1	0	2	2
충청남도	당진시	순성면	순성면제3투	1199	850	349	8	842	577	256	1	1	0	7
충청남도	당진시	우강면	소계	5063	3683	1380	23	3660	2446	1197	1	1	4	11
충청남도	당진시	우강면	우강면제1투	2746	1954	792	9	1945	1261	674	1	0	3	6
충청남도	당진시	우강면	우강면제2투	1419	1050	369	7	1043	746	292	0	1	1	3
충청남도	당진시	우강면	우강면제3투	898	679	219	7	672	439	231	0	0	0	2
충청남도	당진시	신평면	소계	12570	8786	3784	23	8763	5224	3492	0	7	16	24
충청남도	당진시	신평면	신평면제1투	3162	2232	930	6	2226	1390	828	0	0	5	3
충청남도	당진시	신평면	신평면제2투	5615	3874	1741	8	3866	2070	1778	0	2	6	10
충청남도	당진시	신평면	신평면제3투	1342	1017	325	1	1016	679	326	0	0	4	7
충청남도	당진시	신평면	신평면제4투	2451	1663	788	8	1655	1085	560	0	5	1	4
충청남도	당진시	송산면	소계	7601	5262	2339	24	5238	3152	2067	3	2	3	11
충청남도	당진시	송산면	송산면제1투	2651	1880	771	8	1872	1049	813	2	1	1	6
충청남도	당진시	송산면	송산면제2투	2309	1596	713	7	1589	1037	545	1	1	1	4
충청남도	당진시	송산면	송산면제3투	2641	1786	855	9	1777	1066	709	0	0	1	1
충청남도	부여군	계	계	61804	46080	15724	448	45632	28725	16461	55	52	130	209
충청남도	부여군	재외투표	재외투표	189	135	54	3	132	58	73	0	0	1	0
충청남도	부여군	국내부재자투표	국내부재자투표	2028	1824	204	48	1776	810	948	1	4	5	8
충청남도	부여군	부여읍	소계	18460	13647	4813	84	13563	8548	4962	2	4	14	33
충청남도	부여군	부여읍	부여읍제1투	2332	1604	728	7	1597	1011	584	0	0	1	1
충청남도	부여군	부여읍	부여읍제2투	1920	1408	512	4	1404	916	481	1	1	2	3
충청남도	부여군	부여읍	부여읍제3투	1913	1458	455	13	1445	938	499	1	1	1	5
충청남도	부여군	부여읍	부여읍제4투	1666	1225	441	6	1219	839	375	0	0	1	4
충청남도	부여군	부여읍	부여읍제5투	3272	2471	801	11	2460	1467	986	0	2	4	1
충청남도	부여군	부여읍	부여읍제6투	2235	1785	450	10	1775	982	790	0	0	1	2
충청남도	부여군	부여읍	부여읍제7투	1809	1332	477	13	1319	867	446	0	0	0	6
충청남도	부여군	부여읍	부여읍제8투	1394	990	404	15	975	693	274	0	0	2	6
충청남도	부여군	부여읍	부여읍제9투	1919	1374	545	5	1369	835	527	0	0	2	5
충청남도	부여군	규암면	소계	8131	6009	2122	57	5952	3833	2086	1	3	11	18
충청남도	부여군	규암면	규암면제1투	2046	1484	562	16	1468	986	478	0	1	1	2
충청남도	부여군	규암면	규암면제2투	2925	2160	765	10	2150	1362	780	0	1	3	4
충청남도	부여군	규암면	규암면제3투	1887	1414	473	21	1393	846	532	1	1	5	8
충청남도	부여군	규암면	규암면제4투	1273	951	322	10	941	639	296	0	0	2	4
충청남도	부여군	은산면	소계	3733	2723	1010	37	2686	1892	762	3	0	9	20
충청남도	부여군	은산면	은산면제1투	1980	1413	567	13	1400	1021	365	3	0	4	7
충청남도	부여군	은산면	은산면제2투	805	592	213	11	581	379	193	0	0	3	6
충청남도	부여군	은산면	은산면제3투	948	718	230	13	705	492	204	0	0	2	7
충청남도	부여군	외산면	소계	2398	1791	607	11	1780	1051	707	1	2	4	15
충청남도	부여군	외산면	외산면투표소	2398	1791	607	11	1780	1051	707	1	2	4	15
충청남도	부여군	내산면	소계	1604	1197	407	5	1192	809	369	2	0	2	10
충청남도	부여군	내산면	내산면투표소	1604	1197	407	5	1192	809	369	2	0	2	10
충청남도	부여군	구룡면	소계	2305	1743	562	18	1725	1080	630	3	0	4	8
충청남도	부여군	구룡면	구룡면제1투	1579	1181	398	11	1170	757	402	3	0	1	7
충청남도	부여군	구룡면	구룡면제2투	726	562	164	7	555	323	228	0	0	3	1
충청남도	부여군	홍산면	소계	2803	2157	646	13	2144	1441	684	2	1	3	13
충청남도	부여군	홍산면	홍산면제1투	2017	1533	484	6	1527	1036	479	2	1	2	7
충청남도	부여군	홍산면	홍산면제2투	786	624	162	7	617	405	205	0	0	1	6
충청남도	부여군	옥산면	소계	1375	1048	327	8	1040	647	383	0	0	3	7
충청남도	부여군	옥산면	옥산면투표소	1375	1048	327	8	1040	647	383	0	0	3	7
충청남도	부여군	남면	소계	1863	1391	472	11	1380	901	468	0	0	6	5
충청남도	부여군	남면	남면투표소	1863	1391	472	11	1380	901	468	0	0	6	5
충청남도	부여군	충화면	소계	1172	867	305	3	864	588	262	2	0	1	11
충청남도	부여군	충화면	충화면투표소	1172	867	305	3	864	588	262	2	0	1	11
충청남도	부여군	양화면	소계	1788	1283	505	16	1267	821	416	4	4	12	10
충청남도	부여군	양화면	양화면제1투	760	537	223	7	530	354	161	2	3	4	6
충청남도	부여군	양화면	양화면제2투	1028	746	282	9	737	467	255	2	1	8	4
충청남도	부여군	임천면	소계	2850	2115	735	23	2092	1332	720	12	5	15	8
충청남도	부여군	임천면	임천면제1투	1753	1305	448	9	1296	782	492	9	3	7	3
충청남도	부여군	임천면	임천면제2투	1097	810	287	14	796	550	228	3	2	8	5
충청남도	부여군	장암면	소계	2744	2019	725	35	1984	1296	637	16	6	14	15
충청남도	부여군	장암면	장암면제1투	768	551	217	7	544	374	159	4	1	3	3
충청남도	부여군	장암면	장암면제2투	927	671	256	16	655	438	207	1	1	5	3
충청남도	부여군	장암면	장암면제3투	1049	797	252	12	785	484	271	11	4	6	9
충청남도	부여군	세도면	소계	3320	2412	908	39	2373	1322	1003	3	23	15	7
충청남도	부여군	세도면	세도면제1투	1757	1264	493	24	1240	733	475	2	16	10	4
충청남도	부여군	세도면	세도면제2투	1563	1148	415	15	1133	589	528	1	7	5	3
충청남도	부여군	석성면	소계	2828	2092	736	20	2072	1326	724	3	0	9	10
충청남도	부여군	석성면	석성면제1투	1771	1291	480	13	1278	841	422	2	0	6	7
충청남도	부여군	석성면	석성면제2투	1057	801	256	7	794	485	302	1	0	3	3
충청남도	부여군	초촌면	소계	2213	1625	588	17	1608	968	627	0	0	2	11
충청남도	부여군	초촌면	초촌면제1투	1440	1053	387	9	1044	618	419	0	0	1	6
충청남도	부여군	초촌면	초촌면제2투	773	572	201	8	564	350	208	0	0	1	5
충청남도	부여군	잘못 투입·구분된 투표지	잘못 투입·구분된 투표지	0	2	-2	0	2	2	0	0	0	0	0
충청남도	서천군	계	계	50228	36354	13874	263	36091	20671	15102	20	25	83	190
충청남도	서천군	재외투표	재외투표	139	110	29	1	109	56	53	0	0	0	0
충청남도	서천군	국내부재자투표	국내부재자투표	1597	1433	164	19	1414	605	795	3	1	7	3
충청남도	서천군	장항읍	소계	10446	7302	3144	35	7267	4191	3039	4	6	8	19
충청남도	서천군	장항읍	장항읍제1투	1954	1310	644	2	1308	797	506	1	1	1	2
충청남도	서천군	장항읍	장항읍제2투	3071	2177	894	17	2160	1180	966	0	3	4	7
충청남도	서천군	장항읍	장항읍제3투	2786	1950	836	2	1948	1123	819	0	2	2	2
충청남도	서천군	장항읍	장항읍제4투	2635	1865	770	14	1851	1091	748	3	0	1	8
충청남도	서천군	서천읍	소계	10908	8083	2825	41	8042	4456	3540	6	4	12	24
충청남도	서천군	서천읍	서천읍제1투	2329	1648	681	9	1639	1000	629	1	2	3	4
충청남도	서천군	서천읍	서천읍제2투	1899	1358	541	5	1353	803	543	1	1	2	3
충청남도	서천군	서천읍	서천읍제3투	2044	1492	552	10	1482	840	627	1	0	4	10
충청남도	서천군	서천읍	서천읍제4투	4636	3585	1051	17	3568	1813	1741	3	1	3	7
충청남도	서천군	마서면	소계	5135	3556	1579	29	3527	1943	1551	1	2	11	19
충청남도	서천군	마서면	마서면제1투	1748	1210	538	3	1207	634	564	0	1	3	5
충청남도	서천군	마서면	마서면제2투	1583	1045	538	17	1028	608	406	0	1	6	7
충청남도	서천군	마서면	마서면제3투	1804	1301	503	9	1292	701	581	1	0	2	7
충청남도	서천군	화양면	소계	2395	1716	679	11	1705	1011	679	0	1	4	10
충청남도	서천군	화양면	화양면제1투	1500	1047	453	6	1041	599	436	0	0	2	4
충청남도	서천군	화양면	화양면제2투	895	669	226	5	664	412	243	0	1	2	6
충청남도	서천군	기산면	소계	1730	1277	453	10	1267	785	470	0	1	4	7
충청남도	서천군	기산면	기산면투표소	1730	1277	453	10	1267	785	470	0	1	4	7
충청남도	서천군	한산면	소계	2634	1958	676	18	1940	1174	753	3	0	2	8
충청남도	서천군	한산면	한산면제1투	1432	1048	384	3	1045	618	423	0	0	1	3
충청남도	서천군	한산면	한산면제2투	573	440	133	6	434	290	141	0	0	0	3
충청남도	서천군	한산면	한산면제3투	629	470	159	9	461	266	189	3	0	1	2
충청남도	서천군	마산면	소계	1428	1080	348	10	1070	586	456	1	1	7	19
충청남도	서천군	마산면	마산면제1투	920	702	218	5	697	383	304	0	0	4	6
충청남도	서천군	마산면	마산면제2투	508	378	130	5	373	203	152	1	1	3	13
충청남도	서천군	시초면	소계	1212	877	335	11	866	546	306	0	2	5	7
충청남도	서천군	시초면	시초면투표소	1212	877	335	11	866	546	306	0	2	5	7
충청남도	서천군	문산면	소계	1286	937	349	7	930	591	328	0	1	2	8
충청남도	서천군	문산면	문산면투표소	1286	937	349	7	930	591	328	0	1	2	8
충청남도	서천군	판교면	소계	2103	1573	530	20	1553	1017	506	0	1	8	21
충청남도	서천군	판교면	판교면투표소	2103	1573	530	20	1553	1017	506	0	1	8	21
충청남도	서천군	종천면	소계	2055	1452	603	17	1435	878	538	0	1	5	13
충청남도	서천군	종천면	종천면제1투	1006	704	302	10	694	406	280	0	1	3	4
충청남도	서천군	종천면	종천면제2투	1049	748	301	7	741	472	258	0	0	2	9
충청남도	서천군	비인면	소계	3069	2173	896	19	2154	1250	881	1	1	2	19
충청남도	서천군	비인면	비인면제1투	2021	1475	546	12	1463	870	578	0	1	1	13
충청남도	서천군	비인면	비인면제2투	1048	698	350	7	691	380	303	1	0	1	6
충청남도	서천군	서면	소계	4091	2827	1264	15	2812	1582	1207	1	3	6	13
충청남도	서천군	서면	서면제1투	1635	1154	481	6	1148	687	447	0	0	4	10
충청남도	서천군	서면	서면제2투	2456	1673	783	9	1664	895	760	1	3	2	3
충청남도	홍성군	계	계	71995	52297	19698	249	52048	32170	19514	20	24	92	228
충청남도	홍성군	재외투표	재외투표	172	112	60	0	112	52	60	0	0	0	0
충청남도	홍성군	국내부재자투표	국내부재자투표	2028	1859	169	35	1824	792	1014	2	3	5	8
충청남도	홍성군	홍성읍	소계	32310	22956	9354	60	22896	13257	9553	7	11	35	33
충청남도	홍성군	홍성읍	홍성읍제1투	3654	2517	1137	3	2514	1622	885	0	1	2	4
충청남도	홍성군	홍성읍	홍성읍제2투	3430	2522	908	7	2515	1447	1055	0	1	7	5
충청남도	홍성군	홍성읍	홍성읍제3투	4587	3304	1283	8	3296	1666	1620	0	1	6	3
충청남도	홍성군	홍성읍	홍성읍제4투	2839	1951	888	10	1941	1216	711	4	2	2	6
충청남도	홍성군	홍성읍	홍성읍제5투	4535	3244	1291	10	3234	1950	1277	0	0	6	1
충청남도	홍성군	홍성읍	홍성읍제6투	3974	2789	1185	8	2781	1848	919	1	2	3	8
충청남도	홍성군	홍성읍	홍성읍제7투	4348	3157	1191	7	3150	1670	1471	0	2	3	4
충청남도	홍성군	홍성읍	홍성읍제8투	4943	3472	1471	7	3465	1838	1615	2	2	6	2
충청남도	홍성군	광천읍	소계	8981	6415	2566	33	6382	4465	1884	1	3	11	18
충청남도	홍성군	광천읍	광천읍제1투	3053	2151	902	6	2145	1497	638	0	2	2	6
충청남도	홍성군	광천읍	광천읍제2투	3254	2313	941	14	2299	1592	689	1	1	8	8
충청남도	홍성군	광천읍	광천읍제3투	2674	1951	723	13	1938	1376	557	0	0	1	4
충청남도	홍성군	홍북면	소계	3749	2799	950	13	2786	1715	1047	2	0	3	19
충청남도	홍성군	홍북면	홍북면제1투	1671	1239	432	5	1234	722	502	2	0	1	7
충청남도	홍성군	홍북면	홍북면제2투	1076	820	256	3	817	515	297	0	0	2	3
충청남도	홍성군	홍북면	홍북면제3투	1002	740	262	5	735	478	248	0	0	0	9
충청남도	홍성군	금마면	소계	3350	2464	886	5	2459	1567	873	1	0	1	17
충청남도	홍성군	금마면	금마면제1투	970	718	252	1	717	462	246	0	0	0	9
충청남도	홍성군	금마면	금마면제2투	1078	795	283	3	792	533	254	1	0	1	3
충청남도	홍성군	금마면	금마면제3투	1302	951	351	1	950	572	373	0	0	0	5
충청남도	홍성군	홍동면	소계	3177	2382	795	12	2370	1355	991	0	2	5	17
충청남도	홍성군	홍동면	홍동면제1투	1209	898	311	5	893	461	419	0	1	3	9
충청남도	홍성군	홍동면	홍동면제2투	867	667	200	1	666	334	326	0	1	1	4
충청남도	홍성군	홍동면	홍동면제3투	1101	817	284	6	811	560	246	0	0	1	4
충청남도	홍성군	장곡면	소계	3026	2201	825	17	2184	1470	681	1	2	5	25
충청남도	홍성군	장곡면	장곡면제1투	1452	1027	425	5	1022	692	317	0	1	4	8
충청남도	홍성군	장곡면	장곡면제2투	571	432	139	6	426	272	149	0	0	1	4
충청남도	홍성군	장곡면	장곡면제3투	1003	742	261	6	736	506	215	1	1	0	13
충청남도	홍성군	은하면	소계	2463	1784	679	15	1769	1220	524	1	1	7	16
충청남도	홍성군	은하면	은하면제1투	1717	1227	490	12	1215	796	400	1	1	5	12
충청남도	홍성군	은하면	은하면제2투	746	557	189	3	554	424	124	0	0	2	4
충청남도	홍성군	결성면	소계	2198	1668	530	16	1652	1200	428	0	0	5	19
충청남도	홍성군	결성면	결성면제1투	853	645	208	1	644	493	142	0	0	2	7
충청남도	홍성군	결성면	결성면제2투	636	480	156	12	468	331	133	0	0	2	2
충청남도	홍성군	결성면	결성면제3투	709	543	166	3	540	376	153	0	0	1	10
충청남도	홍성군	서부면	소계	3209	2332	877	11	2321	1621	673	1	1	7	18
충청남도	홍성군	서부면	서부면제1투	1679	1195	484	8	1187	828	339	1	1	4	14
충청남도	홍성군	서부면	서부면제2투	1530	1137	393	3	1134	793	334	0	0	3	4
충청남도	홍성군	갈산면	소계	3604	2683	921	17	2666	1826	806	2	0	4	28
충청남도	홍성군	갈산면	갈산면제1투	2001	1490	511	6	1484	1062	405	1	0	2	14
충청남도	홍성군	갈산면	갈산면제2투	465	353	112	0	353	249	99	1	0	0	4
충청남도	홍성군	갈산면	갈산면제3투	1138	840	298	11	829	515	302	0	0	2	10
충청남도	홍성군	구항면	소계	3728	2642	1086	15	2627	1630	980	2	1	4	10
충청남도	홍성군	구항면	구항면제1투	2136	1560	576	8	1552	958	586	1	1	1	5
충청남도	홍성군	구항면	구항면제2투	1592	1082	510	7	1075	672	394	1	0	3	5
충청남도	청양군	계	계	27566	20849	6717	147	20702	13490	6989	17	15	54	137
충청남도	청양군	재외투표	재외투표	65	39	26	0	39	22	17	0	0	0	0
충청남도	청양군	국내부재자투표	국내부재자투표	857	770	87	13	757	360	385	2	3	2	5
충청남도	청양군	청양읍	소계	7916	5987	1929	15	5972	3961	1975	4	2	13	17
충청남도	청양군	청양읍	청양읍제1투	1783	1333	450	4	1329	884	433	2	1	3	6
충청남도	청양군	청양읍	청양읍제2투	3030	2341	689	4	2337	1484	841	1	0	6	5
충청남도	청양군	청양읍	청양읍제3투	1468	1093	375	4	1089	750	334	0	0	3	2
충청남도	청양군	청양읍	청양읍제4투	1635	1220	415	3	1217	843	367	1	1	1	4
충청남도	청양군	운곡면	소계	1950	1462	488	13	1449	1042	379	1	1	5	21
충청남도	청양군	운곡면	운곡면제1투	1412	1068	344	8	1060	762	275	1	1	5	16
충청남도	청양군	운곡면	운곡면제2투	538	394	144	5	389	280	104	0	0	0	5
충청남도	청양군	대치면	소계	1956	1464	492	13	1451	1011	420	1	1	4	14
충청남도	청양군	대치면	대치면제1투	1122	858	264	8	850	592	245	1	1	3	8
충청남도	청양군	대치면	대치면제2투	834	606	228	5	601	419	175	0	0	1	6
충청남도	청양군	정산면	소계	3007	2247	760	11	2236	1426	790	2	3	3	12
충청남도	청양군	정산면	정산면제1투	1539	1136	403	4	1132	727	393	1	3	3	5
충청남도	청양군	정산면	정산면제2투	1468	1111	357	7	1104	699	397	1	0	0	7
충청남도	청양군	목면	소계	1365	1026	339	10	1016	611	391	0	0	5	9
충청남도	청양군	목면	목면제1투	727	562	165	8	554	340	207	0	0	2	5
충청남도	청양군	목면	목면제2투	638	464	174	2	462	271	184	0	0	3	4
충청남도	청양군	청남면	소계	1751	1314	437	12	1302	896	386	2	1	2	15
충청남도	청양군	청남면	청남면투표소	1751	1314	437	12	1302	896	386	2	1	2	15
충청남도	청양군	장평면	소계	2210	1672	538	12	1660	968	676	2	0	5	9
충청남도	청양군	장평면	장평면제1투	1006	774	232	5	769	410	356	0	0	2	1
충청남도	청양군	장평면	장평면제2투	526	390	136	3	387	268	114	1	0	1	3
충청남도	청양군	장평면	장평면제3투	678	508	170	4	504	290	206	1	0	2	5
충청남도	청양군	남양면	소계	2467	1850	617	17	1833	1230	583	1	1	6	12
충청남도	청양군	남양면	남양면제1투	1791	1320	471	13	1307	868	426	0	0	5	8
충청남도	청양군	남양면	남양면제2투	676	530	146	4	526	362	157	1	1	1	4
충청남도	청양군	화성면	소계	2046	1498	548	13	1485	989	476	2	3	5	10
충청남도	청양군	화성면	화성면제1투	1052	773	279	4	769	512	246	1	1	2	7
충청남도	청양군	화성면	화성면제2투	994	725	269	9	716	477	230	1	2	3	3
충청남도	청양군	비봉면	소계	1976	1520	456	18	1502	974	511	0	0	4	13
충청남도	청양군	비봉면	비봉면제1투	1345	1036	309	7	1029	655	362	0	0	3	9
충청남도	청양군	비봉면	비봉면제2투	631	484	147	11	473	319	149	0	0	1	4
충청남도	예산군	계	계	71974	53169	18805	262	52907	37225	15394	19	15	88	166
충청남도	예산군	재외투표	재외투표	218	156	62	1	155	88	66	0	0	0	1
충청남도	예산군	국내부재자투표	국내부재자투표	2121	1956	165	27	1929	938	978	1	5	4	3
충청남도	예산군	예산읍	소계	28452	20982	7470	66	20916	14556	6293	5	2	34	26
충청남도	예산군	예산읍	예산읍제1투	2223	1407	816	5	1402	1058	339	0	0	4	1
충청남도	예산군	예산읍	예산읍제2투	1754	1294	460	5	1289	956	329	0	0	3	1
충청남도	예산군	예산읍	예산읍제3투	2386	1757	629	5	1752	1223	520	1	0	5	3
충청남도	예산군	예산읍	예산읍제4투	2302	1785	517	4	1781	1202	575	0	0	1	3
충청남도	예산군	예산읍	예산읍제5투	2361	1734	627	4	1730	1342	384	0	0	1	3
충청남도	예산군	예산읍	예산읍제6투	2375	1741	634	3	1738	1201	532	1	0	3	1
충청남도	예산군	예산읍	예산읍제7투	2442	1823	619	8	1815	1206	604	0	0	1	4
충청남도	예산군	예산읍	예산읍제8투	3316	2529	787	10	2519	1576	934	1	1	5	2
충청남도	예산군	예산읍	예산읍제9투	3181	2458	723	6	2452	1509	934	1	0	7	1
충청남도	예산군	예산읍	예산읍제10투	2481	1811	670	10	1801	1384	411	1	1	1	3
충청남도	예산군	예산읍	예산읍제11투	3631	2643	988	6	2637	1899	731	0	0	3	4
충청남도	예산군	삽교읍	소계	6765	4862	1903	23	4839	3568	1234	4	4	10	19
충청남도	예산군	삽교읍	삽교읍제1투	2300	1664	636	6	1658	1224	419	1	1	6	7
충청남도	예산군	삽교읍	삽교읍제2투	1101	782	319	4	778	545	224	3	0	3	3
충청남도	예산군	삽교읍	삽교읍제3투	1978	1432	546	8	1424	1042	375	0	1	1	5
충청남도	예산군	삽교읍	삽교읍제4투	1386	984	402	5	979	757	216	0	2	0	4
충청남도	예산군	대술면	소계	2583	1877	706	8	1869	1332	530	0	1	1	5
충청남도	예산군	대술면	대술면투표소	2583	1877	706	8	1869	1332	530	0	1	1	5
충청남도	예산군	신양면	소계	3078	2265	813	17	2248	1664	564	0	0	5	15
충청남도	예산군	신양면	신양면투표소	3078	2265	813	17	2248	1664	564	0	0	5	15
충청남도	예산군	광시면	소계	3162	2328	834	21	2307	1687	598	1	0	5	16
충청남도	예산군	광시면	광시면제1투	2309	1694	615	16	1678	1204	459	1	0	3	11
충청남도	예산군	광시면	광시면제2투	853	634	219	5	629	483	139	0	0	2	5
충청남도	예산군	대흥면	소계	1777	1325	452	8	1317	1025	282	0	0	1	9
충청남도	예산군	대흥면	대흥면제1투	857	658	199	4	654	509	141	0	0	1	3
충청남도	예산군	대흥면	대흥면제2투	920	667	253	4	663	516	141	0	0	0	6
충청남도	예산군	응봉면	소계	2399	1785	614	11	1774	1291	475	0	0	4	4
충청남도	예산군	응봉면	응봉면제1투	1635	1199	436	7	1192	834	353	0	0	4	1
충청남도	예산군	응봉면	응봉면제2투	764	586	178	4	582	457	122	0	0	0	3
충청남도	예산군	덕산면	소계	6127	4350	1777	18	4332	3074	1238	1	0	5	14
충청남도	예산군	덕산면	덕산면제1투	3254	2294	960	13	2281	1605	665	0	0	4	7
충청남도	예산군	덕산면	덕산면제2투	1570	1105	465	2	1103	791	309	0	0	1	2
충청남도	예산군	덕산면	덕산면제3투	1303	951	352	3	948	678	264	1	0	0	5
충청남도	예산군	봉산면	소계	2445	1817	628	6	1811	1262	528	3	0	3	15
충청남도	예산군	봉산면	봉산면제1투	1751	1308	443	5	1303	904	384	2	0	2	11
충청남도	예산군	봉산면	봉산면제2투	694	509	185	1	508	358	144	1	0	1	4
충청남도	예산군	고덕면	소계	4588	3419	1169	25	3394	2357	1011	1	0	9	16
충청남도	예산군	고덕면	고덕면제1투	2754	2041	713	14	2027	1401	611	1	0	4	10
충청남도	예산군	고덕면	고덕면제2투	1001	745	256	7	738	521	212	0	0	1	4
충청남도	예산군	고덕면	고덕면제3투	833	633	200	4	629	435	188	0	0	4	2
충청남도	예산군	신암면	소계	3662	2672	990	17	2655	1861	778	1	2	3	10
충청남도	예산군	신암면	신암면제1투	2702	1927	775	12	1915	1365	538	1	2	2	7
충청남도	예산군	신암면	신암면제2투	960	745	215	5	740	496	240	0	0	1	3
충청남도	예산군	오가면	소계	4597	3375	1222	14	3361	2522	819	2	1	4	13
충청남도	예산군	오가면	오가면제1투	2524	1795	729	3	1792	1376	402	2	1	2	9
충청남도	예산군	오가면	오가면제2투	2073	1580	493	11	1569	1146	417	0	0	2	4
전라북도	전주시완산구	계	계	278250	222304	55946	572	221732	27095	193995	48	116	362	116
전라북도	전주시완산구	재외투표	재외투표	1033	764	269	8	756	87	669	0	0	0	0
전라북도	전주시완산구	국내부재자투표	국내부재자투표	8887	8191	696	116	8075	1464	6550	12	24	17	8
전라북도	전주시완산구	중앙동	소계	9065	6716	2349	19	6697	1200	5480	0	2	12	3
전라북도	전주시완산구	중앙동	중앙동제1투	2744	1945	799	8	1937	337	1592	0	1	6	1
전라북도	전주시완산구	중앙동	중앙동제2투	3638	2829	809	9	2820	586	2230	0	0	2	2
전라북도	전주시완산구	중앙동	중앙동제3투	2683	1942	741	2	1940	277	1658	0	1	4	0
전라북도	전주시완산구	풍남동	소계	5934	4320	1614	19	4301	677	3613	1	2	5	3
전라북도	전주시완산구	풍남동	풍남동제1투	2856	2069	787	11	2058	341	1713	1	1	1	1
전라북도	전주시완산구	풍남동	풍남동제2투	3078	2251	827	8	2243	336	1900	0	1	4	2
전라북도	전주시완산구	노송동	소계	12375	9147	3228	24	9123	1278	7806	9	4	14	12
전라북도	전주시완산구	노송동	노송동제1투	3034	2286	748	0	2286	343	1939	2	1	0	1
전라북도	전주시완산구	노송동	노송동제2투	2226	1672	554	2	1670	233	1430	1	1	3	2
전라북도	전주시완산구	노송동	노송동제3투	2173	1584	589	6	1578	201	1367	2	1	4	3
전라북도	전주시완산구	노송동	노송동제4투	2797	2083	714	11	2072	266	1792	1	1	7	5
전라북도	전주시완산구	노송동	노송동제5투	2145	1522	623	5	1517	235	1278	3	0	0	1
전라북도	전주시완산구	완산동	소계	5512	4028	1484	9	4019	570	3436	1	1	6	5
전라북도	전주시완산구	완산동	완산동제1투	2719	1960	759	7	1953	261	1686	1	0	3	2
전라북도	전주시완산구	완산동	완산동제2투	2793	2068	725	2	2066	309	1750	0	1	3	3
전라북도	전주시완산구	동서학동	소계	6742	5144	1598	12	5132	691	4427	0	1	9	4
전라북도	전주시완산구	동서학동	동서학동제1투	3057	2401	656	4	2397	327	2064	0	0	5	1
전라북도	전주시완산구	동서학동	동서학동제2투	1744	1314	430	1	1313	163	1148	0	0	1	1
전라북도	전주시완산구	동서학동	동서학동제3투	1941	1429	512	7	1422	201	1215	0	1	3	2
전라북도	전주시완산구	서서학동	소계	9201	7004	2197	21	6983	745	6217	1	5	12	3
전라북도	전주시완산구	서서학동	서서학동제1투	3024	2235	789	8	2227	293	1926	0	2	6	0
전라북도	전주시완산구	서서학동	서서학동제2투	3184	2430	754	10	2420	203	2212	1	0	3	1
전라북도	전주시완산구	서서학동	서서학동제3투	2993	2339	654	3	2336	249	2079	0	3	3	2
전라북도	전주시완산구	중화산1동	소계	12147	9874	2273	19	9855	1362	8448	3	5	32	5
전라북도	전주시완산구	중화산1동	중화산1동제1투	4437	3620	817	6	3614	434	3170	0	1	7	2
전라북도	전주시완산구	중화산1동	중화산1동제2투	4167	3420	747	8	3412	447	2945	0	2	17	1
전라북도	전주시완산구	중화산1동	중화산1동제3투	3543	2834	709	5	2829	481	2333	3	2	8	2
전라북도	전주시완산구	중화산2동	소계	14712	11685	3027	14	11671	1458	10188	2	4	17	2
전라북도	전주시완산구	중화산2동	중화산2동제1투	4220	3669	551	4	3665	577	3079	0	2	7	0
전라북도	전주시완산구	중화산2동	중화산2동제2투	3977	2815	1162	5	2810	277	2530	0	2	1	0
전라북도	전주시완산구	중화산2동	중화산2동제3투	3327	2622	705	3	2619	291	2323	0	0	3	2
전라북도	전주시완산구	중화산2동	중화산2동제4투	3188	2579	609	2	2577	313	2256	2	0	6	0
전라북도	전주시완산구	평화1동	소계	11675	8729	2946	29	8700	1107	7559	0	5	19	10
전라북도	전주시완산구	평화1동	평화1동제1투	4298	3144	1154	13	3131	409	2709	0	2	8	3
전라북도	전주시완산구	평화1동	평화1동제2투	4047	2943	1104	13	2930	413	2502	0	3	6	6
전라북도	전주시완산구	평화1동	평화1동제3투	3330	2642	688	3	2639	285	2348	0	0	5	1
전라북도	전주시완산구	평화2동	소계	31965	26449	5516	61	26388	2740	23575	8	5	42	18
전라북도	전주시완산구	평화2동	평화2동제1투	4099	3352	747	8	3344	468	2863	1	0	8	4
전라북도	전주시완산구	평화2동	평화2동제2투	3992	3252	740	3	3249	309	2931	1	1	4	3
전라북도	전주시완산구	평화2동	평화2동제3투	3399	2663	736	16	2647	321	2317	3	1	4	1
전라북도	전주시완산구	평화2동	평화2동제4투	3089	2673	416	3	2670	245	2411	1	0	8	5
전라북도	전주시완산구	평화2동	평화2동제5투	1614	1226	388	6	1220	115	1099	1	0	4	1
전라북도	전주시완산구	평화2동	평화2동제6투	4157	3509	648	8	3501	302	3189	0	2	7	1
전라북도	전주시완산구	평화2동	평화2동제7투	3386	2826	560	5	2821	328	2489	0	0	4	0
전라북도	전주시완산구	평화2동	평화2동제8투	4606	3829	777	4	3825	348	3474	0	0	1	2
전라북도	전주시완산구	평화2동	평화2동제9투	3623	3119	504	8	3111	304	2802	1	1	2	1
전라북도	전주시완산구	서신동	소계	33291	27203	6088	37	27166	3087	24007	5	16	41	10
전라북도	전주시완산구	서신동	서신동제1투	3347	2723	624	2	2721	317	2399	1	0	4	0
전라북도	전주시완산구	서신동	서신동제2투	3467	2625	842	5	2620	276	2328	0	4	10	2
전라북도	전주시완산구	서신동	서신동제3투	2653	2224	429	7	2217	370	1837	2	2	6	0
전라북도	전주시완산구	서신동	서신동제4투	3016	2400	616	7	2393	335	2051	1	3	2	1
전라북도	전주시완산구	서신동	서신동제5투	3668	2904	764	6	2898	253	2634	0	3	5	3
전라북도	전주시완산구	서신동	서신동제6투	2485	2134	351	3	2131	210	1918	1	0	2	0
전라북도	전주시완산구	서신동	서신동제7투	2656	2230	426	0	2230	210	2017	0	1	2	0
전라북도	전주시완산구	서신동	서신동제8투	3886	3362	524	4	3358	367	2985	0	2	3	1
전라북도	전주시완산구	서신동	서신동제9투	3307	2856	451	3	2853	258	2590	0	0	2	3
전라북도	전주시완산구	서신동	서신동제10투	4806	3745	1061	0	3745	491	3248	0	1	5	0
전라북도	전주시완산구	삼천1동	소계	10793	8547	2246	25	8522	994	7499	0	6	23	0
전라북도	전주시완산구	삼천1동	삼천1동제1투	3374	2600	774	5	2595	324	2261	0	1	9	0
전라북도	전주시완산구	삼천1동	삼천1동제2투	4124	3402	722	17	3385	392	2979	0	3	11	0
전라북도	전주시완산구	삼천1동	삼천1동제3투	3295	2545	750	3	2542	278	2259	0	2	3	0
전라북도	전주시완산구	삼천2동	소계	13996	10842	3154	24	10818	1206	9588	2	1	18	3
전라북도	전주시완산구	삼천2동	삼천2동제1투	3734	2741	993	7	2734	290	2440	0	0	4	0
전라북도	전주시완산구	삼천2동	삼천2동제2투	2431	1955	476	4	1951	176	1771	0	0	2	2
전라북도	전주시완산구	삼천2동	삼천2동제3투	3796	3144	652	8	3136	426	2700	1	1	8	0
전라북도	전주시완산구	삼천2동	삼천2동제4투	4035	3002	1033	5	2997	314	2677	1	0	4	1
전라북도	전주시완산구	삼천3동	소계	17206	14230	2976	26	14204	1377	12792	1	10	17	7
전라북도	전주시완산구	삼천3동	삼천3동제1투	3166	2629	537	3	2626	253	2370	0	1	2	0
전라북도	전주시완산구	삼천3동	삼천3동제2투	1189	872	317	3	869	115	751	0	1	1	1
전라북도	전주시완산구	삼천3동	삼천3동제3투	3712	3136	576	6	3130	266	2854	1	2	5	2
전라북도	전주시완산구	삼천3동	삼천3동제4투	3130	2675	455	2	2673	228	2438	0	3	3	1
전라북도	전주시완산구	삼천3동	삼천3동제5투	2325	1748	577	9	1739	224	1507	0	1	5	2
전라북도	전주시완산구	삼천3동	삼천3동제6투	3684	3170	514	3	3167	291	2872	0	2	1	1
전라북도	전주시완산구	효자1동	소계	11316	9025	2291	26	8999	1256	7718	0	6	13	6
전라북도	전주시완산구	효자1동	효자1동제1투	4019	3284	735	10	3274	474	2790	0	1	8	1
전라북도	전주시완산구	효자1동	효자1동제2투	4024	3143	881	6	3137	355	2770	0	4	3	5
전라북도	전주시완산구	효자1동	효자1동제3투	3273	2598	675	10	2588	427	2158	0	1	2	0
전라북도	전주시완산구	효자2동	소계	10306	7992	2314	13	7979	953	7008	0	1	13	4
전라북도	전주시완산구	효자2동	효자2동제1투	3745	2939	806	1	2938	335	2597	0	1	4	1
전라북도	전주시완산구	효자2동	효자2동제2투	2414	1815	599	5	1810	261	1546	0	0	3	0
전라북도	전주시완산구	효자2동	효자2동제3투	4147	3238	909	7	3231	357	2865	0	0	6	3
전라북도	전주시완산구	효자3동	소계	13097	11056	2041	24	11032	1298	9707	0	5	17	5
전라북도	전주시완산구	효자3동	효자3동제1투	2987	2508	479	8	2500	375	2120	0	1	3	1
전라북도	전주시완산구	효자3동	효자3동제2투	3731	3158	573	6	3152	374	2769	0	1	6	2
전라북도	전주시완산구	효자3동	효자3동제3투	3477	2914	563	5	2909	337	2562	0	2	7	1
전라북도	전주시완산구	효자3동	효자3동제4투	2902	2476	426	5	2471	212	2256	0	1	1	1
전라북도	전주시완산구	효자4동	소계	38997	31358	7639	46	31312	3545	27708	3	13	35	8
전라북도	전주시완산구	효자4동	효자4동제1투	2439	2018	421	2	2016	314	1697	0	1	3	1
전라북도	전주시완산구	효자4동	효자4동제2투	2355	2038	317	1	2037	383	1649	1	0	3	1
전라북도	전주시완산구	효자4동	효자4동제3투	3157	2343	814	5	2338	212	2122	0	0	3	1
전라북도	전주시완산구	효자4동	효자4동제4투	3862	3050	812	5	3045	280	2758	2	3	1	1
전라북도	전주시완산구	효자4동	효자4동제5투	4031	3301	730	10	3291	353	2932	0	1	2	3
전라북도	전주시완산구	효자4동	효자4동제6투	4086	3178	908	8	3170	330	2834	0	2	3	1
전라북도	전주시완산구	효자4동	효자4동제7투	3374	2422	952	1	2421	273	2145	0	0	3	0
전라북도	전주시완산구	효자4동	효자4동제8투	3467	2569	898	4	2565	279	2281	0	3	2	0
전라북도	전주시완산구	효자4동	효자4동제9투	3753	3323	430	4	3319	457	2858	0	1	3	0
전라북도	전주시완산구	효자4동	효자4동제10투	3269	2908	361	2	2906	247	2652	0	1	6	0
전라북도	전주시완산구	효자4동	효자4동제11투	2582	2203	379	3	2200	243	1951	0	1	5	0
전라북도	전주시완산구	효자4동	효자4동제12투	2622	2005	617	1	2004	174	1829	0	0	1	0
전라북도	전주시덕진구	계	계	217955	172431	45524	420	172011	20283	151196	39	117	268	108
전라북도	전주시덕진구	재외투표	재외투표	748	527	221	5	522	65	455	0	1	1	0
전라북도	전주시덕진구	국내부재자투표	국내부재자투표	6489	5938	551	63	5875	1115	4714	7	9	14	16
전라북도	전주시덕진구	진북동	소계	14146	11116	3030	20	11096	1705	9362	3	5	17	4
전라북도	전주시덕진구	진북동	진북동제1투	2765	1958	807	5	1953	249	1700	2	1	1	0
전라북도	전주시덕진구	진북동	진북동제2투	2768	2244	524	3	2241	404	1828	1	2	5	1
전라북도	전주시덕진구	진북동	진북동제3투	3427	2752	675	7	2745	368	2371	0	0	5	1
전라북도	전주시덕진구	진북동	진북동제4투	3102	2579	523	2	2577	420	2153	0	0	3	1
전라북도	전주시덕진구	진북동	진북동제5투	2084	1583	501	3	1580	264	1310	0	2	3	1
전라북도	전주시덕진구	인후1동	소계	15041	12302	2739	26	12276	1503	10737	1	10	18	7
전라북도	전주시덕진구	인후1동	인후1동제1투	4485	3424	1061	7	3417	406	3004	0	0	5	2
전라북도	전주시덕진구	인후1동	인후1동제2투	2974	2369	605	8	2361	281	2072	0	1	5	2
전라북도	전주시덕진구	인후1동	인후1동제3투	3554	3040	514	4	3036	401	2628	1	5	1	0
전라북도	전주시덕진구	인후1동	인후1동제4투	4028	3469	559	7	3462	415	3033	0	4	7	3
전라북도	전주시덕진구	인후2동	소계	10611	7884	2727	13	7871	967	6885	4	3	9	3
전라북도	전주시덕진구	인후2동	인후2동제1투	2673	2010	663	3	2007	240	1762	0	2	1	2
전라북도	전주시덕진구	인후2동	인후2동제2투	2327	1656	671	3	1653	196	1451	3	0	2	1
전라북도	전주시덕진구	인후2동	인후2동제3투	2548	1841	707	4	1837	225	1607	1	0	4	0
전라북도	전주시덕진구	인후2동	인후2동제4투	3063	2377	686	3	2374	306	2065	0	1	2	0
전라북도	전주시덕진구	인후3동	소계	26405	20530	5875	31	20499	2063	18395	4	10	19	8
전라북도	전주시덕진구	인후3동	인후3동제1투	3908	2644	1264	7	2637	291	2341	0	1	2	2
전라북도	전주시덕진구	인후3동	인후3동제2투	3709	2917	792	4	2913	275	2634	0	1	1	2
전라북도	전주시덕진구	인후3동	인후3동제3투	3790	3009	781	2	3007	283	2715	1	1	6	1
전라북도	전주시덕진구	인후3동	인후3동제4투	3607	3112	495	4	3108	403	2697	0	1	5	2
전라북도	전주시덕진구	인후3동	인후3동제5투	4357	3610	747	3	3607	320	3280	2	2	2	1
전라북도	전주시덕진구	인후3동	인후3동제6투	3965	3247	718	6	3241	297	2940	1	2	1	0
전라북도	전주시덕진구	인후3동	인후3동제7투	3069	1991	1078	5	1986	194	1788	0	2	2	0
전라북도	전주시덕진구	덕진동	소계	13704	10534	3170	20	10514	1280	9211	1	4	16	2
전라북도	전주시덕진구	덕진동	덕진동제1투	3295	2360	935	3	2357	316	2039	0	0	2	0
전라북도	전주시덕진구	덕진동	덕진동제2투	2874	2155	719	5	2150	295	1850	0	0	3	2
전라북도	전주시덕진구	덕진동	덕진동제3투	3658	2916	742	6	2910	362	2537	0	4	7	0
전라북도	전주시덕진구	덕진동	덕진동제4투	3877	3103	774	6	3097	307	2785	1	0	4	0
전라북도	전주시덕진구	금암1동	소계	6607	4796	1811	8	4788	670	4104	2	2	5	5
전라북도	전주시덕진구	금암1동	금암1동제1투	3022	2190	832	4	2186	353	1823	2	2	2	4
전라북도	전주시덕진구	금암1동	금암1동제2투	3585	2606	979	4	2602	317	2281	0	0	3	1
전라북도	전주시덕진구	금암2동	소계	9702	7548	2154	16	7532	1048	6463	1	3	13	4
전라북도	전주시덕진구	금암2동	금암2동제1투	3170	2372	798	6	2366	298	2056	0	3	6	3
전라북도	전주시덕진구	금암2동	금암2동제2투	3369	2706	663	8	2698	420	2273	1	0	4	0
전라북도	전주시덕진구	금암2동	금암2동제3투	3163	2470	693	2	2468	330	2134	0	0	3	1
전라북도	전주시덕진구	팔복동	소계	8896	6504	2392	16	6488	714	5746	3	7	10	8
전라북도	전주시덕진구	팔복동	팔복동제1투	3447	2514	933	6	2508	282	2215	1	2	5	3
전라북도	전주시덕진구	팔복동	팔복동제2투	3676	2717	959	7	2710	278	2417	2	5	4	4
전라북도	전주시덕진구	팔복동	팔복동제3투	1773	1273	500	3	1270	154	1114	0	0	1	1
전라북도	전주시덕진구	우아1동	소계	9974	7370	2604	16	7354	938	6396	0	4	13	3
전라북도	전주시덕진구	우아1동	우아1동제1투	3371	2527	844	7	2520	357	2157	0	1	4	1
전라북도	전주시덕진구	우아1동	우아1동제2투	3168	2391	777	3	2388	242	2139	0	1	4	2
전라북도	전주시덕진구	우아1동	우아1동제3투	3435	2452	983	6	2446	339	2100	0	2	5	0
전라북도	전주시덕진구	우아2동	소계	11719	8799	2920	9	8790	934	7826	1	8	14	7
전라북도	전주시덕진구	우아2동	우아2동제1투	2796	2312	484	3	2309	210	2091	0	2	6	0
전라북도	전주시덕진구	우아2동	우아2동제2투	3993	2936	1057	3	2933	362	2561	1	3	4	2
전라북도	전주시덕진구	우아2동	우아2동제3투	821	620	201	1	619	78	534	0	1	2	4
전라북도	전주시덕진구	우아2동	우아2동제4투	4109	2931	1178	2	2929	284	2640	0	2	2	1
전라북도	전주시덕진구	호성동	소계	17403	14595	2808	37	14558	1621	12898	3	16	17	3
전라북도	전주시덕진구	호성동	호성동제1투	1371	1056	315	15	1041	140	897	1	1	2	0
전라북도	전주시덕진구	호성동	호성동제2투	3809	3095	714	7	3088	272	2807	0	4	5	0
전라북도	전주시덕진구	호성동	호성동제3투	3342	2860	482	4	2856	265	2585	1	4	1	0
전라북도	전주시덕진구	호성동	호성동제4투	3843	3263	580	7	3256	348	2896	1	3	6	2
전라북도	전주시덕진구	호성동	호성동제5투	5038	4321	717	4	4317	596	3713	0	4	3	1
전라북도	전주시덕진구	송천1동	소계	25086	20879	4207	52	20827	2238	18537	2	10	31	9
전라북도	전주시덕진구	송천1동	송천1동제1투	3205	2565	640	8	2557	290	2260	0	2	4	1
전라북도	전주시덕진구	송천1동	송천1동제2투	3133	2482	651	7	2475	245	2223	0	2	3	2
전라북도	전주시덕진구	송천1동	송천1동제3투	3711	2920	791	7	2913	300	2609	0	2	1	1
전라북도	전주시덕진구	송천1동	송천1동제4투	4539	3844	695	7	3837	430	3397	0	2	7	1
전라북도	전주시덕진구	송천1동	송천1동제5투	3292	2873	419	6	2867	259	2599	0	1	6	2
전라북도	전주시덕진구	송천1동	송천1동제6투	3809	3282	527	5	3277	346	2926	0	0	4	1
전라북도	전주시덕진구	송천1동	송천1동제7투	3397	2913	484	12	2901	368	2523	2	1	6	1
전라북도	전주시덕진구	송천2동	소계	19965	16516	3449	29	16487	1710	14729	1	10	31	6
전라북도	전주시덕진구	송천2동	송천2동제1투	2692	2140	552	3	2137	220	1912	0	0	4	1
전라북도	전주시덕진구	송천2동	송천2동제2투	3028	2585	443	4	2581	241	2333	0	0	4	3
전라북도	전주시덕진구	송천2동	송천2동제3투	2608	2157	451	4	2153	193	1953	0	3	4	0
전라북도	전주시덕진구	송천2동	송천2동제4투	3309	2722	587	7	2715	297	2410	0	2	5	1
전라북도	전주시덕진구	송천2동	송천2동제5투	4467	3777	690	4	3773	458	3306	0	2	7	0
전라북도	전주시덕진구	송천2동	송천2동제6투	1272	965	307	3	962	83	872	1	3	3	0
전라북도	전주시덕진구	송천2동	송천2동제7투	2589	2170	419	4	2166	218	1943	0	0	4	1
전라북도	전주시덕진구	조촌동	소계	8394	6421	1973	40	6381	634	5701	4	5	23	14
전라북도	전주시덕진구	조촌동	조촌동제1투	2925	2389	536	6	2383	198	2174	0	3	6	2
전라북도	전주시덕진구	조촌동	조촌동제2투	3212	2313	899	3	2310	263	2039	1	1	3	3
전라북도	전주시덕진구	조촌동	조촌동제3투	2257	1719	538	31	1688	173	1488	3	1	14	9
전라북도	전주시덕진구	동산동	소계	13065	10172	2893	19	10153	1078	9037	2	10	17	9
전라북도	전주시덕진구	동산동	동산동제1투	3400	2558	842	6	2552	274	2269	1	0	7	1
전라북도	전주시덕진구	동산동	동산동제2투	3539	2877	662	3	2874	331	2530	0	3	5	5
전라북도	전주시덕진구	동산동	동산동제3투	3730	2888	842	5	2883	285	2586	1	5	5	1
전라북도	전주시덕진구	동산동	동산동제4투	2396	1849	547	5	1844	188	1652	0	2	0	2
전라북도	군산시	계	계	218605	164176	54429	542	163634	24862	138173	57	68	312	162
전라북도	군산시	재외투표	재외투표	647	468	179	2	466	83	382	0	1	0	0
전라북도	군산시	국내부재자투표	국내부재자투표	6756	6170	586	103	6067	1134	4886	6	7	17	17
전라북도	군산시	옥구읍	소계	3263	2486	777	16	2470	409	2049	2	0	5	5
전라북도	군산시	옥구읍	옥구읍투표소	3263	2486	777	16	2470	409	2049	2	0	5	5
전라북도	군산시	옥산면	소계	2400	1780	620	5	1775	266	1500	1	2	5	1
전라북도	군산시	옥산면	옥산면투표소	2400	1780	620	5	1775	266	1500	1	2	5	1
전라북도	군산시	회현면	소계	3050	2354	696	18	2336	352	1959	2	3	11	9
전라북도	군산시	회현면	회현면투표소	3050	2354	696	18	2336	352	1959	2	3	11	9
전라북도	군산시	임피면	소계	2824	2094	730	8	2086	276	1792	2	2	10	4
전라북도	군산시	임피면	임피면투표소	2824	2094	730	8	2086	276	1792	2	2	10	4
전라북도	군산시	서수면	소계	2625	1884	741	12	1872	274	1580	1	1	10	6
전라북도	군산시	서수면	서수면투표소	2625	1884	741	12	1872	274	1580	1	1	10	6
전라북도	군산시	대야면	소계	5330	3973	1357	13	3960	638	3289	2	3	18	10
전라북도	군산시	대야면	대야면제1투	2612	1934	678	8	1926	275	1635	2	0	6	8
전라북도	군산시	대야면	대야면제2투	2718	2039	679	5	2034	363	1654	0	3	12	2
전라북도	군산시	개정면	소계	3229	2353	876	4	2349	373	1965	0	3	6	2
전라북도	군산시	개정면	개정면투표소	3229	2353	876	4	2349	373	1965	0	3	6	2
전라북도	군산시	성산면	소계	2876	2143	733	9	2134	359	1766	0	1	6	2
전라북도	군산시	성산면	성산면투표소	2876	2143	733	9	2134	359	1766	0	1	6	2
전라북도	군산시	나포면	소계	2350	1754	596	11	1743	266	1452	4	2	10	9
전라북도	군산시	나포면	나포면투표소	2350	1754	596	11	1743	266	1452	4	2	10	9
전라북도	군산시	옥도면	소계	3347	1603	1744	9	1594	275	1307	2	1	3	6
전라북도	군산시	옥도면	옥도면제1투	717	305	412	3	302	39	260	0	0	1	2
전라북도	군산시	옥도면	옥도면제2투	156	69	87	1	68	8	58	0	1	1	0
전라북도	군산시	옥도면	옥도면제3투	316	132	184	0	132	32	100	0	0	0	0
전라북도	군산시	옥도면	옥도면제4투	250	159	91	1	158	14	144	0	0	0	0
전라북도	군산시	옥도면	옥도면제5투	299	187	112	0	187	33	151	0	0	1	2
전라북도	군산시	옥도면	옥도면제6투	942	446	496	4	442	83	356	2	0	0	1
전라북도	군산시	옥도면	옥도면제7투	88	45	43	0	45	8	36	0	0	0	1
전라북도	군산시	옥도면	옥도면제8투	199	84	115	0	84	10	74	0	0	0	0
전라북도	군산시	옥도면	옥도면제9투	55	33	22	0	33	4	29	0	0	0	0
전라북도	군산시	옥도면	옥도면제10투	325	143	182	0	143	44	99	0	0	0	0
전라북도	군산시	옥서면	소계	3925	2828	1097	16	2812	423	2373	1	2	6	7
전라북도	군산시	옥서면	옥서면투표소	3925	2828	1097	16	2812	423	2373	1	2	6	7
전라북도	군산시	해신동	소계	2470	1684	786	7	1677	282	1390	0	0	3	2
전라북도	군산시	해신동	해신동투표소	2470	1684	786	7	1677	282	1390	0	0	3	2
전라북도	군산시	월명동	소계	6817	4751	2066	11	4740	833	3895	0	3	3	6
전라북도	군산시	월명동	월명동제1투	1623	972	651	1	971	212	757	0	0	1	1
전라북도	군산시	월명동	월명동제2투	2072	1536	536	4	1532	282	1247	0	1	1	1
전라북도	군산시	월명동	월명동제3투	3122	2243	879	6	2237	339	1891	0	2	1	4
전라북도	군산시	삼학동	소계	6225	4604	1621	11	4593	796	3782	0	1	9	5
전라북도	군산시	삼학동	삼학동제1투	2059	1497	562	3	1494	317	1169	0	1	6	1
전라북도	군산시	삼학동	삼학동제2투	1748	1277	471	2	1275	190	1081	0	0	1	3
전라북도	군산시	삼학동	삼학동제3투	2418	1830	588	6	1824	289	1532	0	0	2	1
전라북도	군산시	신풍동	소계	6999	5306	1693	18	5288	879	4380	2	1	22	4
전라북도	군산시	신풍동	신풍동제1투	2359	1723	636	8	1715	315	1392	1	0	5	2
전라북도	군산시	신풍동	신풍동제2투	2027	1471	556	8	1463	256	1197	1	1	7	1
전라북도	군산시	신풍동	신풍동제3투	2613	2112	501	2	2110	308	1791	0	0	10	1
전라북도	군산시	중앙동	소계	3572	2460	1112	8	2452	403	2036	0	0	10	3
전라북도	군산시	중앙동	중앙동투표소	3572	2460	1112	8	2452	403	2036	0	0	10	3
전라북도	군산시	흥남동	소계	8985	6735	2250	19	6716	1034	5666	1	4	6	5
전라북도	군산시	흥남동	흥남동제1투	1284	832	452	4	828	157	671	0	0	0	0
전라북도	군산시	흥남동	흥남동제2투	3565	2707	858	4	2703	398	2297	0	2	4	2
전라북도	군산시	흥남동	흥남동제3투	1993	1560	433	7	1553	238	1309	1	1	1	3
전라북도	군산시	흥남동	흥남동제4투	2143	1636	507	4	1632	241	1389	0	1	1	0
전라북도	군산시	조촌동	소계	12015	8967	3048	19	8948	1266	7663	2	1	10	6
전라북도	군산시	조촌동	조촌동제1투	2750	2004	746	1	2003	262	1738	1	0	0	2
전라북도	군산시	조촌동	조촌동제2투	4099	3040	1059	8	3032	406	2619	0	0	6	1
전라북도	군산시	조촌동	조촌동제3투	2474	1797	677	5	1792	337	1449	1	1	1	3
전라북도	군산시	조촌동	조촌동제4투	2692	2126	566	5	2121	261	1857	0	0	3	0
전라북도	군산시	경암동	소계	6944	5108	1836	15	5093	800	4280	0	1	5	7
전라북도	군산시	경암동	경암동제1투	2457	1743	714	5	1738	284	1446	0	0	3	5
전라북도	군산시	경암동	경암동제2투	2639	1959	680	6	1953	261	1689	0	0	1	2
전라북도	군산시	경암동	경암동제3투	1848	1406	442	4	1402	255	1145	0	1	1	0
전라북도	군산시	구암동	소계	5335	4128	1207	10	4118	599	3507	2	0	7	3
전라북도	군산시	구암동	구암동제1투	2627	1950	677	6	1944	301	1641	0	0	2	0
전라북도	군산시	구암동	구암동제2투	2708	2178	530	4	2174	298	1866	2	0	5	3
전라북도	군산시	개정동	소계	2742	2113	629	5	2108	311	1787	1	2	5	2
전라북도	군산시	개정동	개정동투표소	2742	2113	629	5	2108	311	1787	1	2	5	2
전라북도	군산시	수송동	소계	29084	23276	5808	46	23230	3415	19758	6	8	31	12
전라북도	군산시	수송동	수송동제1투	3358	2595	763	4	2591	419	2169	0	1	1	1
전라북도	군산시	수송동	수송동제2투	3012	2407	605	3	2404	295	2101	1	0	3	4
전라북도	군산시	수송동	수송동제3투	2157	1663	494	3	1660	235	1420	0	2	2	1
전라북도	군산시	수송동	수송동제4투	2955	2283	672	9	2274	311	1951	0	2	10	0
전라북도	군산시	수송동	수송동제5투	4753	3528	1225	7	3521	518	2998	0	0	3	2
전라북도	군산시	수송동	수송동제6투	4472	3699	773	8	3691	521	3165	0	1	2	2
전라북도	군산시	수송동	수송동제7투	4193	3589	604	7	3582	551	3022	2	2	5	0
전라북도	군산시	수송동	수송동제8투	4184	3512	672	5	3507	565	2932	3	0	5	2
전라북도	군산시	나운1동	소계	13029	9654	3375	21	9633	1424	8185	5	2	11	6
전라북도	군산시	나운1동	나운1동제1투	3309	2491	818	4	2487	374	2105	3	1	4	0
전라북도	군산시	나운1동	나운1동제2투	4101	3092	1009	6	3086	459	2622	1	1	1	2
전라북도	군산시	나운1동	나운1동제3투	3305	2541	764	6	2535	365	2165	0	0	3	2
전라북도	군산시	나운1동	나운1동제4투	2314	1530	784	5	1525	226	1293	1	0	3	2
전라북도	군산시	나운2동	소계	19788	15884	3904	48	15836	2307	13473	5	9	33	9
전라북도	군산시	나운2동	나운2동제1투	3452	2849	603	7	2842	471	2365	0	1	4	1
전라북도	군산시	나운2동	나운2동제2투	2719	1961	758	22	1939	367	1553	2	1	11	5
전라북도	군산시	나운2동	나운2동제3투	2735	2153	582	8	2145	278	1862	0	1	2	2
전라북도	군산시	나운2동	나운2동제4투	3934	3266	668	6	3260	408	2846	0	1	5	0
전라북도	군산시	나운2동	나운2동제5투	3777	3108	669	2	3106	439	2656	3	4	3	1
전라북도	군산시	나운2동	나운2동제6투	3171	2547	624	3	2544	344	2191	0	1	8	0
전라북도	군산시	나운3동	소계	26856	20531	6325	34	20497	2894	17562	2	5	27	7
전라북도	군산시	나운3동	나운3동제1투	3622	2790	832	3	2787	347	2437	0	0	3	0
전라북도	군산시	나운3동	나운3동제2투	2403	1962	441	4	1958	334	1620	1	1	2	0
전라북도	군산시	나운3동	나운3동제3투	3276	2578	698	3	2575	294	2276	1	0	4	0
전라북도	군산시	나운3동	나운3동제4투	3024	2283	741	7	2276	284	1989	0	0	2	1
전라북도	군산시	나운3동	나운3동제5투	2439	1858	581	2	1856	333	1515	0	0	6	2
전라북도	군산시	나운3동	나운3동제6투	3074	1898	1176	2	1896	262	1631	0	2	1	0
전라북도	군산시	나운3동	나운3동제7투	2942	2281	661	2	2279	254	2019	0	2	2	2
전라북도	군산시	나운3동	나운3동제8투	2413	1960	453	4	1956	285	1668	0	0	2	1
전라북도	군산시	나운3동	나운3동제9투	3663	2921	742	7	2914	501	2407	0	0	5	1
전라북도	군산시	소룡동	소계	14966	10342	4624	23	10319	1516	8785	2	0	13	3
전라북도	군산시	소룡동	소룡동제1투	3184	2212	972	4	2208	361	1843	0	0	3	1
전라북도	군산시	소룡동	소룡동제2투	2563	1852	711	4	1848	265	1579	0	0	3	1
전라북도	군산시	소룡동	소룡동제3투	3333	2309	1024	5	2304	298	2002	1	0	2	1
전라북도	군산시	소룡동	소룡동제4투	4543	3271	1272	9	3262	440	2817	1	0	4	0
전라북도	군산시	소룡동	소룡동제5투	1343	698	645	1	697	152	544	0	0	1	0
전라북도	군산시	미성동	소계	10156	6743	3413	21	6722	975	5724	6	3	10	4
전라북도	군산시	미성동	미성동제1투	2687	1725	962	5	1720	229	1481	3	1	5	1
전라북도	군산시	미성동	미성동제2투	3163	2307	856	10	2297	342	1953	0	1	1	0
전라북도	군산시	미성동	미성동제3투	984	725	259	2	723	101	619	0	1	2	0
전라북도	군산시	미성동	미성동제4투	3322	1986	1336	4	1982	303	1671	3	0	2	3
전라북도	익산시	계	계	240817	182350	58467	972	181378	24639	156065	99	82	304	189
전라북도	익산시	재외투표	재외투표	776	549	227	3	546	93	449	0	0	3	1
전라북도	익산시	국내부재자투표	국내부재자투표	7474	6721	753	94	6627	1418	5150	8	12	19	20
전라북도	익산시	함열읍	소계	6706	4871	1835	21	4850	707	4118	2	2	10	11
전라북도	익산시	함열읍	함열읍제1투	3695	2675	1020	10	2665	376	2274	0	1	7	7
전라북도	익산시	함열읍	함열읍제2투	3011	2196	815	11	2185	331	1844	2	1	3	4
전라북도	익산시	오산면	소계	7280	5423	1857	30	5393	674	4701	1	3	7	7
전라북도	익산시	오산면	오산면제1투	2453	1787	666	14	1773	233	1534	0	0	1	5
전라북도	익산시	오산면	오산면제2투	3343	2476	867	7	2469	279	2185	1	1	1	2
전라북도	익산시	오산면	오산면제3투	1484	1160	324	9	1151	162	982	0	2	5	0
전라북도	익산시	황등면	소계	7251	5290	1961	31	5259	674	4565	2	2	7	9
전라북도	익산시	황등면	황등면제1투	2707	1936	771	12	1924	251	1665	1	0	4	3
전라북도	익산시	황등면	황등면제2투	3544	2613	931	13	2600	339	2252	1	1	3	4
전라북도	익산시	황등면	황등면제3투	1000	741	259	6	735	84	648	0	1	0	2
전라북도	익산시	함라면	소계	2192	1680	512	16	1664	277	1372	1	0	8	6
전라북도	익산시	함라면	함라면투표소	2192	1680	512	16	1664	277	1372	1	0	8	6
전라북도	익산시	웅포면	소계	1655	1274	381	3	1271	163	1100	0	0	2	6
전라북도	익산시	웅포면	웅포면투표소	1655	1274	381	3	1271	163	1100	0	0	2	6
전라북도	익산시	성당면	소계	2022	1449	573	6	1443	251	1181	1	0	7	3
전라북도	익산시	성당면	성당면투표소	2022	1449	573	6	1443	251	1181	1	0	7	3
전라북도	익산시	용안면	소계	2691	2014	677	20	1994	395	1581	2	1	5	10
전라북도	익산시	용안면	용안면투표소	2691	2014	677	20	1994	395	1581	2	1	5	10
전라북도	익산시	낭산면	소계	3075	2336	739	9	2327	336	1984	0	1	3	3
전라북도	익산시	낭산면	낭산면투표소	3075	2336	739	9	2327	336	1984	0	1	3	3
전라북도	익산시	망성면	소계	3160	2262	898	12	2250	550	1687	3	1	4	5
전라북도	익산시	망성면	망성면투표소	3160	2262	898	12	2250	550	1687	3	1	4	5
전라북도	익산시	여산면	소계	3174	2337	837	10	2327	452	1860	2	0	8	5
전라북도	익산시	여산면	여산면투표소	3174	2337	837	10	2327	452	1860	2	0	8	5
전라북도	익산시	금마면	소계	4151	3034	1117	26	3008	626	2370	2	1	5	4
전라북도	익산시	금마면	금마면제1투	2614	1885	729	19	1866	406	1451	2	1	3	3
전라북도	익산시	금마면	금마면제2투	1537	1149	388	7	1142	220	919	0	0	2	1
전라북도	익산시	왕궁면	소계	4955	3763	1192	21	3742	688	3037	1	1	9	6
전라북도	익산시	왕궁면	왕궁면제1투	2417	1771	646	10	1761	231	1522	0	1	5	2
전라북도	익산시	왕궁면	왕궁면제2투	1468	1113	355	5	1108	164	938	1	0	4	1
전라북도	익산시	왕궁면	왕궁면제3투	1070	879	191	6	873	293	577	0	0	0	3
전라북도	익산시	춘포면	소계	4569	3372	1197	26	3346	429	2899	2	5	7	4
전라북도	익산시	춘포면	춘포면제1투	1626	1235	391	14	1221	145	1069	1	2	2	2
전라북도	익산시	춘포면	춘포면제2투	1463	1056	407	7	1049	136	907	0	1	3	2
전라북도	익산시	춘포면	춘포면제3투	1480	1081	399	5	1076	148	923	1	2	2	0
전라북도	익산시	삼기면	소계	2597	1929	668	24	1905	252	1636	1	2	10	4
전라북도	익산시	삼기면	삼기면투표소	2597	1929	668	24	1905	252	1636	1	2	10	4
전라북도	익산시	용동면	소계	1653	1244	409	6	1238	222	1007	1	2	4	2
전라북도	익산시	용동면	용동면투표소	1653	1244	409	6	1238	222	1007	1	2	4	2
전라북도	익산시	중앙동	소계	3974	2693	1281	24	2669	488	2166	5	0	7	3
전라북도	익산시	중앙동	중앙동제1투	1846	1182	664	11	1171	205	958	4	0	2	2
전라북도	익산시	중앙동	중앙동제2투	2128	1511	617	13	1498	283	1208	1	0	5	1
전라북도	익산시	평화동	소계	4597	3459	1138	26	3433	457	2950	13	1	8	4
전라북도	익산시	평화동	평화동제1투	2997	2313	684	11	2302	312	1977	7	0	4	2
전라북도	익산시	평화동	평화동제2투	1600	1146	454	15	1131	145	973	6	1	4	2
전라북도	익산시	인화동	소계	6602	4820	1782	31	4789	666	4098	17	1	5	2
전라북도	익산시	인화동	인화동제1투	3072	2216	856	10	2206	292	1902	7	0	3	2
전라북도	익산시	인화동	인화동제2투	3530	2604	926	21	2583	374	2196	10	1	2	0
전라북도	익산시	동산동	소계	19224	14231	4993	70	14161	1522	12591	4	7	28	9
전라북도	익산시	동산동	동산동제1투	2928	2153	775	5	2148	244	1894	2	0	6	2
전라북도	익산시	동산동	동산동제2투	2529	1824	705	8	1816	208	1604	0	1	2	1
전라북도	익산시	동산동	동산동제3투	3957	2898	1059	14	2884	345	2525	0	1	10	3
전라북도	익산시	동산동	동산동제4투	3487	2600	887	14	2586	251	2328	1	2	4	0
전라북도	익산시	동산동	동산동제5투	2879	2071	808	15	2056	198	1849	1	2	5	1
전라북도	익산시	동산동	동산동제6투	3444	2685	759	14	2671	276	2391	0	1	1	2
전라북도	익산시	마동	소계	9304	6692	2612	36	6656	803	5829	7	2	13	2
전라북도	익산시	마동	마동제1투	2202	1457	745	9	1448	158	1288	1	0	1	0
전라북도	익산시	마동	마동제2투	3467	2495	972	14	2481	300	2172	0	2	6	1
전라북도	익산시	마동	마동제3투	3635	2740	895	13	2727	345	2369	6	0	6	1
전라북도	익산시	남중동	소계	11835	8736	3099	37	8699	1390	7287	1	1	16	4
전라북도	익산시	남중동	남중동제1투	3105	2261	844	8	2253	343	1906	1	0	3	0
전라북도	익산시	남중동	남중동제2투	2983	2265	718	9	2256	378	1872	0	1	3	2
전라북도	익산시	남중동	남중동제3투	2864	2016	848	9	2007	329	1674	0	0	3	1
전라북도	익산시	남중동	남중동제4투	2883	2194	689	11	2183	340	1835	0	0	7	1
전라북도	익산시	모현동	소계	22917	17814	5103	49	17765	2241	15480	8	8	21	7
전라북도	익산시	모현동	모현동제1투	3061	2185	876	6	2179	276	1899	0	1	1	2
전라북도	익산시	모현동	모현동제2투	3003	2420	583	7	2413	361	2044	0	1	7	0
전라북도	익산시	모현동	모현동제3투	3269	2572	697	7	2565	303	2260	2	0	0	0
전라북도	익산시	모현동	모현동제4투	2142	1761	381	7	1754	200	1550	1	1	2	0
전라북도	익산시	모현동	모현동제5투	3512	2779	733	7	2772	394	2365	3	3	6	1
전라북도	익산시	모현동	모현동제6투	4583	3552	1031	5	3547	396	3141	1	2	4	3
전라북도	익산시	모현동	모현동제7투	3347	2545	802	10	2535	311	2221	1	0	1	1
전라북도	익산시	송학동	소계	6393	4910	1483	13	4897	569	4317	1	0	8	2
전라북도	익산시	송학동	송학동제1투	1997	1466	531	4	1462	176	1281	0	0	4	1
전라북도	익산시	송학동	송학동제2투	2177	1789	388	3	1786	212	1570	1	0	2	1
전라북도	익산시	송학동	송학동제3투	2219	1655	564	6	1649	181	1466	0	0	2	0
전라북도	익산시	신동	소계	12790	9078	3712	38	9040	1256	7759	1	5	10	9
전라북도	익산시	신동	신동제1투	3749	2686	1063	9	2677	396	2275	0	1	2	3
전라북도	익산시	신동	신동제2투	3543	2510	1033	6	2504	325	2177	0	0	2	0
전라북도	익산시	신동	신동제3투	2828	2052	776	7	2045	278	1758	0	1	4	4
전라북도	익산시	신동	신동제4투	2670	1830	840	16	1814	257	1549	1	3	2	2
전라북도	익산시	영등1동	소계	20594	16174	4420	52	16122	1947	14139	0	2	24	10
전라북도	익산시	영등1동	영등1동제1투	3142	2518	624	7	2511	370	2139	0	0	2	0
전라북도	익산시	영등1동	영등1동제2투	2832	2116	716	6	2110	275	1830	0	0	3	2
전라북도	익산시	영등1동	영등1동제3투	3457	2514	943	12	2502	317	2178	0	1	3	3
전라북도	익산시	영등1동	영등1동제4투	2936	2340	596	5	2335	243	2090	0	0	2	0
전라북도	익산시	영등1동	영등1동제5투	2021	1589	432	14	1575	148	1424	0	0	1	2
전라북도	익산시	영등1동	영등1동제6투	3089	2525	564	3	2522	305	2207	0	0	8	2
전라북도	익산시	영등1동	영등1동제7투	3117	2572	545	5	2567	289	2271	0	1	5	1
전라북도	익산시	영등2동	소계	10893	8796	2097	13	8783	886	7879	2	4	9	3
전라북도	익산시	영등2동	영등2동제1투	4145	3424	721	4	3420	319	3097	0	0	1	3
전라북도	익산시	영등2동	영등2동제2투	3199	2630	569	5	2625	315	2304	1	3	2	0
전라북도	익산시	영등2동	영등2동제3투	3549	2742	807	4	2738	252	2478	1	1	6	0
전라북도	익산시	어양동	소계	16762	12774	3988	31	12743	1436	11283	4	4	11	5
전라북도	익산시	어양동	어양동제1투	3357	2423	934	6	2417	264	2146	1	2	4	0
전라북도	익산시	어양동	어양동제2투	3355	2454	901	8	2446	262	2180	1	1	1	1
전라북도	익산시	어양동	어양동제3투	3375	2700	675	5	2695	385	2307	1	0	1	1
전라북도	익산시	어양동	어양동제4투	1994	1481	513	3	1478	129	1344	1	1	2	1
전라북도	익산시	어양동	어양동제5투	2519	1976	543	5	1971	210	1759	0	0	0	2
전라북도	익산시	어양동	어양동제6투	2162	1740	422	4	1736	186	1547	0	0	3	0
전라북도	익산시	팔봉동	소계	5551	4101	1450	124	3977	549	3395	5	6	10	12
전라북도	익산시	팔봉동	팔봉동제1투	4078	3038	1040	105	2933	415	2493	3	5	8	9
전라북도	익산시	팔봉동	팔봉동제2투	1473	1063	410	19	1044	134	902	2	1	2	3
전라북도	익산시	삼성동	소계	24000	18524	5476	70	18454	2222	16195	2	8	16	11
전라북도	익산시	삼성동	삼성동제1투	2923	2393	530	8	2385	268	2115	0	0	2	0
전라북도	익산시	삼성동	삼성동제2투	3213	2182	1031	21	2161	283	1869	1	1	4	3
전라북도	익산시	삼성동	삼성동제3투	3593	2676	917	6	2670	394	2273	1	0	0	2
전라북도	익산시	삼성동	삼성동제4투	3389	2690	699	6	2684	308	2368	0	3	3	2
전라북도	익산시	삼성동	삼성동제5투	3664	2790	874	11	2779	320	2456	0	0	1	2
전라북도	익산시	삼성동	삼성동제6투	2658	2227	431	5	2222	192	2026	0	3	0	1
전라북도	익산시	삼성동	삼성동제7투	1376	1056	320	9	1047	135	905	0	0	6	1
전라북도	익산시	삼성동	삼성동제8투	3184	2510	674	4	2506	322	2183	0	1	0	0
전라북도	익산시	잘못 투입·구분된 투표지	잘못 투입·구분된 투표지	0	0	0	0	0	0	0	0	0	0	0
전라북도	정읍시	계	계	96742	73237	23505	466	72771	8479	63828	26	33	252	153
전라북도	정읍시	재외투표	재외투표	264	195	69	1	194	50	144	0	0	0	0
전라북도	정읍시	국내부재자투표	국내부재자투표	3213	2872	341	38	2834	446	2373	5	2	4	4
전라북도	정읍시	신태인읍	소계	5593	4103	1490	35	4068	530	3512	1	1	14	10
전라북도	정읍시	신태인읍	신태인읍제1투	2605	1887	718	15	1872	218	1648	0	0	5	1
전라북도	정읍시	신태인읍	신태인읍제2투	1863	1362	501	10	1352	177	1163	1	1	5	5
전라북도	정읍시	신태인읍	신태인읍제3투	1125	854	271	10	844	135	701	0	0	4	4
전라북도	정읍시	북면	소계	4114	2990	1124	28	2962	284	2653	0	1	12	12
전라북도	정읍시	북면	북면제1투	2097	1497	600	14	1483	158	1321	0	0	1	3
전라북도	정읍시	북면	북면제2투	2017	1493	524	14	1479	126	1332	0	1	11	9
전라북도	정읍시	입암면	소계	2955	2224	731	17	2207	213	1971	0	0	15	8
전라북도	정읍시	입암면	입암면제1투	1490	1133	357	9	1124	102	1007	0	0	11	4
전라북도	정읍시	입암면	입암면제2투	1465	1091	374	8	1083	111	964	0	0	4	4
전라북도	정읍시	소성면	소계	2223	1713	510	18	1695	164	1515	0	0	7	9
전라북도	정읍시	소성면	소성면제1투	1167	903	264	6	897	91	799	0	0	4	3
전라북도	정읍시	소성면	소성면제2투	1056	810	246	12	798	73	716	0	0	3	6
전라북도	정읍시	고부면	소계	2993	2188	805	30	2158	261	1870	1	3	11	12
전라북도	정읍시	고부면	고부면제1투	2085	1495	590	25	1470	169	1283	1	2	7	8
전라북도	정읍시	고부면	고부면제2투	908	693	215	5	688	92	587	0	1	4	4
전라북도	정읍시	영원면	소계	1883	1420	463	12	1408	157	1238	0	0	10	3
전라북도	정읍시	영원면	영원면제1투	1284	972	312	7	965	103	855	0	0	6	1
전라북도	정읍시	영원면	영원면제2투	599	448	151	5	443	54	383	0	0	4	2
전라북도	정읍시	덕천면	소계	1857	1414	443	11	1403	151	1245	0	1	2	4
전라북도	정읍시	덕천면	덕천면제1투	1011	776	235	3	773	81	688	0	0	1	3
전라북도	정읍시	덕천면	덕천면제2투	846	638	208	8	630	70	557	0	1	1	1
전라북도	정읍시	이평면	소계	2378	1717	661	16	1701	199	1490	3	1	4	4
전라북도	정읍시	이평면	이평면제1투	1495	1083	412	11	1072	136	926	3	1	2	4
전라북도	정읍시	이평면	이평면제2투	883	634	249	5	629	63	564	0	0	2	0
전라북도	정읍시	정우면	소계	2692	2033	659	21	2012	254	1734	2	0	13	9
전라북도	정읍시	정우면	정우면제1투	1937	1459	478	14	1445	175	1253	2	0	9	6
전라북도	정읍시	정우면	정우면제2투	755	574	181	7	567	79	481	0	0	4	3
전라북도	정읍시	태인면	소계	3666	2664	1002	13	2651	302	2332	1	2	11	3
전라북도	정읍시	태인면	태인면제1투	2439	1765	674	7	1758	208	1538	0	1	8	3
전라북도	정읍시	태인면	태인면제2투	1227	899	328	6	893	94	794	1	1	3	0
전라북도	정읍시	감곡면	소계	2965	2190	775	36	2154	294	1835	3	2	14	6
전라북도	정읍시	감곡면	감곡면투표소	2965	2190	775	36	2154	294	1835	3	2	14	6
전라북도	정읍시	옹동면	소계	1746	1321	425	19	1302	169	1115	0	1	11	6
전라북도	정읍시	옹동면	옹동면투표소	1746	1321	425	19	1302	169	1115	0	1	11	6
전라북도	정읍시	칠보면	소계	2324	1778	546	16	1762	203	1541	0	4	8	6
전라북도	정읍시	칠보면	칠보면제1투	1769	1327	442	13	1314	160	1142	0	3	4	5
전라북도	정읍시	칠보면	칠보면제2투	555	451	104	3	448	43	399	0	1	4	1
전라북도	정읍시	산내면	소계	1305	951	354	9	942	117	804	0	2	14	5
전라북도	정읍시	산내면	산내면투표소	1305	951	354	9	942	117	804	0	2	14	5
전라북도	정읍시	산외면	소계	2188	1642	546	10	1632	229	1378	1	0	14	10
전라북도	정읍시	산외면	산외면투표소	2188	1642	546	10	1632	229	1378	1	0	14	10
전라북도	정읍시	수성동	소계	12942	9785	3157	31	9754	998	8719	3	5	22	7
전라북도	정읍시	수성동	수성동제1투	2035	1399	636	2	1397	192	1198	1	1	3	2
전라북도	정읍시	수성동	수성동제2투	2192	1706	486	9	1697	179	1512	0	0	6	0
전라북도	정읍시	수성동	수성동제3투	2550	1856	694	12	1844	174	1657	2	1	8	2
전라북도	정읍시	수성동	수성동제4투	3059	2444	615	2	2442	225	2212	0	2	2	1
전라북도	정읍시	수성동	수성동제5투	3106	2380	726	6	2374	228	2140	0	1	3	2
전라북도	정읍시	장명동	소계	2870	2122	748	11	2111	243	1857	0	0	5	6
전라북도	정읍시	장명동	장명동투표소	2870	2122	748	11	2111	243	1857	0	0	5	6
전라북도	정읍시	내장상동	소계	14758	11526	3232	37	11489	1287	10165	3	4	21	9
전라북도	정읍시	내장상동	내장상동제1투	3018	2363	655	10	2353	218	2130	1	1	2	1
전라북도	정읍시	내장상동	내장상동제2투	3057	2420	637	6	2414	275	2135	0	0	4	0
전라북도	정읍시	내장상동	내장상동제3투	2228	1821	407	6	1815	215	1596	0	1	3	0
전라북도	정읍시	내장상동	내장상동제4투	2425	1875	550	9	1866	232	1626	1	0	3	4
전라북도	정읍시	내장상동	내장상동제5투	1617	1231	386	4	1227	176	1038	1	2	6	4
전라북도	정읍시	내장상동	내장상동제6투	2413	1816	597	2	1814	171	1640	0	0	3	0
전라북도	정읍시	시기동	소계	3552	2661	891	5	2656	343	2305	0	0	4	4
전라북도	정읍시	시기동	시기동제1투	2279	1720	559	5	1715	235	1475	0	0	4	1
전라북도	정읍시	시기동	시기동제2투	1273	941	332	0	941	108	830	0	0	0	3
전라북도	정읍시	초산동	소계	6356	4905	1451	8	4897	563	4319	1	1	12	1
전라북도	정읍시	초산동	초산동제1투	2054	1496	558	3	1493	129	1363	0	0	1	0
전라북도	정읍시	초산동	초산동제2투	2101	1634	467	1	1633	234	1387	1	1	9	1
전라북도	정읍시	초산동	초산동제3투	2201	1775	426	4	1771	200	1569	0	0	2	0
전라북도	정읍시	연지동	소계	4401	3267	1134	9	3258	371	2874	0	2	8	3
전라북도	정읍시	연지동	연지동제1투	2181	1610	571	4	1606	203	1398	0	2	2	1
전라북도	정읍시	연지동	연지동제2투	2220	1657	563	5	1652	168	1476	0	0	6	2
전라북도	정읍시	농소동	소계	3939	2953	986	19	2934	333	2591	0	1	5	4
전라북도	정읍시	농소동	농소동제1투	1757	1300	457	8	1292	149	1140	0	0	3	0
전라북도	정읍시	농소동	농소동제2투	2182	1653	529	11	1642	184	1451	0	1	2	4
전라북도	정읍시	상교동	소계	3565	2603	962	16	2587	318	2248	2	0	11	8
전라북도	정읍시	상교동	상교동제1투	1966	1412	554	9	1403	160	1228	1	0	9	5
전라북도	정읍시	상교동	상교동제2투	1599	1191	408	7	1184	158	1020	1	0	2	3
전라북도	남원시	계	계	70067	54221	15846	503	53718	6583	46681	57	54	205	138
전라북도	남원시	재외투표	재외투표	188	148	40	1	147	33	114	0	0	0	0
전라북도	남원시	국내부재자투표	국내부재자투표	2790	2437	353	38	2399	377	1998	7	5	3	9
전라북도	남원시	운봉읍	소계	3499	2634	865	26	2608	297	2290	3	1	10	7
전라북도	남원시	운봉읍	운봉읍제1투	1647	1234	413	17	1217	125	1081	1	1	4	5
전라북도	남원시	운봉읍	운봉읍제2투	1852	1400	452	9	1391	172	1209	2	0	6	2
전라북도	남원시	주천면	소계	2105	1611	494	21	1590	214	1358	1	2	6	9
전라북도	남원시	주천면	주천면제1투	1845	1412	433	18	1394	181	1200	1	2	4	6
전라북도	남원시	주천면	주천면제2투	260	199	61	3	196	33	158	0	0	2	3
전라북도	남원시	수지면	소계	1129	858	271	10	848	126	715	0	1	3	3
전라북도	남원시	수지면	수지면투표소	1129	858	271	10	848	126	715	0	1	3	3
전라북도	남원시	송동면	소계	2001	1537	464	13	1524	161	1330	0	6	15	12
전라북도	남원시	송동면	송동면투표소	2001	1537	464	13	1524	161	1330	0	6	15	12
전라북도	남원시	주생면	소계	1739	1356	383	21	1335	168	1149	1	2	11	4
전라북도	남원시	주생면	주생면투표소	1739	1356	383	21	1335	168	1149	1	2	11	4
전라북도	남원시	금지면	소계	2302	1794	508	21	1773	214	1536	0	3	13	7
전라북도	남원시	금지면	금지면투표소	2302	1794	508	21	1773	214	1536	0	3	13	7
전라북도	남원시	대강면	소계	1723	1287	436	10	1277	169	1078	2	2	12	14
전라북도	남원시	대강면	대강면투표소	1723	1287	436	10	1277	169	1078	2	2	12	14
전라북도	남원시	대산면	소계	1551	1123	428	22	1101	168	916	1	3	8	5
전라북도	남원시	대산면	대산면투표소	1551	1123	428	22	1101	168	916	1	3	8	5
전라북도	남원시	사매면	소계	1526	1180	346	15	1165	129	1020	3	1	8	4
전라북도	남원시	사매면	사매면투표소	1526	1180	346	15	1165	129	1020	3	1	8	4
전라북도	남원시	덕과면	소계	917	729	188	7	722	99	614	0	0	5	4
전라북도	남원시	덕과면	덕과면투표소	917	729	188	7	722	99	614	0	0	5	4
전라북도	남원시	보절면	소계	1485	1122	363	16	1106	136	946	2	2	15	5
전라북도	남원시	보절면	보절면투표소	1485	1122	363	16	1106	136	946	2	2	15	5
전라북도	남원시	산동면	소계	1671	1299	372	11	1288	135	1133	0	1	11	8
전라북도	남원시	산동면	산동면투표소	1671	1299	372	11	1288	135	1133	0	1	11	8
전라북도	남원시	이백면	소계	2063	1615	448	24	1591	148	1422	1	2	13	5
전라북도	남원시	이백면	이백면투표소	2063	1615	448	24	1591	148	1422	1	2	13	5
전라북도	남원시	인월면	소계	2446	1805	641	11	1794	245	1532	0	3	7	7
전라북도	남원시	인월면	인월면투표소	2446	1805	641	11	1794	245	1532	0	3	7	7
전라북도	남원시	아영면	소계	1762	1321	441	16	1305	155	1130	3	2	11	4
전라북도	남원시	아영면	아영면투표소	1762	1321	441	16	1305	155	1130	3	2	11	4
전라북도	남원시	산내면	소계	1736	1299	437	9	1290	162	1112	1	7	5	3
전라북도	남원시	산내면	산내면투표소	1736	1299	437	9	1290	162	1112	1	7	5	3
전라북도	남원시	동충동	소계	3049	2364	685	20	2344	364	1971	0	0	8	1
전라북도	남원시	동충동	동충동투표소	3049	2364	685	20	2344	364	1971	0	0	8	1
전라북도	남원시	죽항동	소계	3495	2592	903	14	2578	339	2235	0	0	4	0
전라북도	남원시	죽항동	죽항동투표소	3495	2592	903	14	2578	339	2235	0	0	4	0
전라북도	남원시	노암동	소계	3973	3046	927	29	3017	377	2627	1	1	8	3
전라북도	남원시	노암동	노암동제1투	1426	1080	346	12	1068	123	939	0	0	4	2
전라북도	남원시	노암동	노암동제2투	2547	1966	581	17	1949	254	1688	1	1	4	1
전라북도	남원시	금동	소계	5254	4103	1151	32	4071	451	3605	2	1	8	4
전라북도	남원시	금동	금동제1투	2234	1705	529	17	1688	189	1495	1	1	0	2
전라북도	남원시	금동	금동제2투	3020	2398	622	15	2383	262	2110	1	0	8	2
전라북도	남원시	왕정동	소계	3683	2910	773	29	2881	355	2515	0	2	4	5
전라북도	남원시	왕정동	왕정동제1투	2046	1608	438	17	1591	174	1407	0	2	3	5
전라북도	남원시	왕정동	왕정동제2투	1637	1302	335	12	1290	181	1108	0	0	1	0
전라북도	남원시	향교동	소계	6606	4905	1701	38	4867	673	4161	13	3	9	8
전라북도	남원시	향교동	향교동제1투	3655	2767	888	21	2746	352	2382	5	1	5	1
전라북도	남원시	향교동	향교동제2투	1747	1261	486	10	1251	169	1072	4	2	2	2
전라북도	남원시	향교동	향교동제3투	1204	877	327	7	870	152	707	4	0	2	5
전라북도	남원시	도통동	소계	11374	9146	2228	49	9097	888	8174	16	4	8	7
전라북도	남원시	도통동	도통동제1투	3037	2591	446	10	2581	246	2325	5	1	3	1
전라북도	남원시	도통동	도통동제2투	2474	1919	555	9	1910	210	1691	6	0	2	1
전라북도	남원시	도통동	도통동제3투	3027	2403	624	20	2383	234	2143	1	0	1	4
전라북도	남원시	도통동	도통동제4투	2836	2233	603	10	2223	198	2015	4	3	2	1
전라북도	김제시	계	계	77521	58323	19198	384	57939	8185	49430	32	25	161	106
전라북도	김제시	재외투표	재외투표	247	164	83	0	164	38	125	0	0	1	0
전라북도	김제시	국내부재자투표	국내부재자투표	2410	2138	272	56	2082	386	1681	1	2	5	7
전라북도	김제시	만경읍	소계	2906	2174	732	15	2159	391	1754	2	1	4	7
전라북도	김제시	만경읍	만경읍제1투	1293	960	333	5	955	173	777	0	0	1	4
전라북도	김제시	만경읍	만경읍제2투	1613	1214	399	10	1204	218	977	2	1	3	3
전라북도	김제시	죽산면	소계	2833	2043	790	19	2024	295	1719	0	1	7	2
전라북도	김제시	죽산면	죽산면투표소	2833	2043	790	19	2024	295	1719	0	1	7	2
전라북도	김제시	백산면	소계	2592	1953	639	12	1941	222	1711	0	0	4	4
전라북도	김제시	백산면	백산면제1투	1441	1070	371	6	1064	122	937	0	0	2	3
전라북도	김제시	백산면	백산면제2투	1151	883	268	6	877	100	774	0	0	2	1
전라북도	김제시	용지면	소계	3904	2903	1001	24	2879	414	2448	3	1	6	7
전라북도	김제시	용지면	용지면제1투	1993	1457	536	8	1449	223	1217	0	1	2	6
전라북도	김제시	용지면	용지면제2투	1911	1446	465	16	1430	191	1231	3	0	4	1
전라북도	김제시	백구면	소계	3983	2971	1012	17	2954	405	2532	3	1	8	5
전라북도	김제시	백구면	백구면제1투	2030	1524	506	11	1513	221	1283	2	1	3	3
전라북도	김제시	백구면	백구면제2투	1953	1447	506	6	1441	184	1249	1	0	5	2
전라북도	김제시	부량면	소계	1452	1106	346	7	1099	179	908	1	1	7	3
전라북도	김제시	부량면	부량면투표소	1452	1106	346	7	1099	179	908	1	1	7	3
전라북도	김제시	공덕면	소계	2591	2012	579	12	2000	273	1711	1	0	8	7
전라북도	김제시	공덕면	공덕면투표소	2591	2012	579	12	2000	273	1711	1	0	8	7
전라북도	김제시	청하면	소계	1916	1434	482	17	1417	171	1238	1	0	4	3
전라북도	김제시	청하면	청하면투표소	1916	1434	482	17	1417	171	1238	1	0	4	3
전라북도	김제시	성덕면	소계	1931	1418	513	8	1410	197	1202	1	1	6	3
전라북도	김제시	성덕면	성덕면투표소	1931	1418	513	8	1410	197	1202	1	1	6	3
전라북도	김제시	진봉면	소계	2933	2289	644	17	2272	258	1996	0	0	13	5
전라북도	김제시	진봉면	진봉면제1투	2045	1602	443	13	1589	182	1396	0	0	7	4
전라북도	김제시	진봉면	진봉면제2투	888	687	201	4	683	76	600	0	0	6	1
전라북도	김제시	금구면	소계	4341	3343	998	29	3314	434	2857	2	2	11	8
전라북도	김제시	금구면	금구면제1투	2331	1814	517	16	1798	235	1551	2	2	4	4
전라북도	김제시	금구면	금구면제2투	745	570	175	3	567	79	484	0	0	3	1
전라북도	김제시	금구면	금구면제3투	1265	959	306	10	949	120	822	0	0	4	3
전라북도	김제시	봉남면	소계	2479	1838	641	9	1829	265	1552	2	1	6	3
전라북도	김제시	봉남면	봉남면투표소	2479	1838	641	9	1829	265	1552	2	1	6	3
전라북도	김제시	황산면	소계	2022	1545	477	13	1532	192	1330	4	0	2	4
전라북도	김제시	황산면	황산면투표소	2022	1545	477	13	1532	192	1330	4	0	2	4
전라북도	김제시	금산면	소계	4624	3437	1187	22	3415	461	2931	1	0	16	6
전라북도	김제시	금산면	금산면제1투	2347	1672	675	14	1658	235	1410	0	0	10	3
전라북도	김제시	금산면	금산면제2투	2277	1765	512	8	1757	226	1521	1	0	6	3
전라북도	김제시	광활면	소계	1435	1059	376	3	1056	138	910	1	0	0	7
전라북도	김제시	광활면	광활면투표소	1435	1059	376	3	1056	138	910	1	0	0	7
전라북도	김제시	요촌동	소계	8503	6346	2157	27	6319	957	5336	2	4	12	8
전라북도	김제시	요촌동	요촌동제1투	2875	2040	835	6	2034	304	1724	0	1	4	1
전라북도	김제시	요촌동	요촌동제2투	2012	1522	490	4	1518	262	1252	0	0	2	2
전라북도	김제시	요촌동	요촌동제3투	2665	2082	583	6	2076	286	1781	1	1	4	3
전라북도	김제시	요촌동	요촌동제4투	951	702	249	11	691	105	579	1	2	2	2
전라북도	김제시	신풍동	소계	10862	8182	2680	35	8147	1144	6976	0	3	17	7
전라북도	김제시	신풍동	신풍동제1투	1843	1341	502	4	1337	226	1108	0	0	1	2
전라북도	김제시	신풍동	신풍동제2투	2378	1783	595	4	1779	288	1484	0	0	7	0
전라북도	김제시	신풍동	신풍동제3투	2816	2115	701	9	2106	294	1809	0	0	2	1
전라북도	김제시	신풍동	신풍동제4투	2013	1577	436	6	1571	171	1396	0	1	3	0
전라북도	김제시	신풍동	신풍동제5투	909	687	222	8	679	90	586	0	1	2	0
전라북도	김제시	신풍동	신풍동제6투	903	679	224	4	675	75	593	0	1	2	4
전라북도	김제시	검산동	소계	7512	5606	1906	24	5582	712	4846	6	3	9	6
전라북도	김제시	검산동	검산동제1투	3203	2351	852	5	2346	300	2034	3	2	4	3
전라북도	김제시	검산동	검산동제2투	2026	1536	490	16	1520	220	1291	3	0	3	3
전라북도	김제시	검산동	검산동제3투	2283	1719	564	3	1716	192	1521	0	1	2	0
전라북도	김제시	교월동	소계	6045	4362	1683	18	4344	653	3667	1	4	15	4
전라북도	김제시	교월동	교월동제1투	2129	1474	655	3	1471	223	1243	0	1	4	0
전라북도	김제시	교월동	교월동제2투	1864	1388	476	7	1381	189	1181	0	3	6	2
전라북도	김제시	교월동	교월동제3투	2052	1500	552	8	1492	241	1243	1	0	5	2
전라북도	완주군	계	계	68634	53018	15616	294	52724	6926	45422	15	68	175	118
전라북도	완주군	재외투표	재외투표	222	158	64	0	158	26	132	0	0	0	0
전라북도	완주군	국내부재자투표	국내부재자투표	1592	1478	114	45	1433	265	1148	3	3	6	8
전라북도	완주군	삼례읍	소계	12182	9074	3108	33	9041	1221	7775	2	8	24	11
전라북도	완주군	삼례읍	삼례읍제1투	3373	2456	917	9	2447	357	2082	0	1	6	1
전라북도	완주군	삼례읍	삼례읍제2투	3140	2293	847	4	2289	325	1959	1	1	2	1
전라북도	완주군	삼례읍	삼례읍제3투	3377	2588	789	9	2579	310	2250	1	3	9	6
전라북도	완주군	삼례읍	삼례읍제4투	2292	1737	555	11	1726	229	1484	0	3	7	3
전라북도	완주군	봉동읍	소계	17790	14021	3769	37	13984	1636	12263	4	29	32	20
전라북도	완주군	봉동읍	봉동읍제1투	3746	2858	888	9	2849	373	2461	2	3	6	4
전라북도	완주군	봉동읍	봉동읍제2투	3855	2991	864	11	2980	307	2655	0	5	11	2
전라북도	완주군	봉동읍	봉동읍제3투	1355	1050	305	4	1046	97	939	1	1	6	2
전라북도	완주군	봉동읍	봉동읍제4투	1987	1486	501	3	1483	187	1276	1	10	3	6
전라북도	완주군	봉동읍	봉동읍제5투	3516	2954	562	7	2947	361	2579	0	3	2	2
전라북도	완주군	봉동읍	봉동읍제6투	3331	2682	649	3	2679	311	2353	0	7	4	4
전라북도	완주군	용진면	소계	6133	4742	1391	20	4722	621	4068	2	2	20	9
전라북도	완주군	용진면	용진면제1투	1090	845	245	6	839	110	721	0	0	3	5
전라북도	완주군	용진면	용진면제2투	1301	1032	269	5	1027	131	889	1	0	4	2
전라북도	완주군	용진면	용진면제3투	1388	1065	323	4	1061	138	913	0	1	9	0
전라북도	완주군	용진면	용진면제4투	2354	1800	554	5	1795	242	1545	1	1	4	2
전라북도	완주군	상관면	소계	3767	2929	838	14	2915	417	2483	0	5	3	7
전라북도	완주군	상관면	상관면제1투	2951	2283	668	10	2273	328	1934	0	4	2	5
전라북도	완주군	상관면	상관면제2투	816	646	170	4	642	89	549	0	1	1	2
전라북도	완주군	이서면	소계	4820	3677	1143	14	3663	444	3196	0	3	13	7
전라북도	완주군	이서면	이서면제1투	2173	1631	542	3	1628	215	1400	0	1	8	4
전라북도	완주군	이서면	이서면제2투	2647	2046	601	11	2035	229	1796	0	2	5	3
전라북도	완주군	소양면	소계	5380	4073	1307	43	4030	506	3483	2	9	16	14
전라북도	완주군	소양면	소양면제1투	1596	1187	409	9	1178	138	1028	1	2	6	3
전라북도	완주군	소양면	소양면제2투	1308	1045	263	4	1041	111	919	0	1	7	3
전라북도	완주군	소양면	소양면제3투	1131	813	318	25	788	140	635	1	5	3	4
전라북도	완주군	소양면	소양면제4투	1345	1028	317	5	1023	117	901	0	1	0	4
전라북도	완주군	구이면	소계	4683	3635	1048	30	3605	451	3133	1	3	13	4
전라북도	완주군	구이면	구이면제1투	1770	1376	394	7	1369	200	1163	0	1	4	1
전라북도	완주군	구이면	구이면제2투	1577	1255	322	10	1245	133	1106	1	0	4	1
전라북도	완주군	구이면	구이면제3투	1336	1004	332	13	991	118	864	0	2	5	2
전라북도	완주군	고산면	소계	4021	3070	951	16	3054	347	2688	0	3	9	7
전라북도	완주군	고산면	고산면제1투	2763	2059	704	11	2048	246	1792	0	1	6	3
전라북도	완주군	고산면	고산면제2투	1258	1011	247	5	1006	101	896	0	2	3	4
전라북도	완주군	비봉면	소계	1764	1347	417	10	1337	150	1171	0	0	10	6
전라북도	완주군	비봉면	비봉면제1투	1260	976	284	7	969	113	845	0	0	7	4
전라북도	완주군	비봉면	비봉면제2투	504	371	133	3	368	37	326	0	0	3	2
전라북도	완주군	운주면	소계	1806	1360	446	10	1350	327	1001	0	3	7	12
전라북도	완주군	운주면	운주면투표소	1806	1360	446	10	1350	327	1001	0	3	7	12
전라북도	완주군	화산면	소계	2530	1936	594	16	1920	269	1634	0	0	11	6
전라북도	완주군	화산면	화산면투표소	2530	1936	594	16	1920	269	1634	0	0	11	6
전라북도	완주군	동상면	소계	1015	788	227	3	785	128	646	1	0	7	3
전라북도	완주군	동상면	동상면투표소	1015	788	227	3	785	128	646	1	0	7	3
전라북도	완주군	경천면	소계	929	730	199	3	727	118	601	0	0	4	4
전라북도	완주군	경천면	경천면투표소	929	730	199	3	727	118	601	0	0	4	4
전라북도	진안군	계	계	22860	17388	5472	151	17237	2764	14262	11	15	105	80
전라북도	진안군	재외투표	재외투표	72	51	21	0	51	20	31	0	0	0	0
전라북도	진안군	국내부재자투표	국내부재자투표	1004	879	125	23	856	150	695	2	2	4	3
전라북도	진안군	진안읍	소계	8301	6083	2218	35	6048	955	5040	2	5	32	14
전라북도	진안군	진안읍	진안읍제1투	2412	1745	667	8	1737	288	1432	1	2	10	4
전라북도	진안군	진안읍	진안읍제2투	2992	2270	722	14	2256	339	1898	0	0	14	5
전라북도	진안군	진안읍	진안읍제3투	2897	2068	829	13	2055	328	1710	1	3	8	5
전라북도	진안군	용담면	소계	772	594	178	7	587	130	449	1	1	3	3
전라북도	진안군	용담면	용담면투표소	772	594	178	7	587	130	449	1	1	3	3
전라북도	진안군	안천면	소계	932	738	194	5	733	150	567	0	0	10	6
전라북도	진안군	안천면	안천면투표소	932	738	194	5	733	150	567	0	0	10	6
전라북도	진안군	동향면	소계	1319	1014	305	14	1000	145	839	1	1	6	8
전라북도	진안군	동향면	동향면투표소	1319	1014	305	14	1000	145	839	1	1	6	8
전라북도	진안군	상전면	소계	760	555	205	5	550	118	423	1	0	2	6
전라북도	진안군	상전면	상전면투표소	760	555	205	5	550	118	423	1	0	2	6
전라북도	진안군	백운면	소계	1724	1316	408	12	1304	143	1152	1	0	7	1
전라북도	진안군	백운면	백운면투표소	1724	1316	408	12	1304	143	1152	1	0	7	1
전라북도	진안군	성수면	소계	1625	1214	411	15	1199	126	1050	1	3	10	9
전라북도	진안군	성수면	성수면투표소	1625	1214	411	15	1199	126	1050	1	3	10	9
전라북도	진안군	마령면	소계	1754	1339	415	15	1324	229	1079	1	1	7	7
전라북도	진안군	마령면	마령면투표소	1754	1339	415	15	1324	229	1079	1	1	7	7
전라북도	진안군	부귀면	소계	2278	1791	487	8	1783	260	1503	1	0	10	9
전라북도	진안군	부귀면	부귀면투표소	2278	1791	487	8	1783	260	1503	1	0	10	9
전라북도	진안군	정천면	소계	923	732	191	4	728	98	619	0	1	6	4
전라북도	진안군	정천면	정천면투표소	923	732	191	4	728	98	619	0	1	6	4
전라북도	진안군	주천면	소계	1396	1082	314	8	1074	240	815	0	1	8	10
전라북도	진안군	주천면	주천면투표소	1396	1082	314	8	1074	240	815	0	1	8	10
전라북도	무주군	계	계	21335	16095	5240	149	15946	3470	12290	13	10	90	73
전라북도	무주군	재외투표	재외투표	58	37	21	0	37	14	23	0	0	0	0
전라북도	무주군	국내부재자투표	국내부재자투표	752	672	80	11	661	156	499	2	1	1	2
전라북도	무주군	무주읍	소계	7113	5359	1754	51	5308	1229	4043	3	4	17	12
전라북도	무주군	무주읍	무주읍제1투	2824	2141	683	20	2121	507	1600	3	2	5	4
전라북도	무주군	무주읍	무주읍제2투	2419	1860	559	13	1847	402	1438	0	0	4	3
전라북도	무주군	무주읍	무주읍제3투	1870	1358	512	18	1340	320	1005	0	2	8	5
전라북도	무주군	무풍면	소계	2050	1505	545	12	1493	407	1066	4	1	8	7
전라북도	무주군	무풍면	무풍면제1투	1833	1346	487	12	1334	368	948	4	1	7	6
전라북도	무주군	무풍면	무풍면제2투	217	159	58	0	159	39	118	0	0	1	1
전라북도	무주군	설천면	소계	3634	2744	890	22	2722	631	2061	0	0	19	11
전라북도	무주군	설천면	설천면제1투	2408	1852	556	18	1834	447	1362	0	0	16	9
전라북도	무주군	설천면	설천면제2투	1226	892	334	4	888	184	699	0	0	3	2
전라북도	무주군	적상면	소계	2408	1799	609	21	1778	362	1385	1	0	16	14
전라북도	무주군	적상면	적상면제1투	1205	901	304	12	889	189	683	0	0	9	8
전라북도	무주군	적상면	적상면제2투	450	329	121	3	326	72	252	0	0	1	1
전라북도	무주군	적상면	적상면제3투	753	569	184	6	563	101	450	1	0	6	5
전라북도	무주군	안성면	소계	4005	2982	1023	24	2958	454	2469	2	4	19	10
전라북도	무주군	안성면	안성면제1투	2013	1502	511	10	1492	241	1239	0	2	6	4
전라북도	무주군	안성면	안성면제2투	1992	1480	512	14	1466	213	1230	2	2	13	6
전라북도	무주군	부남면	소계	1315	997	318	8	989	217	744	1	0	10	17
전라북도	무주군	부남면	부남면투표소	1315	997	318	8	989	217	744	1	0	10	17
전라북도	장수군	계	계	19525	15113	4412	139	14974	2236	12567	6	19	82	64
전라북도	장수군	재외투표	재외투표	78	47	31	0	47	15	32	0	0	0	0
전라북도	장수군	국내부재자투표	국내부재자투표	890	822	68	11	811	117	689	1	2	0	2
전라북도	장수군	장수읍	소계	5439	4116	1323	36	4080	657	3386	2	5	17	13
전라북도	장수군	장수읍	장수읍제1투	1780	1326	454	11	1315	228	1077	0	1	6	3
전라북도	장수군	장수읍	장수읍제2투	1384	1043	341	15	1028	160	853	1	3	5	6
전라북도	장수군	장수읍	장수읍제3투	2275	1747	528	10	1737	269	1456	1	1	6	4
전라북도	장수군	산서면	소계	2087	1613	474	12	1601	165	1411	1	4	12	8
전라북도	장수군	산서면	산서면투표소	2087	1613	474	12	1601	165	1411	1	4	12	8
전라북도	장수군	번암면	소계	2179	1659	520	20	1639	232	1386	1	2	9	9
전라북도	장수군	번암면	번암면제1투	1577	1206	371	14	1192	187	991	1	1	7	5
전라북도	장수군	번암면	번암면제2투	602	453	149	6	447	45	395	0	1	2	4
전라북도	장수군	장계면	소계	3660	2840	820	23	2817	456	2334	0	1	15	11
전라북도	장수군	장계면	장계면제1투	2108	1633	475	11	1622	264	1341	0	0	10	7
전라북도	장수군	장계면	장계면제2투	1552	1207	345	12	1195	192	993	0	1	5	4
전라북도	장수군	천천면	소계	1933	1453	480	14	1439	205	1213	0	2	9	10
전라북도	장수군	천천면	천천면투표소	1933	1453	480	14	1439	205	1213	0	2	9	10
전라북도	장수군	계남면	소계	1877	1473	404	13	1460	202	1243	0	2	6	7
전라북도	장수군	계남면	계남면투표소	1877	1473	404	13	1460	202	1243	0	2	6	7
전라북도	장수군	계북면	소계	1382	1090	292	10	1080	187	873	1	1	14	4
전라북도	장수군	계북면	계북면투표소	1382	1090	292	10	1080	187	873	1	1	14	4
전라북도	임실군	계	계	25881	19695	6186	176	19519	2386	16884	14	12	140	83
전라북도	임실군	재외투표	재외투표	76	49	27	1	48	19	29	0	0	0	0
전라북도	임실군	국내부재자투표	국내부재자투표	1078	995	83	21	974	170	792	4	0	3	5
전라북도	임실군	임실읍	소계	5153	3888	1265	30	3858	543	3279	3	2	16	15
전라북도	임실군	임실읍	임실읍제1투	1323	983	340	9	974	164	802	2	0	4	2
전라북도	임실군	임실읍	임실읍제2투	2211	1720	491	12	1708	191	1507	1	1	4	4
전라북도	임실군	임실읍	임실읍제3투	1619	1185	434	9	1176	188	970	0	1	8	9
전라북도	임실군	청웅면	소계	1341	1015	326	8	1007	147	847	0	0	8	5
전라북도	임실군	청웅면	청웅면투표소	1341	1015	326	8	1007	147	847	0	0	8	5
전라북도	임실군	운암면	소계	1586	1192	394	11	1181	138	1027	1	1	10	4
전라북도	임실군	운암면	운암면제1투	537	397	140	5	392	68	318	1	0	3	2
전라북도	임실군	운암면	운암면제2투	391	301	90	4	297	19	273	0	0	4	1
전라북도	임실군	운암면	운암면제3투	658	494	164	2	492	51	436	0	1	3	1
전라북도	임실군	신평면	소계	1512	1141	371	7	1134	149	968	1	0	13	3
전라북도	임실군	신평면	신평면투표소	1512	1141	371	7	1134	149	968	1	0	13	3
전라북도	임실군	성수면	소계	1599	1227	372	13	1214	126	1071	1	1	9	6
전라북도	임실군	성수면	성수면제1투	1123	853	270	7	846	93	742	1	0	6	4
전라북도	임실군	성수면	성수면제2투	476	374	102	6	368	33	329	0	1	3	2
전라북도	임실군	오수면	소계	3766	2868	898	17	2851	268	2559	1	2	11	10
전라북도	임실군	오수면	오수면제1투	1994	1501	493	4	1497	131	1351	1	2	7	5
전라북도	임실군	오수면	오수면제2투	1772	1367	405	13	1354	137	1208	0	0	4	5
전라북도	임실군	신덕면	소계	1231	958	273	12	946	87	834	0	1	18	6
전라북도	임실군	신덕면	신덕면투표소	1231	958	273	12	946	87	834	0	1	18	6
전라북도	임실군	삼계면	소계	1482	1095	387	13	1082	130	934	0	2	8	8
전라북도	임실군	삼계면	삼계면투표소	1482	1095	387	13	1082	130	934	0	2	8	8
전라북도	임실군	관촌면	소계	3191	2372	819	22	2350	259	2070	1	3	13	4
전라북도	임실군	관촌면	관촌면투표소	3191	2372	819	22	2350	259	2070	1	3	13	4
전라북도	임실군	강진면	소계	1535	1108	427	6	1102	162	915	1	0	17	7
전라북도	임실군	강진면	강진면투표소	1535	1108	427	6	1102	162	915	1	0	17	7
전라북도	임실군	덕치면	소계	1081	816	265	7	809	85	710	0	0	8	6
전라북도	임실군	덕치면	덕치면제1투	666	507	159	4	503	47	450	0	0	3	3
전라북도	임실군	덕치면	덕치면제2투	415	309	106	3	306	38	260	0	0	5	3
전라북도	임실군	지사면	소계	1250	971	279	8	963	103	849	1	0	6	4
전라북도	임실군	지사면	지사면투표소	1250	971	279	8	963	103	849	1	0	6	4
전라북도	순창군	계	계	25003	19314	5689	194	19120	2093	16797	10	27	124	69
전라북도	순창군	재외투표	재외투표	96	61	35	0	61	24	37	0	0	0	0
전라북도	순창군	국내부재자투표	국내부재자투표	1362	1239	123	48	1191	166	1010	3	4	3	5
전라북도	순창군	순창읍	소계	7232	5605	1627	26	5579	636	4915	0	4	15	9
전라북도	순창군	순창읍	순창읍제1투	2054	1594	460	6	1588	175	1401	0	2	6	4
전라북도	순창군	순창읍	순창읍제2투	2497	1932	565	11	1921	221	1693	0	1	2	4
전라북도	순창군	순창읍	순창읍제3투	2681	2079	602	9	2070	240	1821	0	1	7	1
전라북도	순창군	인계면	소계	1455	1120	335	9	1111	79	1017	0	1	7	7
전라북도	순창군	인계면	인계면투표소	1455	1120	335	9	1111	79	1017	0	1	7	7
전라북도	순창군	동계면	소계	1933	1432	501	15	1417	140	1246	1	9	16	5
전라북도	순창군	동계면	동계면제1투	1264	943	321	10	933	84	832	0	8	7	2
전라북도	순창군	동계면	동계면제2투	669	489	180	5	484	56	414	1	1	9	3
전라북도	순창군	적성면	소계	1187	911	276	11	900	120	770	0	0	7	3
전라북도	순창군	적성면	적성면투표소	1187	911	276	11	900	120	770	0	0	7	3
전라북도	순창군	유등면	소계	1088	823	265	9	814	88	715	2	1	4	4
전라북도	순창군	유등면	유등면투표소	1088	823	265	9	814	88	715	2	1	4	4
전라북도	순창군	풍산면	소계	1628	1273	355	13	1260	115	1119	2	2	14	8
전라북도	순창군	풍산면	풍산면제1투	857	665	192	6	659	51	594	1	2	8	3
전라북도	순창군	풍산면	풍산면제2투	771	608	163	7	601	64	525	1	0	6	5
전라북도	순창군	금과면	소계	1548	1169	379	7	1162	115	1035	1	1	4	6
전라북도	순창군	금과면	금과면투표소	1548	1169	379	7	1162	115	1035	1	1	4	6
전라북도	순창군	팔덕면	소계	1400	1086	314	11	1075	121	942	1	0	6	5
전라북도	순창군	팔덕면	팔덕면투표소	1400	1086	314	11	1075	121	942	1	0	6	5
전라북도	순창군	복흥면	소계	1998	1525	473	14	1511	167	1321	0	0	15	8
전라북도	순창군	복흥면	복흥면제1투	1379	1042	337	7	1035	110	909	0	0	9	7
전라북도	순창군	복흥면	복흥면제2투	619	483	136	7	476	57	412	0	0	6	1
전라북도	순창군	쌍치면	소계	1842	1381	461	14	1367	154	1198	0	3	11	1
전라북도	순창군	쌍치면	쌍치면제1투	1052	777	275	7	770	89	673	0	1	6	1
전라북도	순창군	쌍치면	쌍치면제2투	790	604	186	7	597	65	525	0	2	5	0
전라북도	순창군	구림면	소계	2234	1689	545	17	1672	168	1472	0	2	22	8
전라북도	순창군	구림면	구림면제1투	1574	1189	385	11	1178	112	1042	0	2	16	6
전라북도	순창군	구림면	구림면제2투	660	500	160	6	494	56	430	0	0	6	2
전라북도	고창군	계	계	50439	37846	12593	304	37542	4328	32729	23	31	309	122
전라북도	고창군	재외투표	재외투표	112	78	34	1	77	18	59	0	0	0	0
전라북도	고창군	국내부재자투표	국내부재자투표	2029	1836	193	20	1816	277	1530	0	2	3	4
전라북도	고창군	고창읍	소계	15210	11558	3652	41	11517	1325	10147	5	3	25	12
전라북도	고창군	고창읍	고창읍제1투	4086	3098	988	11	3087	338	2743	0	1	2	3
전라북도	고창군	고창읍	고창읍제2투	1484	1118	366	2	1116	131	977	0	0	5	3
전라북도	고창군	고창읍	고창읍제3투	1264	933	331	2	931	113	815	2	0	1	0
전라북도	고창군	고창읍	고창읍제4투	1641	1245	396	5	1240	148	1081	1	0	8	2
전라북도	고창군	고창읍	고창읍제5투	1452	1080	372	8	1072	136	931	0	2	3	0
전라북도	고창군	고창읍	고창읍제6투	2016	1567	449	8	1559	163	1388	2	0	4	2
전라북도	고창군	고창읍	고창읍제7투	3267	2517	750	5	2512	296	2212	0	0	2	2
전라북도	고창군	고수면	소계	2218	1655	563	17	1638	147	1462	1	4	13	11
전라북도	고창군	고수면	고수면제1투	965	699	266	5	694	57	619	0	3	8	7
전라북도	고창군	고수면	고수면제2투	1253	956	297	12	944	90	843	1	1	5	4
전라북도	고창군	아산면	소계	2614	1934	680	12	1922	226	1665	2	0	20	9
전라북도	고창군	아산면	아산면제1투	1764	1298	466	5	1293	132	1141	2	0	12	6
전라북도	고창군	아산면	아산면제2투	850	636	214	7	629	94	524	0	0	8	3
전라북도	고창군	무장면	소계	2838	2029	809	22	2007	236	1741	0	1	22	7
전라북도	고창군	무장면	무장면제1투	1277	922	355	9	913	128	769	0	1	11	4
전라북도	고창군	무장면	무장면제2투	1561	1107	454	13	1094	108	972	0	0	11	3
전라북도	고창군	공음면	소계	2534	1867	667	16	1851	181	1641	0	1	24	4
전라북도	고창군	공음면	공음면제1투	1456	1055	401	10	1045	83	943	0	0	16	3
전라북도	고창군	공음면	공음면제2투	1078	812	266	6	806	98	698	0	1	8	1
전라북도	고창군	상하면	소계	2380	1760	620	32	1728	172	1517	7	3	25	4
전라북도	고창군	상하면	상하면제1투	1041	790	251	19	771	80	677	3	1	9	1
전라북도	고창군	상하면	상하면제2투	1339	970	369	13	957	92	840	4	2	16	3
전라북도	고창군	해리면	소계	2834	2048	786	25	2023	248	1724	0	3	31	17
전라북도	고창군	해리면	해리면제1투	1733	1262	471	14	1248	155	1059	0	2	21	11
전라북도	고창군	해리면	해리면제2투	1101	786	315	11	775	93	665	0	1	10	6
전라북도	고창군	성송면	소계	1845	1353	492	10	1343	136	1172	1	0	21	13
전라북도	고창군	성송면	성송면제1투	1145	848	297	9	839	92	722	0	0	14	11
전라북도	고창군	성송면	성송면제2투	700	505	195	1	504	44	450	1	0	7	2
전라북도	고창군	대산면	소계	3537	2611	926	25	2586	260	2296	0	1	24	5
전라북도	고창군	대산면	대산면제1투	2218	1635	583	11	1624	171	1437	0	1	13	2
전라북도	고창군	대산면	대산면제2투	1319	976	343	14	962	89	859	0	0	11	3
전라북도	고창군	심원면	소계	2440	1750	690	19	1731	197	1501	3	3	20	7
전라북도	고창군	심원면	심원면제1투	1286	893	393	8	885	105	768	0	2	8	2
전라북도	고창군	심원면	심원면제2투	1154	857	297	11	846	92	733	3	1	12	5
전라북도	고창군	흥덕면	소계	3039	2280	759	22	2258	299	1933	0	1	17	8
전라북도	고창군	흥덕면	흥덕면제1투	1612	1230	382	11	1219	176	1025	0	1	11	6
전라북도	고창군	흥덕면	흥덕면제2투	1427	1050	377	11	1039	123	908	0	0	6	2
전라북도	고창군	성내면	소계	2011	1503	508	12	1491	206	1266	1	2	12	4
전라북도	고창군	성내면	성내면제1투	1152	865	287	7	858	125	722	1	1	6	3
전라북도	고창군	성내면	성내면제2투	859	638	221	5	633	81	544	0	1	6	1
전라북도	고창군	신림면	소계	2130	1614	516	16	1598	176	1387	2	1	23	9
전라북도	고창군	신림면	신림면제1투	1257	920	337	10	910	103	789	2	0	13	3
전라북도	고창군	신림면	신림면제2투	873	694	179	6	688	73	598	0	1	10	6
전라북도	고창군	부안면	소계	2668	1970	698	14	1956	224	1688	1	6	29	8
전라북도	고창군	부안면	부안면제1투	1572	1194	378	6	1188	122	1041	1	6	13	5
전라북도	고창군	부안면	부안면제2투	1096	776	320	8	768	102	647	0	0	16	3
전라북도	부안군	계	계	49768	36622	13146	292	36330	5986	30003	30	25	177	109
전라북도	부안군	재외투표	재외투표	122	84	38	0	84	20	64	0	0	0	0
전라북도	부안군	국내부재자투표	국내부재자투표	1960	1811	149	29	1782	311	1453	5	1	7	5
전라북도	부안군	부안읍	소계	15665	11564	4101	42	11522	1865	9614	5	3	19	16
전라북도	부안군	부안읍	부안읍제1투	1807	1238	569	4	1234	263	969	0	0	1	1
전라북도	부안군	부안읍	부안읍제2투	1522	1105	417	5	1100	212	887	0	0	1	0
전라북도	부안군	부안읍	부안읍제3투	2635	1963	672	5	1958	295	1656	0	1	3	3
전라북도	부안군	부안읍	부안읍제4투	2290	1702	588	5	1697	294	1396	1	1	3	2
전라북도	부안군	부안읍	부안읍제5투	2971	2189	782	8	2181	316	1853	2	0	8	2
전라북도	부안군	부안읍	부안읍제6투	3157	2429	728	6	2423	356	2064	0	1	1	1
전라북도	부안군	부안읍	부안읍제7투	1283	938	345	9	929	129	789	2	0	2	7
전라북도	부안군	주산면	소계	2104	1500	604	18	1482	235	1215	4	3	14	11
전라북도	부안군	주산면	주산면제1투	991	671	320	8	663	98	546	3	3	10	3
전라북도	부안군	주산면	주산면제2투	1113	829	284	10	819	137	669	1	0	4	8
전라북도	부안군	동진면	소계	3194	2325	869	28	2297	374	1890	1	3	20	9
전라북도	부안군	동진면	동진면제1투	1503	1103	400	9	1094	179	907	0	1	4	3
전라북도	부안군	동진면	동진면제2투	693	502	191	8	494	89	395	1	0	6	3
전라북도	부안군	동진면	동진면제3투	998	720	278	11	709	106	588	0	2	10	3
전라북도	부안군	행안면	소계	2146	1631	515	12	1619	317	1286	2	1	12	1
전라북도	부안군	행안면	행안면제1투	1109	850	259	4	846	164	676	0	1	5	0
전라북도	부안군	행안면	행안면제2투	1037	781	256	8	773	153	610	2	0	7	1
전라북도	부안군	계화면	소계	3901	2864	1037	16	2848	445	2383	1	0	12	7
전라북도	부안군	계화면	계화면제1투	1264	936	328	5	931	136	786	1	0	3	5
전라북도	부안군	계화면	계화면제2투	1015	767	248	3	764	110	650	0	0	3	1
전라북도	부안군	계화면	계화면제3투	988	697	291	4	693	124	568	0	0	1	0
전라북도	부안군	계화면	계화면제4투	634	464	170	4	460	75	379	0	0	5	1
전라북도	부안군	보안면	소계	2520	1884	636	22	1862	290	1544	1	3	11	13
전라북도	부안군	보안면	보안면제1투	738	533	205	10	523	101	417	0	0	3	2
전라북도	부안군	보안면	보안면제2투	782	597	185	3	594	77	503	1	2	5	6
전라북도	부안군	보안면	보안면제3투	1000	754	246	9	745	112	624	0	1	3	5
전라북도	부안군	변산면	소계	4196	2971	1225	26	2945	508	2399	3	2	21	12
전라북도	부안군	변산면	변산면제1투	1648	1161	487	10	1151	208	930	1	2	6	4
전라북도	부안군	변산면	변산면제2투	803	564	239	5	559	90	460	0	0	5	4
전라북도	부안군	변산면	변산면제3투	1745	1246	499	11	1235	210	1009	2	0	10	4
전라북도	부안군	진서면	소계	2260	1619	641	14	1605	307	1281	0	2	9	6
전라북도	부안군	진서면	진서면제1투	1429	990	439	9	981	192	784	0	1	2	2
전라북도	부안군	진서면	진서면제2투	446	339	107	4	335	55	277	0	1	1	1
전라북도	부안군	진서면	진서면제3투	385	290	95	1	289	60	220	0	0	6	3
전라북도	부안군	백산면	소계	2761	2033	728	20	2013	351	1638	3	3	12	6
전라북도	부안군	백산면	백산면제1투	1500	1076	424	8	1068	157	902	0	2	5	2
전라북도	부안군	백산면	백산면제2투	933	697	236	7	690	146	532	2	1	6	3
전라북도	부안군	백산면	백산면제3투	328	260	68	5	255	48	204	1	0	1	1
전라북도	부안군	상서면	소계	2243	1654	589	11	1643	261	1364	2	2	8	6
전라북도	부안군	상서면	상서면제1투	1451	1055	396	9	1046	183	850	2	2	6	3
전라북도	부안군	상서면	상서면제2투	792	599	193	2	597	78	514	0	0	2	3
전라북도	부안군	하서면	소계	2854	2074	780	21	2053	290	1741	0	2	12	8
전라북도	부안군	하서면	하서면제1투	1190	881	309	9	872	134	731	0	2	4	1
전라북도	부안군	하서면	하서면제2투	852	607	245	6	601	72	524	0	0	1	4
전라북도	부안군	하서면	하서면제3투	812	586	226	6	580	84	486	0	0	7	3
전라북도	부안군	줄포면	소계	2704	1949	755	29	1920	327	1576	2	0	9	6
전라북도	부안군	줄포면	줄포면제1투	1828	1307	521	15	1292	243	1043	0	0	4	2
전라북도	부안군	줄포면	줄포면제2투	387	288	99	9	279	28	244	2	0	4	1
전라북도	부안군	줄포면	줄포면제3투	489	354	135	5	349	56	289	0	0	1	3
전라북도	부안군	위도면	소계	1138	659	479	4	655	85	555	1	0	11	3
전라북도	부안군	위도면	위도면제1투	959	568	391	4	564	71	479	1	0	10	3
전라북도	부안군	위도면	위도면제2투	179	91	88	0	91	14	76	0	0	1	0
전라남도	목포시	계	계	186587	141368	45219	465	140903	11971	128448	22	75	242	145
전라남도	목포시	재외투표	재외투표	479	324	155	2	322	47	274	0	0	0	1
전라남도	목포시	국내부재자투표	국내부재자투표	6662	6098	564	104	5994	965	4962	5	16	20	26
전라남도	목포시	용당1동	소계	11034	7917	3117	23	7894	744	7116	1	3	21	9
전라남도	목포시	용당1동	용당1동제1투	2702	1936	766	1	1935	182	1747	0	1	3	2
전라남도	목포시	용당1동	용당1동제2투	2922	2038	884	4	2034	178	1847	1	0	5	3
전라남도	목포시	용당1동	용당1동제3투	2392	1814	578	5	1809	166	1636	0	1	3	3
전라남도	목포시	용당1동	용당1동제4투	3018	2129	889	13	2116	218	1886	0	1	10	1
전라남도	목포시	용당2동	소계	5764	4153	1611	8	4145	333	3799	0	3	2	8
전라남도	목포시	용당2동	용당2동제1투	3094	2159	935	3	2156	200	1949	0	1	2	4
전라남도	목포시	용당2동	용당2동제2투	2670	1994	676	5	1989	133	1850	0	2	0	4
전라남도	목포시	연동	소계	5234	3687	1547	11	3676	299	3365	1	1	6	4
전라남도	목포시	연동	연동제1투	2653	1810	843	9	1801	168	1626	1	0	4	2
전라남도	목포시	연동	연동제2투	2581	1877	704	2	1875	131	1739	0	1	2	2
전라남도	목포시	산정동	소계	6686	5115	1571	16	5099	438	4647	0	6	5	3
전라남도	목포시	산정동	산정동제1투	3108	2308	800	7	2301	226	2069	0	2	3	1
전라남도	목포시	산정동	산정동제2투	3578	2807	771	9	2798	212	2578	0	4	2	2
전라남도	목포시	연산동	소계	4390	3474	916	6	3468	242	3218	0	1	6	1
전라남도	목포시	연산동	연산동제1투	2081	1617	464	1	1616	112	1499	0	1	3	1
전라남도	목포시	연산동	연산동제2투	2309	1857	452	5	1852	130	1719	0	0	3	0
전라남도	목포시	원산동	소계	11841	9152	2689	32	9120	613	8482	0	3	15	7
전라남도	목포시	원산동	원산동제1투	2384	1757	627	7	1750	142	1606	0	1	1	0
전라남도	목포시	원산동	원산동제2투	3349	2750	599	11	2739	131	2599	0	1	3	5
전라남도	목포시	원산동	원산동제3투	3363	2480	883	9	2471	195	2269	0	1	6	0
전라남도	목포시	원산동	원산동제4투	2745	2165	580	5	2160	145	2008	0	0	5	2
전라남도	목포시	대성동	소계	2848	1957	891	5	1952	168	1775	0	0	6	3
전라남도	목포시	대성동	대성동투표소	2848	1957	891	5	1952	168	1775	0	0	6	3
전라남도	목포시	목원동	소계	9131	6343	2788	25	6318	603	5689	2	3	12	9
전라남도	목포시	목원동	목원동제1투	2904	2042	862	8	2034	192	1827	1	1	5	8
전라남도	목포시	목원동	목원동제2투	2867	1930	937	7	1923	169	1747	1	1	4	1
전라남도	목포시	목원동	목원동제3투	3360	2371	989	10	2361	242	2115	0	1	3	0
전라남도	목포시	동명동	소계	6368	4586	1782	29	4557	374	4169	1	0	9	4
전라남도	목포시	동명동	동명동제1투	3257	2268	989	18	2250	176	2065	0	0	6	3
전라남도	목포시	동명동	동명동제2투	3111	2318	793	11	2307	198	2104	1	0	3	1
전라남도	목포시	삼학동	소계	5500	4303	1197	9	4294	286	3999	0	2	6	1
전라남도	목포시	삼학동	삼학동제1투	2899	2214	685	4	2210	156	2050	0	1	2	1
전라남도	목포시	삼학동	삼학동제2투	2601	2089	512	5	2084	130	1949	0	1	4	0
전라남도	목포시	만호동	소계	3786	2479	1307	9	2470	223	2237	1	1	8	0
전라남도	목포시	만호동	만호동투표소	3786	2479	1307	9	2470	223	2237	1	1	8	0
전라남도	목포시	유달동	소계	5800	3732	2068	21	3711	341	3341	1	3	12	13
전라남도	목포시	유달동	유달동제1투	2636	1713	923	5	1708	187	1513	0	1	3	4
전라남도	목포시	유달동	유달동제2투	2422	1549	873	13	1536	109	1414	1	1	7	4
전라남도	목포시	유달동	유달동제3투	203	126	77	1	125	5	118	0	0	1	1
전라남도	목포시	유달동	유달동제4투	329	198	131	2	196	34	157	0	1	1	3
전라남도	목포시	유달동	유달동제5투	210	146	64	0	146	6	139	0	0	0	1
전라남도	목포시	죽교동	소계	3701	2520	1181	11	2509	238	2258	0	1	7	5
전라남도	목포시	죽교동	죽교동제1투	1810	1200	610	5	1195	107	1081	0	1	3	3
전라남도	목포시	죽교동	죽교동제2투	1891	1320	571	6	1314	131	1177	0	0	4	2
전라남도	목포시	북항동	소계	7552	5664	1888	13	5651	415	5219	1	2	11	3
전라남도	목포시	북항동	북항동제1투	3514	2728	786	3	2725	186	2532	0	2	2	3
전라남도	목포시	북항동	북항동제2투	2074	1498	576	6	1492	116	1371	0	0	5	0
전라남도	목포시	북항동	북항동제3투	1964	1438	526	4	1434	113	1316	1	0	4	0
전라남도	목포시	용해동	소계	10772	8261	2511	21	8240	594	7618	0	3	15	10
전라남도	목포시	용해동	용해동제1투	1257	882	375	2	880	85	793	0	1	0	1
전라남도	목포시	용해동	용해동제2투	2139	1602	537	7	1595	136	1455	0	0	3	1
전라남도	목포시	용해동	용해동제3투	3233	2550	683	3	2547	155	2382	0	1	6	3
전라남도	목포시	용해동	용해동제4투	4143	3227	916	9	3218	218	2988	0	1	6	5
전라남도	목포시	이로동	소계	8559	6802	1757	14	6788	573	6196	2	4	11	2
전라남도	목포시	이로동	이로동제1투	2422	1862	560	2	1860	196	1656	0	1	5	2
전라남도	목포시	이로동	이로동제2투	2551	1934	617	7	1927	142	1779	1	2	3	0
전라남도	목포시	이로동	이로동제3투	3586	3006	580	5	3001	235	2761	1	1	3	0
전라남도	목포시	상동	소계	14290	11052	3238	33	11019	896	10085	4	8	17	9
전라남도	목포시	상동	상동제1투	2192	1525	667	10	1515	144	1368	0	0	3	0
전라남도	목포시	상동	상동제2투	2176	1643	533	3	1640	117	1516	0	1	2	4
전라남도	목포시	상동	상동제3투	2362	1670	692	10	1660	154	1491	2	3	8	2
전라남도	목포시	상동	상동제4투	5035	4172	863	6	4166	315	3844	1	3	2	1
전라남도	목포시	상동	상동제5투	2525	2042	483	4	2038	166	1866	1	1	2	2
전라남도	목포시	하당동	소계	9318	6626	2692	7	6619	513	6091	1	1	8	5
전라남도	목포시	하당동	하당동제1투	2721	1798	923	2	1796	127	1667	0	0	2	0
전라남도	목포시	하당동	하당동제2투	3992	2629	1363	3	2626	230	2390	0	1	3	2
전라남도	목포시	하당동	하당동제3투	2605	2199	406	2	2197	156	2034	1	0	3	3
전라남도	목포시	신흥동	소계	12903	10353	2550	17	10336	872	9437	0	7	15	5
전라남도	목포시	신흥동	신흥동제1투	2961	2328	633	6	2322	182	2137	0	0	3	0
전라남도	목포시	신흥동	신흥동제2투	2703	2159	544	3	2156	158	1989	0	3	4	2
전라남도	목포시	신흥동	신흥동제3투	3420	2843	577	3	2840	237	2594	0	3	5	1
전라남도	목포시	신흥동	신흥동제4투	3819	3023	796	5	3018	295	2717	0	1	3	2
전라남도	목포시	삼향동	소계	4879	3669	1210	10	3659	304	3340	0	2	8	5
전라남도	목포시	삼향동	삼향동제1투	1991	1489	502	3	1486	102	1379	0	0	3	2
전라남도	목포시	삼향동	삼향동제2투	2888	2180	708	7	2173	202	1961	0	2	5	3
전라남도	목포시	옥암동	소계	7783	6319	1464	8	6311	438	5857	1	3	8	4
전라남도	목포시	옥암동	옥암동제1투	3737	3070	667	3	3067	198	2862	0	0	4	3
전라남도	목포시	옥암동	옥암동제2투	4046	3249	797	5	3244	240	2995	1	3	4	1
전라남도	목포시	부흥동	소계	9589	7318	2271	17	7301	599	6696	0	0	3	3
전라남도	목포시	부흥동	부흥동제1투	3681	2667	1014	8	2659	219	2435	0	0	3	2
전라남도	목포시	부흥동	부흥동제2투	2843	2117	726	7	2110	175	1935	0	0	0	0
전라남도	목포시	부흥동	부흥동제3투	3065	2534	531	2	2532	205	2326	0	0	0	1
전라남도	목포시	부주동	소계	11718	9464	2254	14	9450	853	8578	1	2	11	5
전라남도	목포시	부주동	부주동제1투	4717	3686	1031	3	3683	313	3362	1	2	3	2
전라남도	목포시	부주동	부주동제2투	2947	2517	430	2	2515	238	2276	0	0	1	0
전라남도	목포시	부주동	부주동제3투	4054	3261	793	9	3252	302	2940	0	0	7	3
전라남도	여수시	계	계	230407	177249	53158	1302	175947	15662	159415	119	109	392	250
전라남도	여수시	재외투표	재외투표	639	433	206	4	429	101	326	0	1	1	0
전라남도	여수시	국내부재자투표	국내부재자투표	8205	7399	806	118	7281	1077	6138	12	17	16	21
전라남도	여수시	돌산읍	소계	12123	8824	3299	59	8765	743	7972	6	4	27	13
전라남도	여수시	돌산읍	돌산읍제1투	1765	1256	509	6	1250	114	1127	1	1	4	3
전라남도	여수시	돌산읍	돌산읍제2투	1229	888	341	8	880	54	822	0	0	2	2
전라남도	여수시	돌산읍	돌산읍제3투	2082	1543	539	15	1528	123	1389	2	2	9	3
전라남도	여수시	돌산읍	돌산읍제4투	1593	1174	419	8	1166	88	1073	2	0	3	0
전라남도	여수시	돌산읍	돌산읍제5투	1538	1142	396	6	1136	87	1040	1	0	5	3
전라남도	여수시	돌산읍	돌산읍제6투	3916	2821	1095	16	2805	277	2521	0	1	4	2
전라남도	여수시	소라면	소계	9916	7539	2377	98	7441	618	6729	26	26	27	15
전라남도	여수시	소라면	소라면제1투	2385	1823	562	22	1801	146	1634	9	6	3	3
전라남도	여수시	소라면	소라면제2투	1179	861	318	14	847	89	747	2	7	0	2
전라남도	여수시	소라면	소라면제3투	1603	1213	390	21	1192	86	1083	8	7	4	4
전라남도	여수시	소라면	소라면제4투	1457	1122	335	23	1099	103	966	6	2	16	6
전라남도	여수시	소라면	소라면제5투	3292	2520	772	18	2502	194	2299	1	4	4	0
전라남도	여수시	율촌면	소계	6391	4797	1594	104	4693	398	4205	2	6	48	34
전라남도	여수시	율촌면	율촌면제1투	3753	2793	960	55	2738	243	2457	1	3	22	12
전라남도	여수시	율촌면	율촌면제2투	1217	927	290	15	912	68	827	1	0	10	6
전라남도	여수시	율촌면	율촌면제3투	1135	846	289	28	818	52	735	0	2	15	14
전라남도	여수시	율촌면	율촌면제4투	286	231	55	6	225	35	186	0	1	1	2
전라남도	여수시	화양면	소계	6595	4808	1787	115	4693	456	4163	13	18	24	19
전라남도	여수시	화양면	화양면제1투	1887	1371	516	42	1329	154	1158	4	3	4	6
전라남도	여수시	화양면	화양면제2투	1441	1084	357	20	1064	91	963	2	5	3	0
전라남도	여수시	화양면	화양면제3투	1614	1191	423	25	1166	104	1032	5	3	14	8
전라남도	여수시	화양면	화양면제4투	1653	1162	491	28	1134	107	1010	2	7	3	5
전라남도	여수시	남면	소계	3010	2083	927	26	2057	230	1777	2	4	28	16
전라남도	여수시	남면	남면제1투	1380	925	455	16	909	125	767	1	1	10	5
전라남도	여수시	남면	남면제2투	212	154	58	1	153	4	148	0	0	1	0
전라남도	여수시	남면	남면제3투	379	281	98	2	279	18	254	0	1	2	4
전라남도	여수시	남면	남면제4투	139	102	37	1	101	6	92	0	0	1	2
전라남도	여수시	남면	남면제5투	409	280	129	3	277	37	230	1	0	7	2
전라남도	여수시	남면	남면제6투	491	341	150	3	338	40	286	0	2	7	3
전라남도	여수시	화정면	소계	2313	1693	620	46	1647	133	1479	6	2	19	8
전라남도	여수시	화정면	화정면제1투	209	143	66	4	139	6	129	0	0	2	2
전라남도	여수시	화정면	화정면제2투	728	538	190	14	524	65	450	2	0	6	1
전라남도	여수시	화정면	화정면제3투	325	262	63	12	250	18	223	3	1	5	0
전라남도	여수시	화정면	화정면제4투	63	48	15	0	48	3	44	0	0	1	0
전라남도	여수시	화정면	화정면제5투	294	222	72	10	212	13	195	0	0	1	3
전라남도	여수시	화정면	화정면제6투	44	30	14	0	30	1	29	0	0	0	0
전라남도	여수시	화정면	화정면제7투	117	70	47	3	67	13	52	0	0	1	1
전라남도	여수시	화정면	화정면제8투	280	198	82	2	196	7	189	0	0	0	0
전라남도	여수시	화정면	화정면제9투	108	86	22	0	86	4	80	0	1	0	1
전라남도	여수시	화정면	화정면제10투	44	25	19	0	25	0	25	0	0	0	0
전라남도	여수시	화정면	화정면제11투	51	32	19	0	32	1	28	1	0	2	0
전라남도	여수시	화정면	화정면제12투	50	39	11	1	38	2	35	0	0	1	0
전라남도	여수시	삼산면	소계	2156	1321	835	8	1313	182	1124	1	0	3	3
전라남도	여수시	삼산면	삼산면제1투	589	342	247	3	339	48	290	0	0	1	0
전라남도	여수시	삼산면	삼산면제2투	311	198	113	1	197	33	164	0	0	0	0
전라남도	여수시	삼산면	삼산면제3투	366	239	127	1	238	34	202	1	0	0	1
전라남도	여수시	삼산면	삼산면제4투	262	176	86	0	176	26	149	0	0	1	0
전라남도	여수시	삼산면	삼산면제5투	400	227	173	0	227	24	202	0	0	1	0
전라남도	여수시	삼산면	삼산면제6투	228	139	89	3	136	17	117	0	0	0	2
전라남도	여수시	동문동	소계	4765	3391	1374	29	3362	392	2953	0	0	10	7
전라남도	여수시	동문동	동문동제1투	1973	1366	607	7	1359	161	1189	0	0	5	4
전라남도	여수시	동문동	동문동제2투	1662	1185	477	13	1172	144	1023	0	0	4	1
전라남도	여수시	동문동	동문동제3투	1130	840	290	9	831	87	741	0	0	1	2
전라남도	여수시	한려동	소계	3501	2553	948	20	2533	274	2253	1	0	3	2
전라남도	여수시	한려동	한려동제1투	1223	854	369	6	848	73	772	0	0	1	2
전라남도	여수시	한려동	한려동제2투	2278	1699	579	14	1685	201	1481	1	0	2	0
전라남도	여수시	중앙동	소계	5022	3817	1205	20	3797	373	3413	2	1	5	3
전라남도	여수시	중앙동	중앙동제1투	2393	1864	529	11	1853	177	1670	1	0	4	1
전라남도	여수시	중앙동	중앙동제2투	2629	1953	676	9	1944	196	1743	1	1	1	2
전라남도	여수시	충무동	소계	4586	3289	1297	22	3267	275	2977	2	1	7	5
전라남도	여수시	충무동	충무동제1투	2297	1714	583	5	1709	162	1540	1	0	2	4
전라남도	여수시	충무동	충무동제2투	2289	1575	714	17	1558	113	1437	1	1	5	1
전라남도	여수시	광림동	소계	6809	4962	1847	32	4930	395	4515	2	2	12	4
전라남도	여수시	광림동	광림동제1투	2585	1790	795	19	1771	143	1622	1	1	4	0
전라남도	여수시	광림동	광림동제2투	1699	1360	339	4	1356	89	1260	1	1	3	2
전라남도	여수시	광림동	광림동제3투	2525	1812	713	9	1803	163	1633	0	0	5	2
전라남도	여수시	서강동	소계	3996	2994	1002	21	2973	290	2672	1	1	7	2
전라남도	여수시	서강동	서강동제1투	1885	1388	497	11	1377	147	1226	1	1	1	1
전라남도	여수시	서강동	서강동제2투	2111	1606	505	10	1596	143	1446	0	0	6	1
전라남도	여수시	대교동	소계	6412	4502	1910	20	4482	378	4090	0	2	8	4
전라남도	여수시	대교동	대교동제1투	2489	1702	787	6	1696	154	1537	0	0	3	2
전라남도	여수시	대교동	대교동제2투	2218	1559	659	8	1551	144	1406	0	0	0	1
전라남도	여수시	대교동	대교동제3투	1705	1241	464	6	1235	80	1147	0	2	5	1
전라남도	여수시	국동	소계	10179	7496	2683	25	7471	592	6855	2	2	16	4
전라남도	여수시	국동	국동제1투	2338	1657	681	4	1653	146	1498	1	1	4	3
전라남도	여수시	국동	국동제2투	3340	2479	861	8	2471	176	2292	1	0	1	1
전라남도	여수시	국동	국동제3투	1694	1258	436	6	1252	115	1133	0	0	4	0
전라남도	여수시	국동	국동제4투	2807	2102	705	7	2095	155	1932	0	1	7	0
전라남도	여수시	월호동	소계	6548	5144	1404	23	5121	446	4660	2	1	6	6
전라남도	여수시	월호동	월호동제1투	3211	2474	737	11	2463	225	2229	1	1	4	3
전라남도	여수시	월호동	월호동제2투	2501	2065	436	9	2056	180	1873	1	0	1	1
전라남도	여수시	월호동	월호동제3투	705	510	195	2	508	34	471	0	0	1	2
전라남도	여수시	월호동	월호동제4투	131	95	36	1	94	7	87	0	0	0	0
전라남도	여수시	여서동	소계	17314	13891	3423	36	13855	1115	12711	1	3	14	11
전라남도	여수시	여서동	여서동제1투	3561	2684	877	11	2673	223	2443	0	1	3	3
전라남도	여수시	여서동	여서동제2투	2599	2152	447	6	2146	241	1902	0	0	3	0
전라남도	여수시	여서동	여서동제3투	3095	2588	507	2	2586	223	2360	1	1	1	0
전라남도	여수시	여서동	여서동제4투	2966	2396	570	6	2390	142	2243	0	1	2	2
전라남도	여수시	여서동	여서동제5투	2390	1986	404	5	1981	167	1810	0	0	3	1
전라남도	여수시	여서동	여서동제6투	2703	2085	618	6	2079	119	1953	0	0	2	5
전라남도	여수시	문수동	소계	17347	13499	3848	44	13455	1083	12345	2	0	13	12
전라남도	여수시	문수동	문수동제1투	1742	1363	379	6	1357	109	1246	1	0	1	0
전라남도	여수시	문수동	문수동제2투	2662	2151	511	8	2143	166	1974	0	0	1	2
전라남도	여수시	문수동	문수동제3투	4138	3319	819	5	3314	273	3037	0	0	2	2
전라남도	여수시	문수동	문수동제4투	1613	1374	239	3	1371	121	1247	0	0	3	0
전라남도	여수시	문수동	문수동제5투	2822	1898	924	11	1887	217	1658	1	0	4	7
전라남도	여수시	문수동	문수동제6투	4370	3394	976	11	3383	197	3183	0	0	2	1
전라남도	여수시	미평동	소계	10296	7949	2347	47	7902	659	7214	4	3	13	9
전라남도	여수시	미평동	미평동제1투	3149	2470	679	12	2458	249	2201	0	0	4	4
전라남도	여수시	미평동	미평동제2투	2775	2028	747	19	2009	177	1822	0	2	6	2
전라남도	여수시	미평동	미평동제3투	2338	1782	556	7	1775	118	1650	2	1	3	1
전라남도	여수시	미평동	미평동제4투	2034	1669	365	9	1660	115	1541	2	0	0	2
전라남도	여수시	둔덕동	소계	8379	6719	1660	30	6689	532	6141	5	3	7	1
전라남도	여수시	둔덕동	둔덕동제1투	2006	1501	505	12	1489	121	1362	2	0	3	1
전라남도	여수시	둔덕동	둔덕동제2투	4165	3367	798	10	3357	276	3077	1	1	2	0
전라남도	여수시	둔덕동	둔덕동제3투	2208	1851	357	8	1843	135	1702	2	2	2	0
전라남도	여수시	만덕동	소계	4887	3704	1183	27	3677	299	3360	4	0	10	4
전라남도	여수시	만덕동	만덕동제1투	3564	2735	829	17	2718	233	2475	2	0	5	3
전라남도	여수시	만덕동	만덕동제2투	1323	969	354	10	959	66	885	2	0	5	1
전라남도	여수시	쌍봉동	소계	26185	20897	5288	101	20796	1865	18890	4	4	20	13
전라남도	여수시	쌍봉동	쌍봉동제1투	2072	1494	578	16	1478	162	1313	0	0	1	2
전라남도	여수시	쌍봉동	쌍봉동제2투	3717	2732	985	17	2715	258	2453	1	0	1	2
전라남도	여수시	쌍봉동	쌍봉동제3투	3306	2697	609	9	2688	241	2440	0	1	5	1
전라남도	여수시	쌍봉동	쌍봉동제4투	2852	2351	501	4	2347	233	2109	1	0	2	2
전라남도	여수시	쌍봉동	쌍봉동제5투	4246	3451	795	23	3428	218	3202	0	1	3	4
전라남도	여수시	쌍봉동	쌍봉동제6투	2943	2297	646	15	2282	206	2070	1	1	3	1
전라남도	여수시	쌍봉동	쌍봉동제7투	3400	2778	622	11	2767	266	2499	1	0	1	0
전라남도	여수시	쌍봉동	쌍봉동제8투	3649	3097	552	6	3091	281	2804	0	1	4	1
전라남도	여수시	시전동	소계	16274	12801	3473	73	12728	1064	11614	16	3	16	15
전라남도	여수시	시전동	시전동제1투	3080	2262	818	16	2246	191	2039	4	2	5	5
전라남도	여수시	시전동	시전동제2투	2828	2402	426	23	2379	210	2160	2	1	2	4
전라남도	여수시	시전동	시전동제3투	2419	1907	512	6	1901	119	1777	2	0	2	1
전라남도	여수시	시전동	시전동제4투	2782	2074	708	12	2062	193	1860	4	0	3	2
전라남도	여수시	시전동	시전동제5투	1917	1560	357	9	1551	118	1430	1	0	1	1
전라남도	여수시	시전동	시전동제6투	3248	2596	652	7	2589	233	2348	3	0	3	2
전라남도	여수시	여천동	소계	17073	13204	3869	110	13094	1147	11908	2	3	17	17
전라남도	여수시	여천동	여천동제1투	2430	1875	555	17	1858	203	1651	1	0	2	1
전라남도	여수시	여천동	여천동제2투	3764	3087	677	20	3067	288	2773	0	1	2	3
전라남도	여수시	여천동	여천동제3투	3576	2708	868	19	2689	203	2474	0	0	7	5
전라남도	여수시	여천동	여천동제4투	4575	3455	1120	29	3426	268	3151	0	0	2	5
전라남도	여수시	여천동	여천동제5투	2728	2079	649	25	2054	185	1859	1	2	4	3
전라남도	여수시	주삼동	소계	5862	4813	1049	29	4784	351	4423	1	1	6	2
전라남도	여수시	주삼동	주삼동제1투	1413	1103	310	9	1094	98	992	0	0	3	1
전라남도	여수시	주삼동	주삼동제2투	1919	1640	279	12	1628	126	1500	1	0	0	1
전라남도	여수시	주삼동	주삼동제3투	2530	2070	460	8	2062	127	1931	0	1	3	0
전라남도	여수시	삼일동	소계	2489	1841	648	11	1830	138	1685	0	0	7	0
전라남도	여수시	삼일동	삼일동투표소	2489	1841	648	11	1830	138	1685	0	0	7	0
전라남도	여수시	묘도동	소계	1135	885	250	4	881	56	822	0	1	2	0
전라남도	여수시	묘도동	묘도동투표소	1135	885	250	4	881	56	822	0	1	2	0
전라남도	여수시	잘못 투입·구분된 투표지	잘못 투입·구분된 투표지	0	1	-1	0	1	0	1	0	0	0	0
전라남도	순천시	계	계	208794	165404	43390	631	164773	14638	149610	49	61	269	146
전라남도	순천시	재외투표	재외투표	653	459	194	2	457	92	361	1	0	2	1
전라남도	순천시	국내부재자투표	국내부재자투표	8035	7353	682	96	7257	1126	6084	10	7	14	16
전라남도	순천시	승주읍	소계	2875	2048	827	21	2027	188	1816	0	3	8	12
전라남도	순천시	승주읍	승주읍제1투	2391	1678	713	15	1663	151	1496	0	1	5	10
전라남도	순천시	승주읍	승주읍제2투	484	370	114	6	364	37	320	0	2	3	2
전라남도	순천시	주암면	소계	3323	2473	850	24	2449	256	2170	2	0	8	13
전라남도	순천시	주암면	주암면제1투	1320	1011	309	9	1002	108	881	2	0	4	7
전라남도	순천시	주암면	주암면제2투	2003	1462	541	15	1447	148	1289	0	0	4	6
전라남도	순천시	송광면	소계	1649	1221	428	11	1210	124	1076	0	2	4	4
전라남도	순천시	송광면	송광면투표소	1649	1221	428	11	1210	124	1076	0	2	4	4
전라남도	순천시	외서면	소계	930	686	244	11	675	49	618	1	0	2	5
전라남도	순천시	외서면	외서면투표소	930	686	244	11	675	49	618	1	0	2	5
전라남도	순천시	낙안면	소계	3241	2459	782	26	2433	186	2222	2	1	13	9
전라남도	순천시	낙안면	낙안면제1투	1896	1427	469	14	1413	116	1285	1	0	6	5
전라남도	순천시	낙안면	낙안면제2투	1345	1032	313	12	1020	70	937	1	1	7	4
전라남도	순천시	별량면	소계	5648	4141	1507	27	4114	370	3718	1	2	16	7
전라남도	순천시	별량면	별량면제1투	2158	1607	551	11	1596	150	1434	0	1	7	4
전라남도	순천시	별량면	별량면제2투	2164	1565	599	10	1555	138	1409	1	0	6	1
전라남도	순천시	별량면	별량면제3투	1326	969	357	6	963	82	875	0	1	3	2
전라남도	순천시	상사면	소계	2522	1886	636	13	1873	196	1659	2	3	9	4
전라남도	순천시	상사면	상사면제1투	1064	793	271	6	787	82	696	1	3	2	3
전라남도	순천시	상사면	상사면제2투	1458	1093	365	7	1086	114	963	1	0	7	1
전라남도	순천시	해룡면	소계	18597	14777	3820	50	14727	985	13713	2	2	21	4
전라남도	순천시	해룡면	해룡면제1투	2925	2244	681	10	2234	187	2043	0	0	3	1
전라남도	순천시	해룡면	해룡면제2투	1896	1387	509	14	1373	91	1277	0	0	4	1
전라남도	순천시	해룡면	해룡면제3투	1076	820	256	6	814	44	767	0	0	3	0
전라남도	순천시	해룡면	해룡면제4투	4044	3157	887	4	3153	222	2922	2	0	6	1
전라남도	순천시	해룡면	해룡면제5투	3784	3132	652	5	3127	186	2937	0	2	2	0
전라남도	순천시	해룡면	해룡면제6투	4872	4037	835	11	4026	255	3767	0	0	3	1
전라남도	순천시	서면	소계	9477	7399	2078	37	7362	617	6720	2	4	11	8
전라남도	순천시	서면	서면제1투	1112	842	270	3	839	76	759	1	0	3	0
전라남도	순천시	서면	서면제2투	1763	1366	397	6	1360	136	1214	1	1	4	4
전라남도	순천시	서면	서면제3투	2088	1705	383	3	1702	100	1601	0	0	0	1
전라남도	순천시	서면	서면제4투	3382	2612	770	18	2594	236	2351	0	2	3	2
전라남도	순천시	서면	서면제5투	1132	874	258	7	867	69	795	0	1	1	1
전라남도	순천시	황전면	소계	3161	2368	793	17	2351	230	2106	2	0	5	8
전라남도	순천시	황전면	황전면제1투	1568	1188	380	10	1178	136	1031	1	0	3	7
전라남도	순천시	황전면	황전면제2투	1593	1180	413	7	1173	94	1075	1	0	2	1
전라남도	순천시	월등면	소계	1842	1444	398	9	1435	155	1268	1	0	8	3
전라남도	순천시	월등면	월등면투표소	1842	1444	398	9	1435	155	1268	1	0	8	3
전라남도	순천시	향동	소계	4292	3202	1090	13	3189	308	2862	1	1	11	6
전라남도	순천시	향동	향동투표소	4292	3202	1090	13	3189	308	2862	1	1	11	6
전라남도	순천시	매곡동	소계	5630	4201	1429	14	4187	433	3737	1	1	10	5
전라남도	순천시	매곡동	매곡동제1투	2436	1850	586	5	1845	234	1605	1	0	4	1
전라남도	순천시	매곡동	매곡동제2투	3194	2351	843	9	2342	199	2132	0	1	6	4
전라남도	순천시	삼산동	소계	16925	13711	3214	33	13678	1127	12514	1	7	17	12
전라남도	순천시	삼산동	삼산동제1투	1781	1350	431	4	1346	128	1215	0	1	1	1
전라남도	순천시	삼산동	삼산동제2투	2349	1917	432	5	1912	169	1737	0	2	1	3
전라남도	순천시	삼산동	삼산동제3투	2052	1632	420	3	1629	114	1513	0	1	0	1
전라남도	순천시	삼산동	삼산동제4투	3783	3148	635	4	3144	281	2856	0	2	4	1
전라남도	순천시	삼산동	삼산동제5투	3094	2370	724	13	2357	166	2180	1	1	6	3
전라남도	순천시	삼산동	삼산동제6투	1782	1472	310	1	1471	129	1339	0	0	1	2
전라남도	순천시	삼산동	삼산동제7투	2084	1822	262	3	1819	140	1674	0	0	4	1
전라남도	순천시	조곡동	소계	6151	4755	1396	13	4742	455	4277	0	1	6	3
전라남도	순천시	조곡동	조곡동제1투	2703	2161	542	7	2154	193	1959	0	0	2	0
전라남도	순천시	조곡동	조곡동제2투	1268	911	357	2	909	104	803	0	0	2	0
전라남도	순천시	조곡동	조곡동제3투	2180	1683	497	4	1679	158	1515	0	1	2	3
전라남도	순천시	덕연동	소계	35702	29164	6538	53	29111	2292	26779	4	7	24	5
전라남도	순천시	덕연동	덕연동제1투	3785	3042	743	6	3036	276	2755	0	0	5	0
전라남도	순천시	덕연동	덕연동제2투	3149	2332	817	14	2318	206	2112	0	0	0	0
전라남도	순천시	덕연동	덕연동제3투	3573	3062	511	2	3060	242	2809	0	2	5	2
전라남도	순천시	덕연동	덕연동제4투	3023	2514	509	4	2510	264	2240	1	1	4	0
전라남도	순천시	덕연동	덕연동제5투	3143	2600	543	3	2597	185	2410	0	0	2	0
전라남도	순천시	덕연동	덕연동제6투	2988	2458	530	5	2453	194	2257	1	0	1	0
전라남도	순천시	덕연동	덕연동제7투	3558	2865	693	5	2860	185	2671	2	1	1	0
전라남도	순천시	덕연동	덕연동제8투	3144	2472	672	3	2469	148	2317	0	2	1	1
전라남도	순천시	덕연동	덕연동제9투	3103	2678	425	4	2674	146	2524	0	1	3	0
전라남도	순천시	덕연동	덕연동제10투	2520	2064	456	4	2060	165	1895	0	0	0	0
전라남도	순천시	덕연동	덕연동제11투	3716	3077	639	3	3074	281	2789	0	0	2	2
전라남도	순천시	풍덕동	소계	7624	5954	1670	15	5939	539	5386	1	2	11	0
전라남도	순천시	풍덕동	풍덕동제1투	1985	1481	504	1	1480	128	1348	0	1	3	0
전라남도	순천시	풍덕동	풍덕동제2투	2308	1745	563	6	1739	160	1576	0	0	3	0
전라남도	순천시	풍덕동	풍덕동제3투	3331	2728	603	8	2720	251	2462	1	1	5	0
전라남도	순천시	남제동	소계	8988	6764	2224	22	6742	597	6133	1	2	6	3
전라남도	순천시	남제동	남제동제1투	2059	1507	552	7	1500	146	1350	0	0	4	0
전라남도	순천시	남제동	남제동제2투	2212	1685	527	4	1681	154	1522	0	2	1	2
전라남도	순천시	남제동	남제동제3투	2580	1928	652	7	1921	153	1766	1	0	1	0
전라남도	순천시	남제동	남제동제4투	2137	1644	493	4	1640	144	1495	0	0	0	1
전라남도	순천시	저전동	소계	2941	2303	638	6	2297	235	2054	1	3	4	0
전라남도	순천시	저전동	저전동투표소	2941	2303	638	6	2297	235	2054	1	3	4	0
전라남도	순천시	장천동	소계	2829	2008	821	7	2001	248	1747	1	0	5	0
전라남도	순천시	장천동	장천동투표소	2829	2008	821	7	2001	248	1747	1	0	5	0
전라남도	순천시	중앙동	소계	3538	2589	949	6	2583	268	2313	1	0	1	0
전라남도	순천시	중앙동	중앙동제1투	1463	1131	332	1	1130	125	1005	0	0	0	0
전라남도	순천시	중앙동	중앙동제2투	2075	1458	617	5	1453	143	1308	1	0	1	0
전라남도	순천시	도사동	소계	7560	5766	1794	21	5745	416	5308	4	1	14	2
전라남도	순천시	도사동	도사동제1투	3834	2901	933	7	2894	212	2669	2	0	9	2
전라남도	순천시	도사동	도사동제2투	2144	1628	516	7	1621	108	1507	2	0	4	0
전라남도	순천시	도사동	도사동제3투	1582	1237	345	7	1230	96	1132	0	1	1	0
전라남도	순천시	왕조1동	소계	29525	23676	5849	53	23623	2226	21339	6	9	31	12
전라남도	순천시	왕조1동	왕조1동제1투	3161	2619	542	15	2604	290	2301	2	3	4	4
전라남도	순천시	왕조1동	왕조1동제2투	2861	2147	714	4	2143	185	1955	0	1	1	1
전라남도	순천시	왕조1동	왕조1동제3투	4476	3441	1035	3	3438	312	3116	3	2	5	0
전라남도	순천시	왕조1동	왕조1동제4투	1973	1628	345	3	1625	134	1488	0	0	2	1
전라남도	순천시	왕조1동	왕조1동제5투	2080	1510	570	10	1500	147	1349	1	0	1	2
전라남도	순천시	왕조1동	왕조1동제6투	3587	2563	1024	5	2558	203	2353	0	1	0	1
전라남도	순천시	왕조1동	왕조1동제7투	3493	3000	493	6	2994	265	2724	0	0	4	1
전라남도	순천시	왕조1동	왕조1동제8투	3233	2808	425	2	2806	215	2584	0	2	5	0
전라남도	순천시	왕조1동	왕조1동제9투	4661	3960	701	5	3955	475	3469	0	0	9	2
전라남도	순천시	왕조2동	소계	15136	12597	2539	31	12566	920	11630	1	3	8	4
전라남도	순천시	왕조2동	왕조2동제1투	3043	2595	448	5	2590	225	2360	1	1	2	1
전라남도	순천시	왕조2동	왕조2동제2투	3097	2450	647	8	2442	189	2250	0	2	1	0
전라남도	순천시	왕조2동	왕조2동제3투	2246	1874	372	2	1872	107	1762	0	0	2	1
전라남도	순천시	왕조2동	왕조2동제4투	2982	2462	520	12	2450	156	2290	0	0	3	1
전라남도	순천시	왕조2동	왕조2동제5투	3768	3216	552	4	3212	243	2968	0	0	0	1
전라남도	나주시	계	계	74091	57053	17038	415	56638	4984	51150	62	41	242	159
전라남도	나주시	재외투표	재외투표	259	176	83	0	176	45	128	1	0	0	2
전라남도	나주시	국내부재자투표	국내부재자투표	3138	2855	283	79	2776	390	2303	24	18	12	29
전라남도	나주시	남평읍	소계	6568	5067	1501	26	5041	323	4683	5	3	21	6
전라남도	나주시	남평읍	남평읍제1투	2764	2098	666	7	2091	128	1951	2	1	9	0
전라남도	나주시	남평읍	남평읍제2투	2932	2291	641	14	2277	147	2115	2	2	8	3
전라남도	나주시	남평읍	남평읍제3투	872	678	194	5	673	48	617	1	0	4	3
전라남도	나주시	세지면	소계	2840	2101	739	20	2081	167	1899	0	1	7	7
전라남도	나주시	세지면	세지면투표소	2840	2101	739	20	2081	167	1899	0	1	7	7
전라남도	나주시	왕곡면	소계	3129	2445	684	19	2426	224	2181	3	0	10	8
전라남도	나주시	왕곡면	왕곡면제1투	1630	1272	358	13	1259	121	1126	2	0	4	6
전라남도	나주시	왕곡면	왕곡면제2투	1499	1173	326	6	1167	103	1055	1	0	6	2
전라남도	나주시	반남면	소계	1605	1220	385	10	1210	88	1106	0	1	9	6
전라남도	나주시	반남면	반남면투표소	1605	1220	385	10	1210	88	1106	0	1	9	6
전라남도	나주시	공산면	소계	2429	1925	504	16	1909	169	1710	0	3	18	9
전라남도	나주시	공산면	공산면제1투	1708	1347	361	11	1336	113	1205	0	2	11	5
전라남도	나주시	공산면	공산면제2투	721	578	143	5	573	56	505	0	1	7	4
전라남도	나주시	동강면	소계	2790	2074	716	28	2046	150	1869	3	3	10	11
전라남도	나주시	동강면	동강면투표소	2790	2074	716	28	2046	150	1869	3	3	10	11
전라남도	나주시	다시면	소계	3788	2890	898	27	2863	242	2594	2	0	14	11
전라남도	나주시	다시면	다시면제1투	2903	2185	718	19	2166	191	1954	1	0	11	9
전라남도	나주시	다시면	다시면제2투	885	705	180	8	697	51	640	1	0	3	2
전라남도	나주시	문평면	소계	2066	1592	474	9	1583	166	1404	2	0	6	5
전라남도	나주시	문평면	문평면제1투	1305	1013	292	9	1004	98	894	2	0	5	5
전라남도	나주시	문평면	문평면제2투	761	579	182	0	579	68	510	0	0	1	0
전라남도	나주시	노안면	소계	4651	3532	1119	21	3511	261	3219	4	3	17	7
전라남도	나주시	노안면	노안면제1투	1157	838	319	7	831	75	746	0	3	5	2
전라남도	나주시	노안면	노안면제2투	1535	1193	342	7	1186	78	1100	1	0	6	1
전라남도	나주시	노안면	노안면제3투	1959	1501	458	7	1494	108	1373	3	0	6	4
전라남도	나주시	금천면	소계	4422	3464	958	18	3446	250	3172	3	0	10	11
전라남도	나주시	금천면	금천면제1투	1620	1255	365	4	1251	105	1139	1	0	3	3
전라남도	나주시	금천면	금천면제2투	1191	940	251	7	933	58	865	1	0	3	6
전라남도	나주시	금천면	금천면제3투	1611	1269	342	7	1262	87	1168	1	0	4	2
전라남도	나주시	산포면	소계	3515	2769	746	18	2751	205	2521	1	1	15	8
전라남도	나주시	산포면	산포면제1투	2112	1622	490	11	1611	105	1489	1	1	10	5
전라남도	나주시	산포면	산포면제2투	345	284	61	0	284	21	258	0	0	3	2
전라남도	나주시	산포면	산포면제3투	1058	863	195	7	856	79	774	0	0	2	1
전라남도	나주시	다도면	소계	1816	1383	433	19	1364	96	1243	2	1	18	4
전라남도	나주시	다도면	다도면투표소	1816	1383	433	19	1364	96	1243	2	1	18	4
전라남도	나주시	봉황면	소계	4322	3236	1086	31	3205	218	2946	2	3	30	6
전라남도	나주시	봉황면	봉황면제1투	3117	2352	765	22	2330	157	2147	2	1	20	3
전라남도	나주시	봉황면	봉황면제2투	1205	884	321	9	875	61	799	0	2	10	3
전라남도	나주시	송월동	소계	4953	3916	1037	6	3910	346	3545	2	1	9	7
전라남도	나주시	송월동	송월동제1투	498	371	127	2	369	45	317	0	1	4	2
전라남도	나주시	송월동	송월동제2투	2608	2058	550	2	2056	163	1888	2	0	2	1
전라남도	나주시	송월동	송월동제3투	1847	1487	360	2	1485	138	1340	0	0	3	4
전라남도	나주시	영강동	소계	2812	2075	737	6	2069	194	1869	2	0	4	0
전라남도	나주시	영강동	영강동투표소	2812	2075	737	6	2069	194	1869	2	0	4	0
전라남도	나주시	금남동	소계	5323	4046	1277	20	4026	463	3548	1	0	11	3
전라남도	나주시	금남동	금남동제1투	2001	1534	467	4	1530	204	1321	0	0	3	2
전라남도	나주시	금남동	금남동제2투	1424	1009	415	9	1000	120	878	0	0	2	0
전라남도	나주시	금남동	금남동제3투	1898	1503	395	7	1496	139	1349	1	0	6	1
전라남도	나주시	성북동	소계	7019	5506	1513	13	5493	535	4938	1	1	10	8
전라남도	나주시	성북동	성북동제1투	2117	1538	579	4	1534	194	1330	1	1	3	5
전라남도	나주시	성북동	성북동제2투	1636	1213	423	4	1209	119	1085	0	0	2	3
전라남도	나주시	성북동	성북동제3투	3266	2755	511	5	2750	222	2523	0	0	5	0
전라남도	나주시	영산동	소계	3397	2406	991	14	2392	222	2155	1	1	7	6
전라남도	나주시	영산동	영산동제1투	1530	1093	437	6	1087	99	984	0	0	2	2
전라남도	나주시	영산동	영산동제2투	1867	1313	554	8	1305	123	1171	1	1	5	4
전라남도	나주시	이창동	소계	3249	2375	874	15	2360	230	2117	3	1	4	5
전라남도	나주시	이창동	이창동투표소	3249	2375	874	15	2360	230	2117	3	1	4	5
전라남도	광양시	계	계	112866	88097	24769	365	87732	12918	74467	24	28	197	98
전라남도	광양시	재외투표	재외투표	345	232	113	0	232	65	165	0	0	2	0
전라남도	광양시	국내부재자투표	국내부재자투표	4342	3931	411	54	3877	716	3137	6	3	5	10
전라남도	광양시	광양읍	소계	34270	26531	7739	97	26434	2656	23713	2	9	41	13
전라남도	광양시	광양읍	광양읍제1투	3008	2228	780	22	2206	219	1986	0	0	1	0
전라남도	광양시	광양읍	광양읍제2투	3304	2502	802	16	2486	232	2247	0	0	2	5
전라남도	광양시	광양읍	광양읍제3투	1093	811	282	0	811	93	718	0	0	0	0
전라남도	광양시	광양읍	광양읍제4투	2972	2303	669	1	2302	239	2060	0	0	2	1
전라남도	광양시	광양읍	광양읍제5투	696	539	157	3	536	48	482	0	1	4	1
전라남도	광양시	광양읍	광양읍제6투	739	572	167	4	568	52	511	0	1	3	1
전라남도	광양시	광양읍	광양읍제7투	1362	1035	327	9	1026	78	943	0	1	4	0
전라남도	광양시	광양읍	광양읍제8투	3258	2389	869	8	2381	287	2087	1	2	3	1
전라남도	광양시	광양읍	광양읍제9투	2949	2289	660	3	2286	236	2042	0	1	5	2
전라남도	광양시	광양읍	광양읍제10투	2615	1945	670	8	1937	173	1757	1	0	5	1
전라남도	광양시	광양읍	광양읍제11투	4532	3656	876	10	3646	402	3238	0	1	5	0
전라남도	광양시	광양읍	광양읍제12투	1564	1185	379	3	1182	124	1056	0	1	1	0
전라남도	광양시	광양읍	광양읍제13투	4259	3479	780	9	3470	320	3146	0	0	4	0
전라남도	광양시	광양읍	광양읍제14투	1919	1598	321	1	1597	153	1440	0	1	2	1
전라남도	광양시	봉강면	소계	1912	1492	420	9	1483	166	1299	1	1	10	6
전라남도	광양시	봉강면	봉강면제1투	684	530	154	3	527	62	463	0	0	2	0
전라남도	광양시	봉강면	봉강면제2투	1228	962	266	6	956	104	836	1	1	8	6
전라남도	광양시	옥룡면	소계	2818	2176	642	23	2153	250	1885	1	1	10	6
전라남도	광양시	옥룡면	옥룡면제1투	1592	1231	361	10	1221	144	1065	1	1	7	3
전라남도	광양시	옥룡면	옥룡면제2투	1226	945	281	13	932	106	820	0	0	3	3
전라남도	광양시	옥곡면	소계	3226	2505	721	16	2489	239	2224	0	2	16	8
전라남도	광양시	옥곡면	옥곡면제1투	1075	839	236	9	830	66	746	0	1	10	7
전라남도	광양시	옥곡면	옥곡면제2투	2151	1666	485	7	1659	173	1478	0	1	6	1
전라남도	광양시	진상면	소계	2945	2277	668	26	2251	239	1982	1	2	15	12
전라남도	광양시	진상면	진상면제1투	1963	1526	437	17	1509	164	1321	1	2	12	9
전라남도	광양시	진상면	진상면제2투	982	751	231	9	742	75	661	0	0	3	3
전라남도	광양시	진월면	소계	3092	2317	775	15	2302	311	1958	3	1	21	8
전라남도	광양시	진월면	진월면제1투	1866	1397	469	5	1392	182	1193	1	1	9	6
전라남도	광양시	진월면	진월면제2투	640	473	167	2	471	49	413	0	0	7	2
전라남도	광양시	진월면	진월면제3투	586	447	139	8	439	80	352	2	0	5	0
전라남도	광양시	다압면	소계	1646	1265	381	11	1254	192	1052	1	2	4	3
전라남도	광양시	다압면	다압면제1투	773	588	185	5	583	113	466	0	0	4	0
전라남도	광양시	다압면	다압면제2투	873	677	196	6	671	79	586	1	2	0	3
전라남도	광양시	골약동	소계	2238	1745	493	10	1735	188	1533	0	0	9	5
전라남도	광양시	골약동	골약동제1투	940	759	181	6	753	55	691	0	0	4	3
전라남도	광양시	골약동	골약동제2투	1298	986	312	4	982	133	842	0	0	5	2
전라남도	광양시	중마동	소계	34071	26394	7677	58	26336	3996	22297	3	5	25	10
전라남도	광양시	중마동	중마동제1투	2761	2022	739	5	2017	302	1712	0	1	2	0
전라남도	광양시	중마동	중마동제2투	4364	3190	1174	6	3184	478	2700	2	0	2	2
전라남도	광양시	중마동	중마동제3투	4334	3274	1060	7	3267	561	2699	0	1	3	3
전라남도	광양시	중마동	중마동제4투	3287	2615	672	6	2609	456	2147	0	1	4	1
전라남도	광양시	중마동	중마동제5투	3841	2994	847	8	2986	414	2567	0	1	3	1
전라남도	광양시	중마동	중마동제6투	4205	3362	843	9	3353	503	2845	0	0	4	1
전라남도	광양시	중마동	중마동제7투	3834	3240	594	7	3233	420	2809	0	1	2	1
전라남도	광양시	중마동	중마동제8투	3601	2952	649	4	2948	507	2439	0	0	1	1
전라남도	광양시	중마동	중마동제9투	3844	2745	1099	6	2739	355	2379	1	0	4	0
전라남도	광양시	광영동	소계	9366	6802	2564	18	6784	1239	5519	4	0	13	9
전라남도	광양시	광영동	광영동제1투	3672	2532	1140	8	2524	460	2055	0	0	6	3
전라남도	광양시	광영동	광영동제2투	1631	1162	469	5	1157	159	994	0	0	3	1
전라남도	광양시	광영동	광영동제3투	4063	3108	955	5	3103	620	2470	4	0	4	5
전라남도	광양시	태인동	소계	2094	1588	506	11	1577	189	1375	1	2	4	6
전라남도	광양시	태인동	태인동투표소	2094	1588	506	11	1577	189	1375	1	2	4	6
전라남도	광양시	금호동	소계	10501	8842	1659	17	8825	2472	6328	1	0	22	2
전라남도	광양시	금호동	금호동제1투	2499	2133	366	1	2132	550	1575	0	0	7	0
전라남도	광양시	금호동	금호동제2투	1772	1484	288	5	1479	460	1016	0	0	3	0
전라남도	광양시	금호동	금호동제3투	2080	1747	333	4	1743	489	1247	1	0	5	1
전라남도	광양시	금호동	금호동제4투	2130	1771	359	2	1769	490	1276	0	0	2	1
전라남도	광양시	금호동	금호동제5투	2020	1707	313	5	1702	483	1214	0	0	5	0
전라남도	광양시	잘못 투입·구분된 투표지	잘못 투입·구분된 투표지	0	0	0	0	0	0	0	0	0	0	0
전라남도	담양군	계	계	40636	31746	8890	244	31502	3084	28099	19	27	192	81
전라남도	담양군	재외투표	재외투표	201	92	109	0	92	22	70	0	0	0	0
전라남도	담양군	국내부재자투표	국내부재자투표	1566	1451	115	20	1431	306	1106	1	5	3	10
전라남도	담양군	담양읍	소계	10957	8419	2538	41	8378	901	7420	6	3	36	12
전라남도	담양군	담양읍	담양읍제1투	2372	1732	640	10	1722	169	1538	2	0	8	5
전라남도	담양군	담양읍	담양읍제2투	2168	1708	460	10	1698	152	1532	2	0	10	2
전라남도	담양군	담양읍	담양읍제3투	2469	1924	545	4	1920	262	1653	1	1	3	0
전라남도	담양군	담양읍	담양읍제4투	1644	1287	357	9	1278	151	1118	0	1	6	2
전라남도	담양군	담양읍	담양읍제5투	2304	1768	536	8	1760	167	1579	1	1	9	3
전라남도	담양군	봉산면	소계	2533	1997	536	11	1986	183	1784	0	2	12	5
전라남도	담양군	봉산면	봉산면제1투	1810	1416	394	6	1410	135	1259	0	2	10	4
전라남도	담양군	봉산면	봉산면제2투	723	581	142	5	576	48	525	0	0	2	1
전라남도	담양군	고서면	소계	3054	2386	668	13	2373	193	2161	2	1	8	8
전라남도	담양군	고서면	고서면제1투	1538	1180	358	3	1177	86	1085	1	1	2	2
전라남도	담양군	고서면	고서면제2투	1516	1206	310	10	1196	107	1076	1	0	6	6
전라남도	담양군	남면	소계	1253	999	254	5	994	103	875	1	0	14	1
전라남도	담양군	남면	남면제1투	679	540	139	1	539	66	470	0	0	3	0
전라남도	담양군	남면	남면제2투	574	459	115	4	455	37	405	1	0	11	1
전라남도	담양군	창평면	소계	3393	2577	816	26	2551	197	2333	0	0	10	11
전라남도	담양군	창평면	창평면제1투	2448	1842	606	18	1824	146	1664	0	0	6	8
전라남도	담양군	창평면	창평면제2투	945	735	210	8	727	51	669	0	0	4	3
전라남도	담양군	대덕면	소계	1753	1325	428	9	1316	129	1172	0	1	13	1
전라남도	담양군	대덕면	대덕면제1투	1412	1072	340	7	1065	107	944	0	1	12	1
전라남도	담양군	대덕면	대덕면제2투	341	253	88	2	251	22	228	0	0	1	0
전라남도	담양군	무정면	소계	2369	1833	536	11	1822	173	1621	2	1	20	5
전라남도	담양군	무정면	무정면제1투	1535	1183	352	7	1176	109	1051	1	0	13	2
전라남도	담양군	무정면	무정면제2투	834	650	184	4	646	64	570	1	1	7	3
전라남도	담양군	금성면	소계	2497	1932	565	22	1910	161	1721	0	3	21	4
전라남도	담양군	금성면	금성면제1투	1826	1411	415	16	1395	132	1245	0	2	14	2
전라남도	담양군	금성면	금성면제2투	671	521	150	6	515	29	476	0	1	7	2
전라남도	담양군	용면	소계	1651	1313	338	13	1300	147	1133	3	1	9	7
전라남도	담양군	용면	용면제1투	1229	975	254	10	965	109	843	2	1	5	5
전라남도	담양군	용면	용면제2투	422	338	84	3	335	38	290	1	0	4	2
전라남도	담양군	월산면	소계	2268	1805	463	27	1778	163	1589	1	6	12	7
전라남도	담양군	월산면	월산면제1투	1729	1373	356	23	1350	126	1203	1	6	9	5
전라남도	담양군	월산면	월산면제2투	539	432	107	4	428	37	386	0	0	3	2
전라남도	담양군	수북면	소계	3515	2784	731	28	2756	197	2532	3	3	19	2
전라남도	담양군	수북면	수북면제1투	2718	2161	557	26	2135	158	1957	3	2	15	0
전라남도	담양군	수북면	수북면제2투	797	623	174	2	621	39	575	0	1	4	2
전라남도	담양군	대전면	소계	3626	2833	793	18	2815	209	2582	0	1	15	8
전라남도	담양군	대전면	대전면제1투	2665	2053	612	10	2043	157	1872	0	1	7	6
전라남도	담양군	대전면	대전면제2투	961	780	181	8	772	52	710	0	0	8	2
전라남도	장성군	계	계	38697	29591	9106	217	29374	3532	25567	22	25	147	81
전라남도	장성군	재외투표	재외투표	133	90	43	1	89	20	69	0	0	0	0
전라남도	장성군	국내부재자투표	국내부재자투표	1568	1416	152	29	1387	256	1121	2	5	2	1
전라남도	장성군	장성읍	소계	10412	7818	2594	40	7778	810	6920	4	5	23	16
전라남도	장성군	장성읍	장성읍제1투	2482	1817	665	7	1810	191	1609	1	1	2	6
전라남도	장성군	장성읍	장성읍제2투	2379	1886	493	7	1879	146	1726	2	0	3	2
전라남도	장성군	장성읍	장성읍제3투	3068	2251	817	12	2239	246	1978	0	3	6	6
전라남도	장성군	장성읍	장성읍제4투	2483	1864	619	14	1850	227	1607	1	1	12	2
전라남도	장성군	진원면	소계	2749	2178	571	12	2166	191	1956	1	2	5	11
전라남도	장성군	진원면	진원면제1투	1740	1384	356	5	1379	153	1214	1	1	3	7
전라남도	장성군	진원면	진원면제2투	1009	794	215	7	787	38	742	0	1	2	4
전라남도	장성군	남면	소계	3179	2469	710	14	2455	166	2267	2	2	12	6
전라남도	장성군	남면	남면제1투	1497	1144	353	11	1133	62	1060	1	2	5	3
전라남도	장성군	남면	남면제2투	1682	1325	357	3	1322	104	1207	1	0	7	3
전라남도	장성군	동화면	소계	1770	1350	420	5	1345	143	1186	1	0	9	6
전라남도	장성군	동화면	동화면제1투	1259	946	313	5	941	114	820	0	0	4	3
전라남도	장성군	동화면	동화면제2투	511	404	107	0	404	29	366	1	0	5	3
전라남도	장성군	삼서면	소계	2837	2170	667	19	2151	186	1942	0	0	20	3
전라남도	장성군	삼서면	삼서면투표소	2837	2170	667	19	2151	186	1942	0	0	20	3
전라남도	장성군	삼계면	소계	4817	3670	1147	11	3659	900	2735	2	1	16	5
전라남도	장성군	삼계면	삼계면제1투	1790	1388	402	2	1386	121	1257	0	1	6	1
전라남도	장성군	삼계면	삼계면제2투	2045	1538	507	4	1534	733	792	2	0	4	3
전라남도	장성군	삼계면	삼계면제3투	982	744	238	5	739	46	686	0	0	6	1
전라남도	장성군	황룡면	소계	3611	2678	933	19	2659	287	2344	2	1	20	5
전라남도	장성군	황룡면	황룡면제1투	1368	999	369	3	996	96	892	0	1	6	1
전라남도	장성군	황룡면	황룡면제2투	2243	1679	564	16	1663	191	1452	2	0	14	4
전라남도	장성군	서삼면	소계	1385	1057	328	10	1047	110	927	0	2	6	2
전라남도	장성군	서삼면	서삼면투표소	1385	1057	328	10	1047	110	927	0	2	6	2
전라남도	장성군	북일면	소계	1356	1046	310	9	1037	87	929	1	4	12	4
전라남도	장성군	북일면	북일면투표소	1356	1046	310	9	1037	87	929	1	4	12	4
전라남도	장성군	북이면	소계	2705	2072	633	16	2056	194	1838	1	2	13	8
전라남도	장성군	북이면	북이면제1투	1260	950	310	8	942	88	843	0	1	6	4
전라남도	장성군	북이면	북이면제2투	1445	1122	323	8	1114	106	995	1	1	7	4
전라남도	장성군	북하면	소계	2175	1577	598	32	1545	182	1333	6	1	9	14
전라남도	장성군	북하면	북하면투표소	2175	1577	598	32	1545	182	1333	6	1	9	14
전라남도	장성군	잘못 투입·구분된 투표지	잘못 투입·구분된 투표지	0	0	0	0	0	0	0	0	0	0	0
전라남도	곡성군	계	계	26346	20504	5842	203	20301	2255	17810	14	10	127	85
전라남도	곡성군	재외투표	재외투표	89	68	21	1	67	21	45	1	0	0	0
전라남도	곡성군	국내부재자투표	국내부재자투표	1163	1054	109	11	1043	133	902	1	2	4	1
전라남도	곡성군	곡성읍	소계	6415	4943	1472	40	4903	607	4245	4	4	23	20
전라남도	곡성군	곡성읍	곡성읍제1투	1506	1112	394	8	1104	159	937	0	0	6	2
전라남도	곡성군	곡성읍	곡성읍제2투	1734	1366	368	5	1361	187	1169	0	1	3	1
전라남도	곡성군	곡성읍	곡성읍제3투	1995	1559	436	20	1539	188	1326	2	2	9	12
전라남도	곡성군	곡성읍	곡성읍제4투	1180	906	274	7	899	73	813	2	1	5	5
전라남도	곡성군	오곡면	소계	1863	1468	395	10	1458	170	1276	0	0	7	5
전라남도	곡성군	오곡면	오곡면투표소	1863	1468	395	10	1458	170	1276	0	0	7	5
전라남도	곡성군	삼기면	소계	1606	1232	374	17	1215	145	1048	1	0	17	4
전라남도	곡성군	삼기면	삼기면투표소	1606	1232	374	17	1215	145	1048	1	0	17	4
전라남도	곡성군	석곡면	소계	2270	1735	535	17	1718	190	1507	0	1	10	10
전라남도	곡성군	석곡면	석곡면투표소	2270	1735	535	17	1718	190	1507	0	1	10	10
전라남도	곡성군	목사동면	소계	1342	996	346	10	986	195	778	1	1	8	3
전라남도	곡성군	목사동면	목사동면투표소	1342	996	346	10	986	195	778	1	1	8	3
전라남도	곡성군	죽곡면	소계	1717	1325	392	12	1313	135	1153	3	0	15	7
전라남도	곡성군	죽곡면	죽곡면투표소	1717	1325	392	12	1313	135	1153	3	0	15	7
전라남도	곡성군	고달면	소계	1163	911	252	9	902	87	799	1	0	10	5
전라남도	곡성군	고달면	고달면투표소	1163	911	252	9	902	87	799	1	0	10	5
전라남도	곡성군	옥과면	소계	3335	2554	781	20	2534	192	2319	1	1	10	11
전라남도	곡성군	옥과면	옥과면제1투	2203	1698	505	7	1691	121	1555	1	1	6	7
전라남도	곡성군	옥과면	옥과면제2투	1132	856	276	13	843	71	764	0	0	4	4
전라남도	곡성군	입면	소계	2320	1866	454	22	1844	147	1682	1	1	12	1
전라남도	곡성군	입면	입면투표소	2320	1866	454	22	1844	147	1682	1	1	12	1
전라남도	곡성군	겸면	소계	1679	1301	378	22	1279	124	1145	0	0	3	7
전라남도	곡성군	겸면	겸면투표소	1679	1301	378	22	1279	124	1145	0	0	3	7
전라남도	곡성군	오산면	소계	1384	1051	333	12	1039	109	911	0	0	8	11
전라남도	곡성군	오산면	오산면투표소	1384	1051	333	12	1039	109	911	0	0	8	11
전라남도	구례군	계	계	22950	17833	5117	145	17688	2230	15328	13	11	59	47
전라남도	구례군	재외투표	재외투표	75	49	26	0	49	13	34	0	0	2	0
전라남도	구례군	국내부재자투표	국내부재자투표	1032	956	76	12	944	122	814	4	2	2	0
전라남도	구례군	구례읍	소계	8621	6631	1990	29	6602	837	5743	2	3	10	7
전라남도	구례군	구례읍	구례읍제1투	1095	888	207	3	885	118	767	0	0	0	0
전라남도	구례군	구례읍	구례읍제2투	1997	1530	467	9	1521	160	1359	0	1	1	0
전라남도	구례군	구례읍	구례읍제3투	2135	1628	507	4	1624	212	1409	0	2	1	0
전라남도	구례군	구례읍	구례읍제4투	1551	1206	345	5	1201	158	1035	2	0	3	3
전라남도	구례군	구례읍	구례읍제5투	1843	1379	464	8	1371	189	1173	0	0	5	4
전라남도	구례군	문척면	소계	1071	837	234	9	828	95	723	0	1	5	4
전라남도	구례군	문척면	문척면투표소	1071	837	234	9	828	95	723	0	1	5	4
전라남도	구례군	간전면	소계	1403	1089	314	10	1079	160	904	2	0	6	7
전라남도	구례군	간전면	간전면제1투	696	539	157	7	532	87	438	0	0	3	4
전라남도	구례군	간전면	간전면제2투	374	296	78	2	294	29	262	1	0	0	2
전라남도	구례군	간전면	간전면제3투	333	254	79	1	253	44	204	1	0	3	1
전라남도	구례군	토지면	소계	2202	1690	512	17	1673	209	1440	1	1	14	8
전라남도	구례군	토지면	토지면제1투	1397	1081	316	13	1068	120	930	1	1	11	5
전라남도	구례군	토지면	토지면제2투	391	299	92	3	296	54	237	0	0	2	3
전라남도	구례군	토지면	토지면제3투	414	310	104	1	309	35	273	0	0	1	0
전라남도	구례군	마산면	소계	2387	1814	573	15	1799	251	1541	0	1	3	3
전라남도	구례군	마산면	마산면투표소	2387	1814	573	15	1799	251	1541	0	1	3	3
전라남도	구례군	광의면	소계	2153	1673	480	17	1656	189	1453	0	2	4	8
전라남도	구례군	광의면	광의면제1투	1226	954	272	10	944	115	820	0	0	3	6
전라남도	구례군	광의면	광의면제2투	927	719	208	7	712	74	633	0	2	1	2
전라남도	구례군	용방면	소계	1308	1053	255	18	1035	125	904	1	0	4	1
전라남도	구례군	용방면	용방면투표소	1308	1053	255	18	1035	125	904	1	0	4	1
전라남도	구례군	산동면	소계	2698	2041	657	18	2023	229	1772	3	1	9	9
전라남도	구례군	산동면	산동면제1투	1378	1030	348	10	1020	108	902	2	1	2	5
전라남도	구례군	산동면	산동면제2투	903	678	225	2	676	84	591	0	0	1	0
전라남도	구례군	산동면	산동면제3투	417	333	84	6	327	37	279	1	0	6	4
전라남도	고흥군	계	계	62117	47363	14754	516	46847	5193	41139	29	31	284	171
전라남도	고흥군	재외투표	재외투표	204	133	71	0	133	46	86	0	1	0	0
전라남도	고흥군	국내부재자투표	국내부재자투표	2495	2241	254	38	2203	454	1736	1	3	4	5
전라남도	고흥군	고흥읍	소계	9036	6836	2200	30	6806	763	5995	2	8	28	10
전라남도	고흥군	고흥읍	고흥읍제1투	623	476	147	4	472	34	431	0	1	4	2
전라남도	고흥군	고흥읍	고흥읍제2투	852	651	201	2	649	94	551	0	2	2	0
전라남도	고흥군	고흥읍	고흥읍제3투	2456	1894	562	6	1888	182	1695	0	2	5	4
전라남도	고흥군	고흥읍	고흥읍제4투	2602	1978	624	6	1972	236	1721	2	0	9	4
전라남도	고흥군	고흥읍	고흥읍제5투	2503	1837	666	12	1825	217	1597	0	3	8	0
전라남도	고흥군	도양읍	소계	9230	6976	2254	47	6929	862	6030	6	1	19	11
전라남도	고흥군	도양읍	도양읍제1투	1929	1389	540	4	1385	139	1242	1	0	0	3
전라남도	고흥군	도양읍	도양읍제2투	2397	1800	597	21	1779	167	1603	1	1	5	2
전라남도	고흥군	도양읍	도양읍제3투	2922	2215	707	9	2206	207	1994	2	0	2	1
전라남도	고흥군	도양읍	도양읍제4투	501	379	122	5	374	21	345	1	0	6	1
전라남도	고흥군	도양읍	도양읍제5투	661	497	164	3	494	40	448	1	0	4	1
전라남도	고흥군	도양읍	도양읍제6투	100	79	21	1	78	9	67	0	0	2	0
전라남도	고흥군	도양읍	도양읍제7투	504	431	73	1	430	270	158	0	0	0	2
전라남도	고흥군	도양읍	도양읍제8투	216	186	30	3	183	9	173	0	0	0	1
전라남도	고흥군	풍양면	소계	3315	2595	720	25	2570	236	2318	1	0	8	7
전라남도	고흥군	풍양면	풍양면제1투	1242	953	289	7	946	99	841	1	0	2	3
전라남도	고흥군	풍양면	풍양면제2투	1003	785	218	11	774	76	690	0	0	4	4
전라남도	고흥군	풍양면	풍양면제3투	1070	857	213	7	850	61	787	0	0	2	0
전라남도	고흥군	도덕면	소계	2944	2323	621	26	2297	183	2084	1	1	16	12
전라남도	고흥군	도덕면	도덕면제1투	1843	1454	389	16	1438	115	1305	1	0	10	7
전라남도	고흥군	도덕면	도덕면제2투	1101	869	232	10	859	68	779	0	1	6	5
전라남도	고흥군	금산면	소계	4252	3227	1025	49	3178	264	2879	0	0	20	15
전라남도	고흥군	금산면	금산면제1투	2473	1853	620	30	1823	163	1642	0	0	9	9
전라남도	고흥군	금산면	금산면제2투	1779	1374	405	19	1355	101	1237	0	0	11	6
전라남도	고흥군	도화면	소계	3922	2923	999	49	2874	296	2517	0	6	36	19
전라남도	고흥군	도화면	도화면제1투	587	455	132	9	446	44	390	0	1	7	4
전라남도	고흥군	도화면	도화면제2투	1619	1183	436	25	1158	99	1032	0	4	15	8
전라남도	고흥군	도화면	도화면제3투	1716	1285	431	15	1270	153	1095	0	1	14	7
전라남도	고흥군	포두면	소계	5046	3758	1288	49	3709	333	3338	1	2	25	10
전라남도	고흥군	포두면	포두면제1투	546	387	159	2	385	51	331	0	0	1	2
전라남도	고흥군	포두면	포두면제2투	871	613	258	12	601	53	542	0	0	4	2
전라남도	고흥군	포두면	포두면제3투	2501	1893	608	22	1871	149	1697	1	2	18	4
전라남도	고흥군	포두면	포두면제4투	1128	865	263	13	852	80	768	0	0	2	2
전라남도	고흥군	봉래면	소계	1932	1346	586	9	1337	231	1081	2	0	15	8
전라남도	고흥군	봉래면	봉래면제1투	1375	981	394	8	973	178	783	1	0	8	3
전라남도	고흥군	봉래면	봉래면제2투	557	365	192	1	364	53	298	1	0	7	5
전라남도	고흥군	동일면	소계	1446	1055	391	11	1044	123	901	1	0	8	11
전라남도	고흥군	동일면	동일면투표소	1446	1055	391	11	1044	123	901	1	0	8	11
전라남도	고흥군	점암면	소계	2743	2094	649	32	2062	252	1778	2	3	16	11
전라남도	고흥군	점암면	점암면제1투	1397	1057	340	14	1043	131	899	1	2	6	4
전라남도	고흥군	점암면	점암면제2투	713	536	177	13	523	63	448	1	1	6	4
전라남도	고흥군	점암면	점암면제3투	633	501	132	5	496	58	431	0	0	4	3
전라남도	고흥군	영남면	소계	1361	1057	304	12	1045	100	921	1	1	8	14
전라남도	고흥군	영남면	영남면제1투	558	432	126	6	426	37	381	1	0	4	3
전라남도	고흥군	영남면	영남면제2투	803	625	178	6	619	63	540	0	1	4	11
전라남도	고흥군	과역면	소계	3296	2490	806	23	2467	285	2160	1	2	11	8
전라남도	고흥군	과역면	과역면제1투	2209	1698	511	13	1685	191	1483	0	2	6	3
전라남도	고흥군	과역면	과역면제2투	1087	792	295	10	782	94	677	1	0	5	5
전라남도	고흥군	남양면	소계	2335	1742	593	29	1713	187	1492	2	1	24	7
전라남도	고흥군	남양면	남양면제1투	1492	1120	372	15	1105	135	952	1	0	14	3
전라남도	고흥군	남양면	남양면제2투	843	622	221	14	608	52	540	1	1	10	4
전라남도	고흥군	동강면	소계	3073	2373	700	25	2348	219	2098	2	0	18	11
전라남도	고흥군	동강면	동강면제1투	1648	1284	364	10	1274	112	1142	2	0	10	8
전라남도	고흥군	동강면	동강면제2투	1425	1089	336	15	1074	107	956	0	0	8	3
전라남도	고흥군	대서면	소계	2336	1789	547	22	1767	130	1617	2	2	11	5
전라남도	고흥군	대서면	대서면제1투	1528	1178	350	14	1164	97	1056	1	1	6	3
전라남도	고흥군	대서면	대서면제2투	808	611	197	8	603	33	561	1	1	5	2
전라남도	고흥군	두원면	소계	3151	2405	746	40	2365	229	2108	4	0	17	7
전라남도	고흥군	두원면	두원면제1투	1789	1358	431	23	1335	143	1178	2	0	7	5
전라남도	고흥군	두원면	두원면제2투	1362	1047	315	17	1030	86	930	2	0	10	2
전라남도	보성군	계	계	40159	30149	10010	302	29847	3470	26054	31	22	163	107
전라남도	보성군	재외투표	재외투표	169	109	60	0	109	38	71	0	0	0	0
전라남도	보성군	국내부재자투표	국내부재자투표	1748	1596	152	32	1564	204	1350	4	1	5	0
전라남도	보성군	보성읍	소계	7328	5499	1829	38	5461	706	4712	7	6	21	9
전라남도	보성군	보성읍	보성읍제1투	1321	917	404	12	905	134	767	2	1	1	0
전라남도	보성군	보성읍	보성읍제2투	1442	1121	321	3	1118	192	923	0	1	1	1
전라남도	보성군	보성읍	보성읍제3투	1874	1455	419	4	1451	172	1270	2	1	6	0
전라남도	보성군	보성읍	보성읍제4투	568	421	147	4	417	60	353	0	1	3	0
전라남도	보성군	보성읍	보성읍제5투	1239	919	320	13	906	86	805	1	2	6	6
전라남도	보성군	보성읍	보성읍제6투	884	666	218	2	664	62	594	2	0	4	2
전라남도	보성군	벌교읍	소계	11775	8523	3252	66	8457	909	7475	4	6	33	30
전라남도	보성군	벌교읍	벌교읍제1투	1560	948	612	10	938	117	813	1	2	3	2
전라남도	보성군	벌교읍	벌교읍제2투	1554	1166	388	7	1159	132	1024	1	1	0	1
전라남도	보성군	벌교읍	벌교읍제3투	1549	1148	401	11	1137	134	991	1	0	5	6
전라남도	보성군	벌교읍	벌교읍제4투	1344	954	390	11	943	104	824	0	0	9	6
전라남도	보성군	벌교읍	벌교읍제5투	944	710	234	4	706	71	632	0	1	0	2
전라남도	보성군	벌교읍	벌교읍제6투	1041	754	287	7	747	73	663	0	0	6	5
전라남도	보성군	벌교읍	벌교읍제7투	528	388	140	3	385	35	346	0	1	3	0
전라남도	보성군	벌교읍	벌교읍제8투	2033	1581	452	5	1576	154	1418	1	0	1	2
전라남도	보성군	벌교읍	벌교읍제9투	841	610	231	5	605	75	522	0	1	3	4
전라남도	보성군	벌교읍	벌교읍제10투	381	264	117	3	261	14	242	0	0	3	2
전라남도	보성군	노동면	소계	1046	819	227	10	809	99	688	1	1	14	6
전라남도	보성군	노동면	노동면투표소	1046	819	227	10	809	99	688	1	1	14	6
전라남도	보성군	미력면	소계	1406	1103	303	15	1088	122	952	3	1	4	6
전라남도	보성군	미력면	미력면투표소	1406	1103	303	15	1088	122	952	3	1	4	6
전라남도	보성군	겸백면	소계	1212	926	286	10	916	109	799	3	0	3	2
전라남도	보성군	겸백면	겸백면투표소	1212	926	286	10	916	109	799	3	0	3	2
전라남도	보성군	율어면	소계	1241	935	306	13	922	86	818	2	1	11	4
전라남도	보성군	율어면	율어면투표소	1241	935	306	13	922	86	818	2	1	11	4
전라남도	보성군	복내면	소계	1642	1231	411	13	1218	134	1064	1	1	12	6
전라남도	보성군	복내면	복내면투표소	1642	1231	411	13	1218	134	1064	1	1	12	6
전라남도	보성군	문덕면	소계	852	658	194	8	650	94	551	1	0	1	3
전라남도	보성군	문덕면	문덕면투표소	852	658	194	8	650	94	551	1	0	1	3
전라남도	보성군	조성면	소계	3717	2790	927	24	2766	290	2444	1	1	19	11
전라남도	보성군	조성면	조성면제1투	1708	1300	408	9	1291	134	1143	1	0	8	5
전라남도	보성군	조성면	조성면제2투	817	612	205	3	609	56	541	0	1	7	4
전라남도	보성군	조성면	조성면제3투	1192	878	314	12	866	100	760	0	0	4	2
전라남도	보성군	득량면	소계	4001	2946	1055	36	2910	344	2530	2	3	13	18
전라남도	보성군	득량면	득량면제1투	1345	999	346	10	989	112	863	1	2	5	6
전라남도	보성군	득량면	득량면제2투	1720	1264	456	13	1251	159	1078	1	0	5	8
전라남도	보성군	득량면	득량면제3투	936	683	253	13	670	73	589	0	1	3	4
전라남도	보성군	회천면	소계	2909	2134	775	20	2114	266	1817	2	1	20	8
전라남도	보성군	회천면	회천면제1투	1046	724	322	2	722	118	597	0	0	6	1
전라남도	보성군	회천면	회천면제2투	895	665	230	10	655	77	564	1	1	8	4
전라남도	보성군	회천면	회천면제3투	968	745	223	8	737	71	656	1	0	6	3
전라남도	보성군	웅치면	소계	1113	880	233	17	863	69	783	0	0	7	4
전라남도	보성군	웅치면	웅치면투표소	1113	880	233	17	863	69	783	0	0	7	4
전라남도	화순군	계	계	54652	42352	12300	498	41854	3685	37716	64	30	241	118
전라남도	화순군	재외투표	재외투표	136	107	29	0	107	29	78	0	0	0	0
전라남도	화순군	국내부재자투표	국내부재자투표	1904	1771	133	39	1732	227	1492	3	2	4	4
전라남도	화순군	화순읍	소계	29773	23297	6476	222	23075	1888	21077	36	11	44	19
전라남도	화순군	화순읍	화순읍제1투	2178	1783	395	8	1775	164	1608	0	0	1	2
전라남도	화순군	화순읍	화순읍제2투	2588	2108	480	14	2094	132	1954	2	1	4	1
전라남도	화순군	화순읍	화순읍제3투	3279	2510	769	24	2486	205	2271	1	2	4	3
전라남도	화순군	화순읍	화순읍제4투	3412	2703	709	29	2674	202	2459	6	1	4	2
전라남도	화순군	화순읍	화순읍제5투	1691	1358	333	14	1344	106	1236	1	0	1	0
전라남도	화순군	화순읍	화순읍제6투	1009	748	261	4	744	53	686	3	0	0	2
전라남도	화순군	화순읍	화순읍제7투	708	559	149	21	538	19	509	1	1	7	1
전라남도	화순군	화순읍	화순읍제8투	261	195	66	3	192	18	169	2	0	3	0
전라남도	화순군	화순읍	화순읍제9투	1571	1097	474	9	1088	105	974	6	0	2	1
전라남도	화순군	화순읍	화순읍제10투	3634	2794	840	25	2769	229	2527	5	1	5	2
전라남도	화순군	화순읍	화순읍제11투	2724	2140	584	23	2117	203	1905	3	1	4	1
전라남도	화순군	화순읍	화순읍제12투	3989	3176	813	17	3159	260	2887	5	3	4	0
전라남도	화순군	화순읍	화순읍제13투	2729	2126	603	31	2095	192	1892	1	1	5	4
전라남도	화순군	한천면	소계	1363	1034	329	16	1018	101	899	4	0	8	6
전라남도	화순군	한천면	한천면제1투	901	681	220	13	668	64	593	3	0	5	3
전라남도	화순군	한천면	한천면제2투	462	353	109	3	350	37	306	1	0	3	3
전라남도	화순군	춘양면	소계	1923	1429	494	18	1411	113	1261	4	2	20	11
전라남도	화순군	춘양면	춘양면투표소	1923	1429	494	18	1411	113	1261	4	2	20	11
전라남도	화순군	청풍면	소계	1119	885	234	21	864	90	745	2	1	17	9
전라남도	화순군	청풍면	청풍면제1투	675	524	151	15	509	52	441	1	1	8	6
전라남도	화순군	청풍면	청풍면제2투	444	361	83	6	355	38	304	1	0	9	3
전라남도	화순군	이양면	소계	1889	1395	494	19	1376	104	1238	1	2	20	11
전라남도	화순군	이양면	이양면제1투	1163	836	327	13	823	59	747	1	1	11	4
전라남도	화순군	이양면	이양면제2투	726	559	167	6	553	45	491	0	1	9	7
전라남도	화순군	능주면	소계	2817	2107	710	19	2088	208	1856	2	2	13	7
전라남도	화순군	능주면	능주면제1투	775	571	204	6	565	78	482	1	0	3	1
전라남도	화순군	능주면	능주면제2투	1082	799	283	6	793	50	729	1	2	6	5
전라남도	화순군	능주면	능주면제3투	960	737	223	7	730	80	645	0	0	4	1
전라남도	화순군	도곡면	소계	2635	2060	575	26	2034	168	1836	2	2	21	5
전라남도	화순군	도곡면	도곡면제1투	1220	941	279	13	928	70	835	2	1	16	4
전라남도	화순군	도곡면	도곡면제2투	1415	1119	296	13	1106	98	1001	0	1	5	1
전라남도	화순군	도암면	소계	1441	1090	351	9	1081	124	936	1	1	14	5
전라남도	화순군	도암면	도암면제1투	1070	804	266	6	798	101	679	1	1	12	4
전라남도	화순군	도암면	도암면제2투	371	286	85	3	283	23	257	0	0	2	1
전라남도	화순군	이서면	소계	908	706	202	10	696	51	637	0	0	5	3
전라남도	화순군	이서면	이서면투표소	908	706	202	10	696	51	637	0	0	5	3
전라남도	화순군	북면	소계	1630	1229	401	13	1216	80	1096	3	0	29	8
전라남도	화순군	북면	북면투표소	1630	1229	401	13	1216	80	1096	3	0	29	8
전라남도	화순군	동복면	소계	1662	1215	447	22	1193	119	1048	3	3	11	9
전라남도	화순군	동복면	동복면투표소	1662	1215	447	22	1193	119	1048	3	3	11	9
전라남도	화순군	남면	소계	2181	1643	538	23	1620	157	1433	1	0	18	11
전라남도	화순군	남면	남면제1투	1394	1039	355	14	1025	101	905	1	0	9	9
전라남도	화순군	남면	남면제2투	787	604	183	9	595	56	528	0	0	9	2
전라남도	화순군	동면	소계	3271	2384	887	41	2343	226	2084	2	4	17	10
전라남도	화순군	동면	동면제1투	1501	1100	401	13	1087	108	969	1	2	3	4
전라남도	화순군	동면	동면제2투	997	737	260	12	725	65	646	1	1	7	5
전라남도	화순군	동면	동면제3투	773	547	226	16	531	53	469	0	1	7	1
전라남도	화순군	잘못 투입·구분된 투표지	잘못 투입·구분된 투표지	0	0	0	0	0	0	0	0	0	0	0
전라남도	장흥군	계	계	35194	26817	8377	245	26572	2808	23468	21	18	175	82
전라남도	장흥군	재외투표	재외투표	145	99	46	1	98	32	64	0	0	2	0
전라남도	장흥군	국내부재자투표	국내부재자투표	1829	1553	276	27	1526	177	1339	2	0	3	5
전라남도	장흥군	장흥읍	소계	11212	8506	2706	46	8460	924	7484	4	5	25	18
전라남도	장흥군	장흥읍	장흥읍제1투	1953	1318	635	6	1312	181	1125	1	2	3	0
전라남도	장흥군	장흥읍	장흥읍제2투	1380	1040	340	8	1032	117	901	0	1	6	7
전라남도	장흥군	장흥읍	장흥읍제3투	2225	1721	504	10	1711	161	1546	0	0	2	2
전라남도	장흥군	장흥읍	장흥읍제4투	2852	2270	582	7	2263	239	2011	1	1	6	5
전라남도	장흥군	장흥읍	장흥읍제5투	2044	1575	469	6	1569	162	1401	0	1	4	1
전라남도	장흥군	장흥읍	장흥읍제6투	758	582	176	9	573	64	500	2	0	4	3
전라남도	장흥군	관산읍	소계	5051	3734	1317	36	3698	322	3340	3	2	24	7
전라남도	장흥군	관산읍	관산읍제1투	2047	1517	530	13	1504	129	1363	0	0	9	3
전라남도	장흥군	관산읍	관산읍제2투	1553	1127	426	11	1116	115	987	2	2	8	2
전라남도	장흥군	관산읍	관산읍제3투	1451	1090	361	12	1078	78	990	1	0	7	2
전라남도	장흥군	대덕읍	소계	3418	2557	861	37	2520	321	2163	1	1	22	12
전라남도	장흥군	대덕읍	대덕읍제1투	2787	2080	707	31	2049	273	1747	1	1	16	11
전라남도	장흥군	대덕읍	대덕읍제2투	631	477	154	6	471	48	416	0	0	6	1
전라남도	장흥군	용산면	소계	2270	1732	538	10	1722	164	1531	4	5	13	5
전라남도	장흥군	용산면	용산면투표소	2270	1732	538	10	1722	164	1531	4	5	13	5
전라남도	장흥군	안양면	소계	2704	2065	639	21	2044	190	1827	1	3	17	6
전라남도	장흥군	안양면	안양면제1투	1476	1156	320	11	1145	108	1023	1	2	8	3
전라남도	장흥군	안양면	안양면제2투	1228	909	319	10	899	82	804	0	1	9	3
전라남도	장흥군	장동면	소계	1265	988	277	9	979	97	865	0	0	12	5
전라남도	장흥군	장동면	장동면투표소	1265	988	277	9	979	97	865	0	0	12	5
전라남도	장흥군	장평면	소계	2100	1611	489	23	1588	135	1423	3	2	15	10
전라남도	장흥군	장평면	장평면제1투	1596	1201	395	18	1183	109	1054	0	1	13	6
전라남도	장흥군	장평면	장평면제2투	504	410	94	5	405	26	369	3	1	2	4
전라남도	장흥군	유치면	소계	1074	810	264	7	803	134	660	0	0	7	2
전라남도	장흥군	유치면	유치면투표소	1074	810	264	7	803	134	660	0	0	7	2
전라남도	장흥군	부산면	소계	1381	1062	319	6	1056	82	956	1	0	11	6
전라남도	장흥군	부산면	부산면투표소	1381	1062	319	6	1056	82	956	1	0	11	6
전라남도	장흥군	회진면	소계	2745	2100	645	22	2078	230	1816	2	0	24	6
전라남도	장흥군	회진면	회진면투표소	2745	2100	645	22	2078	230	1816	2	0	24	6
전라남도	강진군	계	계	33287	24779	8508	231	24548	3023	21316	25	16	108	60
전라남도	강진군	재외투표	재외투표	117	77	40	0	77	27	50	0	0	0	0
전라남도	강진군	국내부재자투표	국내부재자투표	1583	1422	161	27	1395	186	1202	0	1	2	4
전라남도	강진군	강진읍	소계	11094	8057	3037	41	8016	1024	6945	7	6	20	14
전라남도	강진군	강진읍	강진읍제1투	2355	1661	694	9	1652	233	1416	2	1	0	0
전라남도	강진군	강진읍	강진읍제2투	2494	1753	741	11	1742	211	1522	0	1	7	1
전라남도	강진군	강진읍	강진읍제3투	1647	1229	418	3	1226	183	1039	0	1	2	1
전라남도	강진군	강진읍	강진읍제4투	1036	776	260	5	771	87	673	2	1	4	4
전라남도	강진군	강진읍	강진읍제5투	1128	830	298	12	818	96	705	3	1	6	7
전라남도	강진군	강진읍	강진읍제6투	2434	1808	626	1	1807	214	1590	0	1	1	1
전라남도	강진군	군동면	소계	3547	2641	906	31	2610	312	2268	4	3	14	9
전라남도	강진군	군동면	군동면제1투	1252	901	351	15	886	135	731	2	3	9	6
전라남도	강진군	군동면	군동면제2투	1397	1064	333	9	1055	108	944	1	0	1	1
전라남도	강진군	군동면	군동면제3투	898	676	222	7	669	69	593	1	0	4	2
전라남도	강진군	칠량면	소계	2368	1745	623	20	1725	215	1495	2	1	11	1
전라남도	강진군	칠량면	칠량면투표소	2368	1745	623	20	1725	215	1495	2	1	11	1
전라남도	강진군	대구면	소계	1211	903	308	13	890	122	752	2	0	13	1
전라남도	강진군	대구면	대구면투표소	1211	903	308	13	890	122	752	2	0	13	1
전라남도	강진군	마량면	소계	1780	1312	468	11	1301	144	1146	0	0	5	6
전라남도	강진군	마량면	마량면투표소	1780	1312	468	11	1301	144	1146	0	0	5	6
전라남도	강진군	도암면	소계	2640	1916	724	24	1892	235	1634	3	0	12	8
전라남도	강진군	도암면	도암면제1투	1903	1357	546	14	1343	177	1151	2	0	7	6
전라남도	강진군	도암면	도암면제2투	737	559	178	10	549	58	483	1	0	5	2
전라남도	강진군	신전면	소계	1793	1381	412	15	1366	153	1198	1	0	7	7
전라남도	강진군	신전면	신전면제1투	1055	802	253	8	794	91	697	0	0	3	3
전라남도	강진군	신전면	신전면제2투	738	579	159	7	572	62	501	1	0	4	4
전라남도	강진군	성전면	소계	2736	2046	690	17	2029	212	1805	1	3	6	2
전라남도	강진군	성전면	성전면투표소	2736	2046	690	17	2029	212	1805	1	3	6	2
전라남도	강진군	작천면	소계	1957	1483	474	13	1470	155	1299	1	1	9	5
전라남도	강진군	작천면	작천면투표소	1957	1483	474	13	1470	155	1299	1	1	9	5
전라남도	강진군	병영면	소계	1762	1278	484	13	1265	178	1076	2	1	5	3
전라남도	강진군	병영면	병영면투표소	1762	1278	484	13	1265	178	1076	2	1	5	3
전라남도	강진군	옴천면	소계	699	518	181	6	512	60	446	2	0	4	0
전라남도	강진군	옴천면	옴천면투표소	699	518	181	6	512	60	446	2	0	4	0
전라남도	강진군	잘못 투입·구분된 투표지	잘못 투입·구분된 투표지	0	0	0	0	0	0	0	0	0	0	0
전라남도	완도군	계	계	45129	34116	11013	372	33744	3152	30236	9	26	213	108
전라남도	완도군	재외투표	재외투표	94	46	48	0	46	17	29	0	0	0	0
전라남도	완도군	국내부재자투표	국내부재자투표	2361	2147	214	43	2104	234	1849	2	3	14	2
전라남도	완도군	완도읍	소계	14309	10553	3756	55	10498	1078	9364	2	6	37	11
전라남도	완도군	완도읍	완도읍제1투	4026	3014	1012	8	3006	298	2700	0	0	6	2
전라남도	완도군	완도읍	완도읍제2투	2854	2042	812	11	2031	217	1803	1	1	7	2
전라남도	완도군	완도읍	완도읍제3투	1607	1128	479	7	1121	114	998	0	1	6	2
전라남도	완도군	완도읍	완도읍제4투	3235	2474	761	10	2464	240	2216	1	2	5	0
전라남도	완도군	완도읍	완도읍제5투	1254	908	346	6	902	112	786	0	0	2	2
전라남도	완도군	완도읍	완도읍제6투	1333	987	346	13	974	97	861	0	2	11	3
전라남도	완도군	금일읍	소계	3215	2341	874	30	2311	140	2140	1	1	24	5
전라남도	완도군	금일읍	금일읍제1투	834	586	248	10	576	40	528	1	1	4	2
전라남도	완도군	금일읍	금일읍제2투	1040	770	270	10	760	53	699	0	0	8	0
전라남도	완도군	금일읍	금일읍제3투	1341	985	356	10	975	47	913	0	0	12	3
전라남도	완도군	노화읍	소계	4650	3473	1177	38	3435	214	3179	0	2	24	16
전라남도	완도군	노화읍	노화읍제1투	2651	1980	671	18	1962	126	1813	0	1	14	8
전라남도	완도군	노화읍	노화읍제2투	1242	939	303	17	922	58	848	0	0	10	6
전라남도	완도군	노화읍	노화읍제3투	757	554	203	3	551	30	518	0	1	0	2
전라남도	완도군	군외면	소계	3029	2210	819	24	2186	318	1847	1	1	14	5
전라남도	완도군	군외면	군외면제1투	1799	1291	508	15	1276	201	1071	0	0	3	1
전라남도	완도군	군외면	군외면제2투	1230	919	311	9	910	117	776	1	1	11	4
전라남도	완도군	신지면	소계	3111	2378	733	21	2357	177	2165	0	2	9	4
전라남도	완도군	신지면	신지면제1투	1657	1288	369	7	1281	100	1172	0	2	5	2
전라남도	완도군	신지면	신지면제2투	1454	1090	364	14	1076	77	993	0	0	4	2
전라남도	완도군	고금면	소계	3836	2928	908	40	2888	262	2596	1	2	20	7
전라남도	완도군	고금면	고금면제1투	2281	1740	541	16	1724	155	1551	1	2	9	6
전라남도	완도군	고금면	고금면제2투	835	636	199	12	624	51	567	0	0	6	0
전라남도	완도군	고금면	고금면제3투	720	552	168	12	540	56	478	0	0	5	1
전라남도	완도군	약산면	소계	2163	1689	474	23	1666	153	1488	0	0	13	12
전라남도	완도군	약산면	약산면제1투	1435	1102	333	17	1085	115	953	0	0	8	9
전라남도	완도군	약산면	약산면제2투	728	587	141	6	581	38	535	0	0	5	3
전라남도	완도군	청산면	소계	2147	1580	567	29	1551	176	1343	1	2	16	13
전라남도	완도군	청산면	청산면제1투	1422	1031	391	17	1014	105	890	1	1	10	7
전라남도	완도군	청산면	청산면제2투	519	402	117	10	392	59	325	0	1	3	4
전라남도	완도군	청산면	청산면제3투	206	147	59	2	145	12	128	0	0	3	2
전라남도	완도군	소안면	소계	2223	1741	482	32	1709	141	1547	1	0	11	9
전라남도	완도군	소안면	소안면제1투	1468	1148	320	20	1128	84	1032	0	0	8	4
전라남도	완도군	소안면	소안면제2투	755	593	162	12	581	57	515	1	0	3	5
전라남도	완도군	금당면	소계	941	709	232	6	703	60	628	0	3	5	7
전라남도	완도군	금당면	금당면투표소	941	709	232	6	703	60	628	0	3	5	7
전라남도	완도군	보길면	소계	2379	1828	551	23	1805	136	1640	0	2	15	12
전라남도	완도군	보길면	보길면제1투	1137	874	263	12	862	58	785	0	0	10	9
전라남도	완도군	보길면	보길면제2투	1242	954	288	11	943	78	855	0	2	5	3
전라남도	완도군	생일면	소계	671	493	178	8	485	46	421	0	2	11	5
전라남도	완도군	생일면	생일면투표소	671	493	178	8	485	46	421	0	2	11	5
전라남도	해남군	계	계	65070	47639	17431	540	47099	4747	41882	55	45	240	130
전라남도	해남군	재외투표	재외투표	172	131	41	0	131	32	98	0	0	0	1
전라남도	해남군	국내부재자투표	국내부재자투표	2997	2692	305	138	2554	466	2016	25	13	16	18
전라남도	해남군	해남읍	소계	17227	12684	4543	59	12625	1246	11317	9	6	27	20
전라남도	해남군	해남읍	해남읍제1투	1551	1036	515	4	1032	93	931	0	0	3	5
전라남도	해남군	해남읍	해남읍제2투	1260	907	353	3	904	119	778	1	0	5	1
전라남도	해남군	해남읍	해남읍제3투	2253	1650	603	8	1642	186	1452	1	0	3	0
전라남도	해남군	해남읍	해남읍제4투	2950	2316	634	11	2305	226	2072	1	2	3	1
전라남도	해남군	해남읍	해남읍제5투	1349	986	363	2	984	78	903	0	0	1	2
전라남도	해남군	해남읍	해남읍제6투	1816	1337	479	3	1334	117	1206	2	1	6	2
전라남도	해남군	해남읍	해남읍제7투	1899	1336	563	10	1326	132	1187	1	2	3	1
전라남도	해남군	해남읍	해남읍제8투	3004	2278	726	8	2270	204	2056	2	1	2	5
전라남도	해남군	해남읍	해남읍제9투	1145	838	307	10	828	91	732	1	0	1	3
전라남도	해남군	삼산면	소계	2883	2064	819	19	2045	213	1815	2	3	8	4
전라남도	해남군	삼산면	삼산면제1투	1861	1325	536	13	1312	151	1152	1	2	4	2
전라남도	해남군	삼산면	삼산면제2투	1022	739	283	6	733	62	663	1	1	4	2
전라남도	해남군	화산면	소계	3370	2417	953	24	2393	237	2128	1	2	16	9
전라남도	해남군	화산면	화산면제1투	1396	966	430	12	954	111	832	0	1	5	5
전라남도	해남군	화산면	화산면제2투	917	677	240	5	672	59	604	1	0	6	2
전라남도	해남군	화산면	화산면제3투	1057	774	283	7	767	67	692	0	1	5	2
전라남도	해남군	현산면	소계	3008	2162	846	33	2129	211	1900	2	0	10	6
전라남도	해남군	현산면	현산면제1투	1060	739	321	11	728	88	635	0	0	3	2
전라남도	해남군	현산면	현산면제2투	758	541	217	7	534	65	465	0	0	3	1
전라남도	해남군	현산면	현산면제3투	1190	882	308	15	867	58	800	2	0	4	3
전라남도	해남군	송지면	소계	5847	4187	1660	53	4134	371	3718	2	3	28	12
전라남도	해남군	송지면	송지면제1투	2294	1617	677	27	1590	150	1418	2	2	14	4
전라남도	해남군	송지면	송지면제2투	1281	926	355	7	919	88	816	0	1	9	5
전라남도	해남군	송지면	송지면제3투	1239	874	365	6	868	76	789	0	0	2	1
전라남도	해남군	송지면	송지면제4투	1033	770	263	13	757	57	695	0	0	3	2
전라남도	해남군	북평면	소계	2774	2065	709	23	2042	191	1827	3	4	14	3
전라남도	해남군	북평면	북평면제1투	1807	1316	491	14	1302	131	1157	1	2	8	3
전라남도	해남군	북평면	북평면제2투	967	749	218	9	740	60	670	2	2	6	0
전라남도	해남군	북일면	소계	2047	1577	470	14	1563	122	1426	2	0	7	6
전라남도	해남군	북일면	북일면제1투	1287	984	303	8	976	72	896	1	0	3	4
전라남도	해남군	북일면	북일면제2투	760	593	167	6	587	50	530	1	0	4	2
전라남도	해남군	옥천면	소계	3027	2208	819	23	2185	265	1893	0	3	17	7
전라남도	해남군	옥천면	옥천면제1투	1922	1410	512	9	1401	153	1237	0	1	6	4
전라남도	해남군	옥천면	옥천면제2투	1105	798	307	14	784	112	656	0	2	11	3
전라남도	해남군	계곡면	소계	2258	1690	568	15	1675	182	1469	2	0	13	9
전라남도	해남군	계곡면	계곡면제1투	1217	900	317	7	893	97	782	1	0	6	7
전라남도	해남군	계곡면	계곡면제2투	1041	790	251	8	782	85	687	1	0	7	2
전라남도	해남군	마산면	소계	2440	1824	616	15	1809	164	1626	1	1	13	4
전라남도	해남군	마산면	마산면제1투	1331	979	352	12	967	86	868	0	1	10	2
전라남도	해남군	마산면	마산면제2투	1109	845	264	3	842	78	758	1	0	3	2
전라남도	해남군	황산면	소계	5127	3604	1523	38	3566	344	3197	0	2	19	4
전라남도	해남군	황산면	황산면제1투	1817	1235	582	12	1223	129	1092	0	0	2	0
전라남도	해남군	황산면	황산면제2투	1244	851	393	12	839	75	754	0	2	7	1
전라남도	해남군	황산면	황산면제3투	823	611	212	7	604	54	542	0	0	7	1
전라남도	해남군	황산면	황산면제4투	1243	907	336	7	900	86	809	0	0	3	2
전라남도	해남군	산이면	소계	4099	2831	1268	29	2802	208	2566	2	1	17	8
전라남도	해남군	산이면	산이면제1투	1494	1042	452	8	1034	81	948	1	1	1	2
전라남도	해남군	산이면	산이면제2투	1044	745	299	11	734	54	671	0	0	8	1
전라남도	해남군	산이면	산이면제3투	1561	1044	517	10	1034	73	947	1	0	8	5
전라남도	해남군	문내면	소계	3956	2831	1125	37	2794	236	2528	3	2	17	8
전라남도	해남군	문내면	문내면제1투	2047	1423	624	16	1407	125	1269	2	0	8	3
전라남도	해남군	문내면	문내면제2투	931	689	242	10	679	62	610	0	0	5	2
전라남도	해남군	문내면	문내면제3투	978	719	259	11	708	49	649	1	2	4	3
전라남도	해남군	화원면	소계	3838	2672	1166	20	2652	259	2358	1	5	18	11
전라남도	해남군	화원면	화원면제1투	1791	1231	560	8	1223	133	1075	1	2	7	5
전라남도	해남군	화원면	화원면제2투	874	615	259	6	609	52	546	0	3	7	1
전라남도	해남군	화원면	화원면제3투	1173	826	347	6	820	74	737	0	0	4	5
전라남도	진도군	계	계	27978	20598	7380	211	20387	2073	18052	14	17	134	97
전라남도	진도군	재외투표	재외투표	126	85	41	0	85	35	49	0	0	0	1
전라남도	진도군	국내부재자투표	국내부재자투표	1206	1073	133	13	1060	132	925	0	1	1	1
전라남도	진도군	진도읍	소계	7815	5801	2014	33	5768	620	5107	6	2	22	11
전라남도	진도군	진도읍	진도읍제1투	2181	1567	614	9	1558	155	1397	2	0	2	2
전라남도	진도군	진도읍	진도읍제2투	1981	1521	460	8	1513	175	1332	3	0	1	2
전라남도	진도군	진도읍	진도읍제3투	2111	1609	502	2	1607	173	1428	0	0	4	2
전라남도	진도군	진도읍	진도읍제4투	1010	719	291	10	709	71	622	1	1	10	4
전라남도	진도군	진도읍	진도읍제5투	532	385	147	4	381	46	328	0	1	5	1
전라남도	진도군	군내면	소계	2855	2137	718	24	2113	223	1861	2	1	18	8
전라남도	진도군	군내면	군내면제1투	944	706	238	11	695	73	612	1	0	5	4
전라남도	진도군	군내면	군내면제2투	1076	801	275	7	794	108	677	0	1	6	2
전라남도	진도군	군내면	군내면제3투	555	421	134	5	416	26	388	0	0	1	1
전라남도	진도군	군내면	군내면제4투	280	209	71	1	208	16	184	1	0	6	1
전라남도	진도군	고군면	소계	3339	2475	864	25	2450	209	2204	0	3	17	17
전라남도	진도군	고군면	고군면제1투	1249	908	341	11	897	69	817	0	0	7	4
전라남도	진도군	고군면	고군면제2투	356	274	82	3	271	15	252	0	0	2	2
전라남도	진도군	고군면	고군면제3투	738	553	185	3	550	54	487	0	1	4	4
전라남도	진도군	고군면	고군면제4투	996	740	256	8	732	71	648	0	2	4	7
전라남도	진도군	의신면	소계	3393	2531	862	23	2508	254	2219	2	2	21	10
전라남도	진도군	의신면	의신면제1투	1212	912	300	12	900	93	798	1	1	6	1
전라남도	진도군	의신면	의신면제2투	363	277	86	3	274	35	234	0	0	4	1
전라남도	진도군	의신면	의신면제3투	659	503	156	3	500	55	437	1	1	3	3
전라남도	진도군	의신면	의신면제4투	628	455	173	2	453	41	405	0	0	3	4
전라남도	진도군	의신면	의신면제5투	531	384	147	3	381	30	345	0	0	5	1
전라남도	진도군	임회면	소계	3299	2429	870	24	2405	215	2159	1	3	14	13
전라남도	진도군	임회면	임회면제1투	1191	865	326	3	862	81	772	0	1	5	3
전라남도	진도군	임회면	임회면제2투	892	679	213	11	668	63	588	0	2	7	8
전라남도	진도군	임회면	임회면제3투	314	243	71	0	243	15	226	1	0	1	0
전라남도	진도군	임회면	임회면제4투	410	288	122	2	286	36	248	0	0	0	2
전라남도	진도군	임회면	임회면제5투	492	354	138	8	346	20	325	0	0	1	0
전라남도	진도군	지산면	소계	3231	2368	863	39	2329	219	2070	1	0	21	18
전라남도	진도군	지산면	지산면제1투	1049	756	293	14	742	78	654	0	0	5	5
전라남도	진도군	지산면	지산면제2투	1040	775	265	17	758	66	683	1	0	3	5
전라남도	진도군	지산면	지산면제3투	775	570	205	7	563	57	488	0	0	11	7
전라남도	진도군	지산면	지산면제4투	367	267	100	1	266	18	245	0	0	2	1
전라남도	진도군	조도면	소계	2714	1699	1015	30	1669	166	1458	2	5	20	18
전라남도	진도군	조도면	조도면제1투	1224	777	447	15	762	79	670	0	2	6	5
전라남도	진도군	조도면	조도면제2투	393	252	141	3	249	18	222	1	1	4	3
전라남도	진도군	조도면	조도면제3투	135	74	61	1	73	9	59	0	0	2	3
전라남도	진도군	조도면	조도면제4투	95	67	28	2	65	9	52	1	1	2	0
전라남도	진도군	조도면	조도면제5투	225	152	73	2	150	17	129	0	1	1	2
전라남도	진도군	조도면	조도면제6투	136	77	59	2	75	9	63	0	0	1	2
전라남도	진도군	조도면	조도면제7투	155	74	81	1	73	11	61	0	0	1	0
전라남도	진도군	조도면	조도면제8투	62	33	29	2	31	8	22	0	0	0	1
전라남도	진도군	조도면	조도면제9투	289	193	96	2	191	6	180	0	0	3	2
전라남도	영암군	계	계	48344	36081	12263	294	35787	3965	31577	28	24	107	86
전라남도	영암군	재외투표	재외투표	148	95	53	0	95	32	63	0	0	0	0
전라남도	영암군	국내부재자투표	국내부재자투표	1907	1765	142	54	1711	266	1416	8	6	5	10
전라남도	영암군	영암읍	소계	6658	4940	1718	29	4911	628	4259	3	1	14	6
전라남도	영암군	영암읍	영암읍제1투	1660	1175	485	5	1170	146	1019	0	0	3	2
전라남도	영암군	영암읍	영암읍제2투	1397	1061	336	5	1056	141	908	1	0	5	1
전라남도	영암군	영암읍	영암읍제3투	1579	1207	372	6	1201	131	1066	0	0	2	2
전라남도	영암군	영암읍	영암읍제4투	2022	1497	525	13	1484	210	1266	2	1	4	1
전라남도	영암군	삼호읍	소계	15737	11387	4350	44	11343	1208	10099	0	6	19	11
전라남도	영암군	삼호읍	삼호읍제1투	4721	3299	1422	13	3286	322	2960	0	0	3	1
전라남도	영암군	삼호읍	삼호읍제2투	3439	2367	1072	11	2356	255	2097	0	1	2	1
전라남도	영암군	삼호읍	삼호읍제3투	1300	959	341	7	952	89	853	0	0	6	4
전라남도	영암군	삼호읍	삼호읍제4투	1333	928	405	5	923	115	803	0	0	4	1
전라남도	영암군	삼호읍	삼호읍제5투	2663	2079	584	4	2075	193	1874	0	3	2	3
전라남도	영암군	삼호읍	삼호읍제6투	2281	1755	526	4	1751	234	1512	0	2	2	1
전라남도	영암군	덕진면	소계	1786	1377	409	12	1365	169	1180	2	3	8	3
전라남도	영암군	덕진면	덕진면제1투	1025	768	257	9	759	88	663	0	1	4	3
전라남도	영암군	덕진면	덕진면제2투	761	609	152	3	606	81	517	2	2	4	0
전라남도	영암군	금정면	소계	1949	1480	469	16	1464	157	1279	3	1	13	11
전라남도	영암군	금정면	금정면투표소	1949	1480	469	16	1464	157	1279	3	1	13	11
전라남도	영암군	신북면	소계	3812	2883	929	18	2865	236	2604	1	4	11	9
전라남도	영암군	신북면	신북면제1투	1831	1375	456	8	1367	114	1246	0	1	4	2
전라남도	영암군	신북면	신북면제2투	1056	812	244	5	807	73	726	0	2	4	2
전라남도	영암군	신북면	신북면제3투	925	696	229	5	691	49	632	1	1	3	5
전라남도	영암군	시종면	소계	3830	2716	1114	34	2682	214	2449	1	0	7	11
전라남도	영암군	시종면	시종면제1투	2359	1638	721	16	1622	119	1494	0	0	2	7
전라남도	영암군	시종면	시종면제2투	1471	1078	393	18	1060	95	955	1	0	5	4
전라남도	영암군	도포면	소계	2301	1735	566	17	1718	170	1527	4	1	11	5
전라남도	영암군	도포면	도포면제1투	1180	885	295	15	870	88	769	3	1	6	3
전라남도	영암군	도포면	도포면제2투	1121	850	271	2	848	82	758	1	0	5	2
전라남도	영암군	군서면	소계	3101	2397	704	21	2376	258	2104	5	1	4	4
전라남도	영암군	군서면	군서면제1투	1200	885	315	8	877	97	772	1	1	3	3
전라남도	영암군	군서면	군서면제2투	1272	1022	250	5	1017	125	888	2	0	1	1
전라남도	영암군	군서면	군서면제3투	629	490	139	8	482	36	444	2	0	0	0
전라남도	영암군	서호면	소계	1939	1444	495	15	1429	207	1209	1	0	5	7
전라남도	영암군	서호면	서호면투표소	1939	1444	495	15	1429	207	1209	1	0	5	7
전라남도	영암군	학산면	소계	2928	2159	769	18	2141	254	1874	0	1	5	7
전라남도	영암군	학산면	학산면제1투	1468	1042	426	7	1035	127	903	0	0	3	2
전라남도	영암군	학산면	학산면제2투	1035	788	247	5	783	103	676	0	1	0	3
전라남도	영암군	학산면	학산면제3투	425	329	96	6	323	24	295	0	0	2	2
전라남도	영암군	미암면	소계	2248	1703	545	16	1687	166	1514	0	0	5	2
전라남도	영암군	미암면	미암면제1투	1520	1153	367	8	1145	120	1022	0	0	3	0
전라남도	영암군	미암면	미암면제2투	728	550	178	8	542	46	492	0	0	2	2
전라남도	무안군	계	계	60244	46788	13456	319	46469	4230	41849	42	58	167	123
전라남도	무안군	재외투표	재외투표	187	137	50	0	137	27	110	0	0	0	0
전라남도	무안군	국내부재자투표	국내부재자투표	3185	2902	283	111	2791	478	2229	28	26	9	21
전라남도	무안군	무안읍	소계	8510	6537	1973	27	6510	575	5898	2	5	21	9
전라남도	무안군	무안읍	무안읍제1투	2699	2000	699	12	1988	188	1781	2	1	12	4
전라남도	무안군	무안읍	무안읍제2투	3064	2359	705	7	2352	216	2129	0	2	4	1
전라남도	무안군	무안읍	무안읍제3투	635	503	132	2	501	37	460	0	0	2	2
전라남도	무안군	무안읍	무안읍제4투	2112	1675	437	6	1669	134	1528	0	2	3	2
전라남도	무안군	일로읍	소계	6459	4834	1625	22	4812	342	4428	2	9	21	10
전라남도	무안군	일로읍	일로읍제1투	1109	796	313	4	792	56	728	1	0	3	4
전라남도	무안군	일로읍	일로읍제2투	757	593	164	3	590	44	540	0	1	4	1
전라남도	무안군	일로읍	일로읍제3투	1929	1399	530	3	1396	112	1280	0	1	2	1
전라남도	무안군	일로읍	일로읍제4투	510	408	102	2	406	20	380	1	2	3	0
전라남도	무안군	일로읍	일로읍제5투	1313	1001	312	8	993	53	928	0	4	4	4
전라남도	무안군	일로읍	일로읍제6투	841	637	204	2	635	57	572	0	1	5	0
전라남도	무안군	삼향읍	소계	17435	13988	3447	42	13946	1065	12840	2	5	20	14
전라남도	무안군	삼향읍	삼향읍제1투	948	726	222	0	726	65	658	0	0	2	1
전라남도	무안군	삼향읍	삼향읍제2투	1498	1182	316	4	1178	103	1064	0	0	6	5
전라남도	무안군	삼향읍	삼향읍제3투	1450	1071	379	6	1065	102	957	0	0	4	2
전라남도	무안군	삼향읍	삼향읍제4투	1108	842	266	7	835	71	760	1	0	3	0
전라남도	무안군	삼향읍	삼향읍제5투	2398	2039	359	4	2035	140	1890	0	3	1	1
전라남도	무안군	삼향읍	삼향읍제6투	2669	2070	599	10	2060	121	1936	1	0	0	2
전라남도	무안군	삼향읍	삼향읍제7투	2040	1570	470	3	1567	100	1466	0	0	1	0
전라남도	무안군	삼향읍	삼향읍제8투	2810	2346	464	4	2342	203	2134	0	1	1	3
전라남도	무안군	삼향읍	삼향읍제9투	2514	2142	372	4	2138	160	1975	0	1	2	0
전라남도	무안군	몽탄면	소계	3287	2527	760	18	2509	208	2273	0	2	15	11
전라남도	무안군	몽탄면	몽탄면제1투	997	752	245	5	747	72	663	0	1	5	6
전라남도	무안군	몽탄면	몽탄면제2투	736	564	172	3	561	53	504	0	0	2	2
전라남도	무안군	몽탄면	몽탄면제3투	886	680	206	3	677	46	625	0	0	4	2
전라남도	무안군	몽탄면	몽탄면제4투	668	531	137	7	524	37	481	0	1	4	1
전라남도	무안군	청계면	소계	6005	4571	1434	30	4541	340	4173	2	1	16	9
전라남도	무안군	청계면	청계면제1투	846	631	215	5	626	44	574	0	1	5	2
전라남도	무안군	청계면	청계면제2투	1919	1394	525	7	1387	111	1270	1	0	2	3
전라남도	무안군	청계면	청계면제3투	1126	907	219	6	901	69	830	0	0	2	0
전라남도	무안군	청계면	청계면제4투	908	698	210	3	695	37	651	0	0	6	1
전라남도	무안군	청계면	청계면제5투	1206	941	265	9	932	79	848	1	0	1	3
전라남도	무안군	현경면	소계	4869	3633	1236	22	3611	374	3200	3	3	18	13
전라남도	무안군	현경면	현경면제1투	535	396	139	2	394	56	330	1	1	4	2
전라남도	무안군	현경면	현경면제2투	1583	1169	414	8	1161	109	1044	1	2	2	3
전라남도	무안군	현경면	현경면제3투	953	711	242	6	705	60	642	0	0	1	2
전라남도	무안군	현경면	현경면제4투	955	736	219	3	733	88	636	1	0	6	2
전라남도	무안군	현경면	현경면제5투	843	621	222	3	618	61	548	0	0	5	4
전라남도	무안군	망운면	소계	2077	1567	510	6	1561	183	1358	1	2	13	4
전라남도	무안군	망운면	망운면제1투	1499	1130	369	4	1126	137	977	1	2	8	1
전라남도	무안군	망운면	망운면제2투	578	437	141	2	435	46	381	0	0	5	3
전라남도	무안군	해제면	소계	5178	3862	1316	25	3837	406	3386	1	4	23	17
전라남도	무안군	해제면	해제면제1투	1357	1011	346	6	1005	83	902	1	4	9	6
전라남도	무안군	해제면	해제면제2투	1838	1402	436	8	1394	166	1223	0	0	3	2
전라남도	무안군	해제면	해제면제3투	815	603	212	3	600	51	541	0	0	6	2
전라남도	무안군	해제면	해제면제4투	1168	846	322	8	838	106	720	0	0	5	7
전라남도	무안군	운남면	소계	3052	2230	822	16	2214	232	1954	1	1	11	15
전라남도	무안군	운남면	운남면제1투	899	638	261	5	633	54	569	0	1	4	5
전라남도	무안군	운남면	운남면제2투	1612	1204	408	7	1197	139	1046	1	0	3	8
전라남도	무안군	운남면	운남면제3투	541	388	153	4	384	39	339	0	0	4	2
전라남도	영광군	계	계	47115	35294	11821	228	35066	3768	30835	23	23	297	120
전라남도	영광군	재외투표	재외투표	104	61	43	0	61	9	52	0	0	0	0
전라남도	영광군	국내부재자투표	국내부재자투표	2405	2163	242	27	2136	241	1881	4	2	5	3
전라남도	영광군	영광읍	소계	15688	11506	4182	41	11465	1278	10120	4	3	33	27
전라남도	영광군	영광읍	영광읍제1투	1900	1309	591	4	1305	158	1136	1	0	6	4
전라남도	영광군	영광읍	영광읍제2투	2441	1806	635	4	1802	215	1582	0	1	2	2
전라남도	영광군	영광읍	영광읍제3투	2388	1731	657	8	1723	197	1521	1	0	1	3
전라남도	영광군	영광읍	영광읍제4투	3126	2331	795	11	2320	271	2039	2	1	2	5
전라남도	영광군	영광읍	영광읍제5투	934	650	284	4	646	71	565	0	0	9	1
전라남도	영광군	영광읍	영광읍제6투	393	295	98	2	293	23	263	0	0	5	2
전라남도	영광군	영광읍	영광읍제7투	629	447	182	3	444	64	377	0	1	2	0
전라남도	영광군	영광읍	영광읍제8투	2571	1995	576	3	1992	186	1796	0	0	3	7
전라남도	영광군	영광읍	영광읍제9투	1306	942	364	2	940	93	841	0	0	3	3
전라남도	영광군	백수읍	소계	4580	3403	1177	31	3372	378	2933	2	6	37	16
전라남도	영광군	백수읍	백수읍제1투	924	653	271	2	651	83	561	2	0	5	0
전라남도	영광군	백수읍	백수읍제2투	1515	1102	413	4	1098	96	977	0	1	17	7
전라남도	영광군	백수읍	백수읍제3투	1200	901	299	14	887	113	753	0	3	11	7
전라남도	영광군	백수읍	백수읍제4투	941	747	194	11	736	86	642	0	2	4	2
전라남도	영광군	홍농읍	소계	5582	4235	1347	23	4212	371	3781	2	3	42	13
전라남도	영광군	홍농읍	홍농읍제1투	1517	1094	423	5	1089	105	970	0	1	11	2
전라남도	영광군	홍농읍	홍농읍제2투	552	416	136	1	415	49	361	0	2	1	2
전라남도	영광군	홍농읍	홍농읍제3투	647	517	130	3	514	46	451	0	0	14	3
전라남도	영광군	홍농읍	홍농읍제4투	972	686	286	6	680	58	615	2	0	4	1
전라남도	영광군	홍농읍	홍농읍제5투	1894	1522	372	8	1514	113	1384	0	0	12	5
전라남도	영광군	대마면	소계	1567	1194	373	11	1183	109	1051	2	1	11	9
전라남도	영광군	대마면	대마면제1투	1071	807	264	6	801	77	709	2	1	8	4
전라남도	영광군	대마면	대마면제2투	496	387	109	5	382	32	342	0	0	3	5
전라남도	영광군	묘량면	소계	1680	1315	365	12	1303	158	1118	0	0	22	5
전라남도	영광군	묘량면	묘량면제1투	1026	820	206	8	812	104	696	0	0	10	2
전라남도	영광군	묘량면	묘량면제2투	654	495	159	4	491	54	422	0	0	12	3
전라남도	영광군	불갑면	소계	1225	984	241	10	974	96	857	0	1	15	5
전라남도	영광군	불갑면	불갑면제1투	818	647	171	8	639	65	561	0	0	10	3
전라남도	영광군	불갑면	불갑면제2투	407	337	70	2	335	31	296	0	1	5	2
전라남도	영광군	군서면	소계	2130	1654	476	10	1644	160	1458	2	1	17	6
전라남도	영광군	군서면	군서면제1투	1106	866	240	8	858	80	765	1	1	7	4
전라남도	영광군	군서면	군서면제2투	1024	788	236	2	786	80	693	1	0	10	2
전라남도	영광군	군남면	소계	2420	1870	550	18	1852	198	1612	1	1	28	12
전라남도	영광군	군남면	군남면제1투	1151	858	293	7	851	77	757	0	0	11	6
전라남도	영광군	군남면	군남면제2투	488	386	102	4	382	42	333	0	1	4	2
전라남도	영광군	군남면	군남면제3투	781	626	155	7	619	79	522	1	0	13	4
전라남도	영광군	염산면	소계	4044	2947	1097	25	2922	325	2544	3	2	37	11
전라남도	영광군	염산면	염산면제1투	1687	1222	465	11	1211	136	1054	3	2	11	5
전라남도	영광군	염산면	염산면제2투	882	626	256	4	622	56	553	0	0	10	3
전라남도	영광군	염산면	염산면제3투	694	507	187	5	502	63	426	0	0	11	2
전라남도	영광군	염산면	염산면제4투	781	592	189	5	587	70	511	0	0	5	1
전라남도	영광군	법성면	소계	5187	3704	1483	18	3686	395	3232	2	3	43	11
전라남도	영광군	법성면	법성면제1투	2369	1641	728	9	1632	169	1445	1	2	13	2
전라남도	영광군	법성면	법성면제2투	724	510	214	2	508	56	448	0	0	3	1
전라남도	영광군	법성면	법성면제3투	633	472	161	2	470	50	414	0	0	3	3
전라남도	영광군	법성면	법성면제4투	902	648	254	3	645	75	555	0	1	12	2
전라남도	영광군	법성면	법성면제5투	559	433	126	2	431	45	370	1	0	12	3
전라남도	영광군	낙월면	소계	503	258	245	2	256	50	196	1	0	7	2
전라남도	영광군	낙월면	낙월면제1투	254	110	144	1	109	27	81	0	0	1	0
전라남도	영광군	낙월면	낙월면제2투	83	56	27	0	56	2	53	0	0	0	1
전라남도	영광군	낙월면	낙월면제3투	166	92	74	1	91	21	62	1	0	6	1
전라남도	함평군	계	계	30688	23428	7260	213	23215	1958	20984	19	21	145	88
전라남도	함평군	재외투표	재외투표	99	77	22	1	76	26	50	0	0	0	0
전라남도	함평군	국내부재자투표	국내부재자투표	1280	1164	116	25	1139	146	975	3	1	9	5
전라남도	함평군	함평읍	소계	7041	5303	1738	39	5264	517	4705	2	3	23	14
전라남도	함평군	함평읍	함평읍제1투	1379	1006	373	8	998	121	872	0	1	3	1
전라남도	함평군	함평읍	함평읍제2투	1469	1082	387	8	1074	120	936	2	1	7	8
전라남도	함평군	함평읍	함평읍제3투	753	552	201	8	544	45	488	0	1	9	1
전라남도	함평군	함평읍	함평읍제4투	2386	1891	495	10	1881	169	1710	0	0	0	2
전라남도	함평군	함평읍	함평읍제5투	1054	772	282	5	767	62	699	0	0	4	2
전라남도	함평군	손불면	소계	3346	2462	884	16	2446	160	2251	3	5	17	10
전라남도	함평군	손불면	손불면제1투	2122	1565	557	9	1556	104	1436	3	3	5	5
전라남도	함평군	손불면	손불면제2투	1224	897	327	7	890	56	815	0	2	12	5
전라남도	함평군	신광면	소계	1737	1297	440	13	1284	98	1165	0	1	14	6
전라남도	함평군	신광면	신광면제1투	1349	992	357	13	979	74	889	0	1	11	4
전라남도	함평군	신광면	신광면제2투	388	305	83	0	305	24	276	0	0	3	2
전라남도	함평군	학교면	소계	3745	2762	983	26	2736	240	2461	2	0	18	15
전라남도	함평군	학교면	학교면제1투	1105	769	336	8	761	62	686	1	0	7	5
전라남도	함평군	학교면	학교면제2투	557	433	124	8	425	51	373	0	0	0	1
전라남도	함평군	학교면	학교면제3투	314	238	76	3	235	21	205	1	0	3	5
전라남도	함평군	학교면	학교면제4투	1769	1322	447	7	1315	106	1197	0	0	8	4
전라남도	함평군	엄다면	소계	1871	1492	379	13	1479	131	1333	1	3	5	6
전라남도	함평군	엄다면	엄다면투표소	1871	1492	379	13	1479	131	1333	1	3	5	6
전라남도	함평군	대동면	소계	2617	2011	606	12	1999	170	1798	3	1	15	12
전라남도	함평군	대동면	대동면제1투	1602	1207	395	4	1203	99	1088	2	0	8	6
전라남도	함평군	대동면	대동면제2투	1015	804	211	8	796	71	710	1	1	7	6
전라남도	함평군	나산면	소계	2688	2014	674	20	1994	167	1798	2	5	17	5
전라남도	함평군	나산면	나산면제1투	2090	1545	545	18	1527	141	1363	2	4	14	3
전라남도	함평군	나산면	나산면제2투	598	469	129	2	467	26	435	0	1	3	2
전라남도	함평군	해보면	소계	2641	2037	604	18	2019	127	1876	1	0	11	4
전라남도	함평군	해보면	해보면제1투	1408	1065	343	8	1057	70	977	0	0	8	2
전라남도	함평군	해보면	해보면제2투	1233	972	261	10	962	57	899	1	0	3	2
전라남도	함평군	월야면	소계	3623	2809	814	30	2779	176	2572	2	2	16	11
전라남도	함평군	월야면	월야면제1투	1782	1348	434	10	1338	76	1249	1	2	8	2
전라남도	함평군	월야면	월야면제2투	565	450	115	8	442	32	400	1	0	4	5
전라남도	함평군	월야면	월야면제3투	1276	1011	265	12	999	68	923	0	0	4	4
전라남도	신안군	계	계	38661	26961	11700	295	26666	2950	23345	28	41	197	105
전라남도	신안군	재외투표	재외투표	112	78	34	0	78	23	53	0	2	0	0
전라남도	신안군	국내부재자투표	국내부재자투표	2417	2129	288	26	2103	212	1881	2	4	1	3
전라남도	신안군	지도읍	소계	4224	3014	1210	34	2980	265	2671	3	2	27	12
전라남도	신안군	지도읍	지도읍제1투	2319	1641	678	16	1625	143	1463	2	1	11	5
전라남도	신안군	지도읍	지도읍제2투	116	77	39	1	76	8	68	0	0	0	0
전라남도	신안군	지도읍	지도읍제3투	761	560	201	7	553	42	500	1	1	8	1
전라남도	신안군	지도읍	지도읍제4투	786	572	214	8	564	50	503	0	0	7	4
전라남도	신안군	지도읍	지도읍제5투	242	164	78	2	162	22	137	0	0	1	2
전라남도	신안군	압해읍	소계	5524	4061	1463	29	4032	466	3529	7	4	15	11
전라남도	신안군	압해읍	압해읍제1투	1447	1039	408	7	1032	132	888	3	1	6	2
전라남도	신안군	압해읍	압해읍제2투	917	698	219	2	696	107	583	1	0	3	2
전라남도	신안군	압해읍	압해읍제3투	1279	964	315	5	959	99	851	1	1	4	3
전라남도	신안군	압해읍	압해읍제4투	1400	1055	345	8	1047	102	936	1	2	2	4
전라남도	신안군	압해읍	압해읍제5투	232	155	77	2	153	16	137	0	0	0	0
전라남도	신안군	압해읍	압해읍제6투	249	150	99	5	145	10	134	1	0	0	0
전라남도	신안군	증도면	소계	1753	1198	555	7	1191	117	1056	1	2	9	6
전라남도	신안군	증도면	증도면제1투	756	489	267	2	487	54	425	1	1	3	3
전라남도	신안군	증도면	증도면제2투	677	501	176	4	497	46	443	0	1	4	3
전라남도	신안군	증도면	증도면제3투	320	208	112	1	207	17	188	0	0	2	0
전라남도	신안군	임자면	소계	2864	1953	911	22	1931	160	1743	1	3	14	10
전라남도	신안군	임자면	임자면제1투	1868	1317	551	11	1306	107	1184	1	2	6	6
전라남도	신안군	임자면	임자면제2투	503	336	167	8	328	38	284	0	1	3	2
전라남도	신안군	임자면	임자면제3투	137	64	73	0	64	1	61	0	0	0	2
전라남도	신안군	임자면	임자면제4투	356	236	120	3	233	14	214	0	0	5	0
전라남도	신안군	자은면	소계	2051	1408	643	16	1392	125	1257	1	1	7	1
전라남도	신안군	자은면	자은면제1투	1503	1011	492	12	999	105	888	0	1	4	1
전라남도	신안군	자은면	자은면제2투	548	397	151	4	393	20	369	1	0	3	0
전라남도	신안군	비금면	소계	3225	2266	959	20	2246	217	1996	1	4	18	10
전라남도	신안군	비금면	비금면제1투	1529	1064	465	9	1055	100	941	1	1	8	4
전라남도	신안군	비금면	비금면제2투	812	598	214	3	595	57	526	0	2	7	3
전라남도	신안군	비금면	비금면제3투	767	529	238	8	521	56	460	0	1	3	1
전라남도	신안군	비금면	비금면제4투	117	75	42	0	75	4	69	0	0	0	2
전라남도	신안군	도초면	소계	2472	1700	772	30	1670	196	1455	2	3	8	6
전라남도	신안군	도초면	도초면제1투	1561	1099	462	23	1076	119	946	0	2	5	4
전라남도	신안군	도초면	도초면제2투	728	503	225	6	497	57	432	2	1	3	2
전라남도	신안군	도초면	도초면제3투	183	98	85	1	97	20	77	0	0	0	0
전라남도	신안군	흑산면	소계	3494	1971	1523	23	1948	234	1683	0	5	17	9
전라남도	신안군	흑산면	흑산면제1투	1575	911	664	9	902	141	750	0	2	5	4
전라남도	신안군	흑산면	흑산면제2투	216	142	74	2	140	11	121	0	2	6	0
전라남도	신안군	흑산면	흑산면제3투	333	178	155	2	176	16	159	0	1	0	0
전라남도	신안군	흑산면	흑산면제4투	234	148	86	2	146	11	131	0	0	2	2
전라남도	신안군	흑산면	흑산면제5투	389	224	165	2	222	12	209	0	0	1	0
전라남도	신안군	흑산면	흑산면제6투	196	69	127	0	69	1	67	0	0	1	0
전라남도	신안군	흑산면	흑산면제7투	414	229	185	4	225	31	190	0	0	1	3
전라남도	신안군	흑산면	흑산면제8투	66	35	31	0	35	8	26	0	0	1	0
전라남도	신안군	흑산면	흑산면제9투	71	35	36	2	33	3	30	0	0	0	0
전라남도	신안군	하의면	소계	1662	1071	591	12	1059	91	942	3	2	17	4
전라남도	신안군	하의면	하의면제1투	869	559	310	8	551	49	490	1	1	8	2
전라남도	신안군	하의면	하의면제2투	690	442	248	3	439	39	388	1	0	9	2
전라남도	신안군	하의면	하의면제3투	103	70	33	1	69	3	64	1	1	0	0
전라남도	신안군	신의면	소계	1487	982	505	10	972	152	809	1	1	5	4
전라남도	신안군	신의면	신의면투표소	1487	982	505	10	972	152	809	1	1	5	4
전라남도	신안군	장산면	소계	1490	1032	458	15	1017	163	832	1	3	12	6
전라남도	신안군	장산면	장산면제1투	906	644	262	9	635	80	537	0	3	10	5
전라남도	신안군	장산면	장산면제2투	584	388	196	6	382	83	295	1	0	2	1
전라남도	신안군	안좌면	소계	2975	2027	948	27	2000	313	1642	2	2	30	11
전라남도	신안군	안좌면	안좌면제1투	1437	975	462	14	961	141	801	1	2	11	5
전라남도	신안군	안좌면	안좌면제2투	280	185	95	2	183	11	171	0	0	0	1
전라남도	신안군	안좌면	안좌면제3투	754	536	218	4	532	102	414	1	0	12	3
전라남도	신안군	안좌면	안좌면제4투	504	331	173	7	324	59	256	0	0	7	2
전라남도	신안군	팔금면	소계	1046	757	289	14	743	85	642	3	2	8	3
전라남도	신안군	팔금면	팔금면투표소	1046	757	289	14	743	85	642	3	2	8	3
전라남도	신안군	암태면	소계	1865	1314	551	10	1304	131	1154	0	1	9	9
전라남도	신안군	암태면	암태면제1투	1300	913	387	8	905	98	793	0	1	7	6
전라남도	신안군	암태면	암태면제2투	409	288	121	1	287	25	257	0	0	2	3
전라남도	신안군	암태면	암태면제3투	156	113	43	1	112	8	104	0	0	0	0
경상북도	포항시북구	계	계	211828	166166	45662	568	165598	131547	33470	48	54	177	302
경상북도	포항시북구	재외투표	재외투표	745	497	248	2	495	243	249	1	1	0	1
경상북도	포항시북구	국내부재자투표	국내부재자투표	8170	7371	799	148	7223	4642	2538	6	7	12	18
경상북도	포항시북구	흥해읍	소계	27428	21244	6184	72	21172	17629	3443	9	4	30	57
경상북도	포항시북구	흥해읍	흥해읍제1투	2391	1659	732	4	1655	1417	230	1	0	3	4
경상북도	포항시북구	흥해읍	흥해읍제2투	1969	1563	406	3	1560	1279	275	0	0	4	2
경상북도	포항시북구	흥해읍	흥해읍제3투	1537	1215	322	6	1209	1082	120	1	0	2	4
경상북도	포항시북구	흥해읍	흥해읍제4투	2068	1624	444	22	1602	1444	139	1	1	3	14
경상북도	포항시북구	흥해읍	흥해읍제5투	1708	1319	389	4	1315	1058	245	2	1	4	5
경상북도	포항시북구	흥해읍	흥해읍제6투	2218	1700	518	6	1694	1418	272	0	0	1	3
경상북도	포항시북구	흥해읍	흥해읍제7투	2390	1844	546	2	1842	1612	224	1	1	0	4
경상북도	포항시북구	흥해읍	흥해읍제8투	1331	971	360	9	962	864	89	0	0	2	7
경상북도	포항시북구	흥해읍	흥해읍제9투	2454	1871	583	2	1869	1470	393	1	0	2	3
경상북도	포항시북구	흥해읍	흥해읍제10투	4269	3414	855	3	3411	2669	735	1	0	3	3
경상북도	포항시북구	흥해읍	흥해읍제11투	2756	2178	578	6	2172	1833	330	1	1	5	2
경상북도	포항시북구	흥해읍	흥해읍제12투	2337	1886	451	5	1881	1483	391	0	0	1	6
경상북도	포항시북구	신광면	소계	2718	2203	515	26	2177	1938	213	3	0	4	19
경상북도	포항시북구	신광면	신광면제1투	1332	1069	263	9	1060	926	119	2	0	4	9
경상북도	포항시북구	신광면	신광면제2투	577	464	113	12	452	397	50	0	0	0	5
경상북도	포항시북구	신광면	신광면제3투	809	670	139	5	665	615	44	1	0	0	5
경상북도	포항시북구	청하면	소계	4772	3684	1088	26	3658	3171	456	3	3	6	19
경상북도	포항시북구	청하면	청하면제1투	2572	1961	611	13	1948	1653	282	0	2	2	9
경상북도	포항시북구	청하면	청하면제2투	1522	1202	320	12	1190	1074	104	1	1	1	9
경상북도	포항시북구	청하면	청하면제3투	678	521	157	1	520	444	70	2	0	3	1
경상북도	포항시북구	송라면	소계	2573	2012	561	15	1997	1772	205	0	4	1	15
경상북도	포항시북구	송라면	송라면투표소	2573	2012	561	15	1997	1772	205	0	4	1	15
경상북도	포항시북구	기계면	소계	4808	3826	982	29	3797	3313	438	4	2	4	36
경상북도	포항시북구	기계면	기계면제1투	3112	2501	611	13	2488	2180	281	3	1	3	20
경상북도	포항시북구	기계면	기계면제2투	992	762	230	10	752	645	102	1	1	1	2
경상북도	포항시북구	기계면	기계면제3투	704	563	141	6	557	488	55	0	0	0	14
경상북도	포항시북구	죽장면	소계	2556	2034	522	15	2019	1773	221	0	0	6	19
경상북도	포항시북구	죽장면	죽장면제1투	1995	1581	414	12	1569	1402	145	0	0	3	19
경상북도	포항시북구	죽장면	죽장면제2투	561	453	108	3	450	371	76	0	0	3	0
경상북도	포항시북구	기북면	소계	1184	957	227	9	948	840	89	0	2	2	15
경상북도	포항시북구	기북면	기북면투표소	1184	957	227	9	948	840	89	0	2	2	15
경상북도	포항시북구	중앙동	소계	15812	11720	4092	24	11696	9887	1786	5	2	7	9
경상북도	포항시북구	중앙동	중앙동제1투	1858	1294	564	4	1290	1144	144	1	0	1	0
경상북도	포항시북구	중앙동	중앙동제2투	1214	894	320	1	893	791	101	0	0	0	1
경상북도	포항시북구	중앙동	중앙동제3투	2049	1514	535	5	1509	1268	235	3	0	2	1
경상북도	포항시북구	중앙동	중앙동제4투	2863	1988	875	3	1985	1615	365	1	0	3	1
경상북도	포항시북구	중앙동	중앙동제5투	3230	2399	831	6	2393	2025	363	0	2	0	3
경상북도	포항시북구	중앙동	중앙동제6투	1620	1212	408	1	1211	1057	153	0	0	1	0
경상북도	포항시북구	중앙동	중앙동제7투	2978	2419	559	4	2415	1987	425	0	0	0	3
경상북도	포항시북구	양학동	소계	14597	11692	2905	22	11670	8876	2767	1	1	12	13
경상북도	포항시북구	양학동	양학동제1투	3002	2286	716	4	2282	1783	493	1	1	3	1
경상북도	포항시북구	양학동	양학동제2투	4156	3296	860	6	3290	2545	741	0	0	1	3
경상북도	포항시북구	양학동	양학동제3투	4299	3501	798	6	3495	2512	970	0	0	7	6
경상북도	포항시북구	양학동	양학동제4투	3140	2609	531	6	2603	2036	563	0	0	1	3
경상북도	포항시북구	죽도동	소계	19006	14021	4985	30	13991	11829	2130	3	3	9	17
경상북도	포항시북구	죽도동	죽도동제1투	3077	2339	738	7	2332	2041	286	0	0	0	5
경상북도	포항시북구	죽도동	죽도동제2투	4878	3322	1556	10	3312	2809	496	0	0	3	4
경상북도	포항시북구	죽도동	죽도동제3투	4018	3121	897	4	3117	2615	494	1	1	1	5
경상북도	포항시북구	죽도동	죽도동제4투	2981	2316	665	3	2313	1924	384	1	0	3	1
경상북도	포항시북구	죽도동	죽도동제5투	4052	2923	1129	6	2917	2440	470	1	2	2	2
경상북도	포항시북구	용흥동	소계	19886	15685	4201	35	15650	12567	3047	3	2	15	16
경상북도	포항시북구	용흥동	용흥동제1투	3296	2599	697	6	2593	2093	495	0	0	1	4
경상북도	포항시북구	용흥동	용흥동제2투	3205	2454	751	8	2446	2018	421	0	0	3	4
경상북도	포항시북구	용흥동	용흥동제3투	2649	2143	506	3	2140	1784	352	1	0	0	3
경상북도	포항시북구	용흥동	용흥동제4투	2568	2132	436	4	2128	1655	466	0	1	3	3
경상북도	포항시북구	용흥동	용흥동제5투	3290	2689	601	3	2686	2058	625	1	1	1	0
경상북도	포항시북구	용흥동	용흥동제6투	2862	2276	586	6	2270	1751	512	1	0	4	2
경상북도	포항시북구	용흥동	용흥동제7투	2016	1392	624	5	1387	1208	176	0	0	3	0
경상북도	포항시북구	우창동	소계	21034	16359	4675	31	16328	12758	3533	2	5	14	16
경상북도	포항시북구	우창동	우창동제1투	3515	2773	742	0	2773	2166	597	0	1	4	5
경상북도	포항시북구	우창동	우창동제2투	2805	2231	574	6	2225	1830	392	0	0	2	1
경상북도	포항시북구	우창동	우창동제3투	3344	2737	607	3	2734	2064	666	1	0	3	0
경상북도	포항시북구	우창동	우창동제4투	2876	2197	679	1	2196	1699	489	0	2	2	4
경상북도	포항시북구	우창동	우창동제5투	2219	1719	500	5	1714	1386	326	0	1	1	0
경상북도	포항시북구	우창동	우창동제6투	2792	1993	799	8	1985	1588	391	1	1	1	3
경상북도	포항시북구	우창동	우창동제7투	3483	2709	774	8	2701	2025	672	0	0	1	3
경상북도	포항시북구	두호동	소계	19230	15374	3856	15	15359	12182	3137	2	4	17	17
경상북도	포항시북구	두호동	두호동제1투	1911	1360	551	3	1357	1166	185	1	0	1	4
경상북도	포항시북구	두호동	두호동제2투	2945	2335	610	2	2333	1862	466	1	1	2	1
경상북도	포항시북구	두호동	두호동제3투	3420	2787	633	1	2786	2242	537	0	2	3	2
경상북도	포항시북구	두호동	두호동제4투	3846	3182	664	4	3178	2458	707	0	0	7	6
경상북도	포항시북구	두호동	두호동제5투	3432	2683	749	2	2681	2184	493	0	0	1	3
경상북도	포항시북구	두호동	두호동제6투	3676	3027	649	3	3024	2270	749	0	1	3	1
경상북도	포항시북구	장량동	소계	38855	30665	8190	51	30614	22907	7650	3	9	32	13
경상북도	포항시북구	장량동	장량동제1투	2934	2283	651	3	2280	1759	518	0	0	1	2
경상북도	포항시북구	장량동	장량동제2투	3492	2809	683	5	2804	2269	530	0	1	3	1
경상북도	포항시북구	장량동	장량동제3투	2978	2369	609	6	2363	1777	582	0	1	3	0
경상북도	포항시북구	장량동	장량동제4투	3777	3094	683	2	3092	2327	757	0	0	5	3
경상북도	포항시북구	장량동	장량동제5투	5512	4269	1243	4	4265	3222	1040	1	0	1	1
경상북도	포항시북구	장량동	장량동제6투	6309	4630	1679	13	4617	3574	1035	1	2	3	2
경상북도	포항시북구	장량동	장량동제7투	3987	3153	834	8	3145	2234	904	1	2	3	1
경상북도	포항시북구	장량동	장량동제8투	4483	3668	815	4	3664	2654	1000	0	0	8	2
경상북도	포항시북구	장량동	장량동제9투	5383	4390	993	6	4384	3091	1284	0	3	5	1
경상북도	포항시북구	환여동	소계	8454	6822	1632	18	6804	5220	1568	3	5	6	2
경상북도	포항시북구	환여동	환여동제1투	1357	1058	299	6	1052	891	156	2	2	1	0
경상북도	포항시북구	환여동	환여동제2투	1735	1316	419	4	1312	1102	208	0	0	0	2
경상북도	포항시북구	환여동	환여동제3투	3926	3274	652	8	3266	2365	896	1	0	4	0
경상북도	포항시북구	환여동	환여동제4투	1436	1174	262	0	1174	862	308	0	3	1	0
경상북도	포항시남구	계	계	200720	155131	45589	531	154600	121186	32833	43	52	193	293
경상북도	포항시남구	재외투표	재외투표	764	509	255	1	508	259	248	0	0	1	0
경상북도	포항시남구	국내부재자투표	국내부재자투표	7215	6510	705	81	6429	4046	2337	10	10	7	19
경상북도	포항시남구	구룡포읍	소계	8700	6142	2558	45	6097	5479	572	3	2	5	36
경상북도	포항시남구	구룡포읍	구룡포읍제1투	3710	2592	1118	11	2581	2311	262	2	1	0	5
경상북도	포항시남구	구룡포읍	구룡포읍제2투	1927	1412	515	19	1393	1277	110	0	0	1	5
경상북도	포항시남구	구룡포읍	구룡포읍제3투	1114	837	277	11	826	745	61	0	0	1	19
경상북도	포항시남구	구룡포읍	구룡포읍제4투	1949	1301	648	4	1297	1146	139	1	1	3	7
경상북도	포항시남구	연일읍	소계	25414	20297	5117	52	20245	15794	4394	4	3	24	26
경상북도	포항시남구	연일읍	연일읍제1투	2714	2002	712	6	1996	1636	350	0	1	6	3
경상북도	포항시남구	연일읍	연일읍제2투	3475	2715	760	11	2704	2199	500	0	0	3	2
경상북도	포항시남구	연일읍	연일읍제3투	2325	1828	497	5	1823	1485	332	0	0	3	3
경상북도	포항시남구	연일읍	연일읍제4투	3883	3035	848	7	3028	2402	619	2	0	1	4
경상북도	포항시남구	연일읍	연일읍제5투	3340	2691	649	8	2683	2063	614	0	0	2	4
경상북도	포항시남구	연일읍	연일읍제6투	3487	2954	533	5	2949	2147	797	0	1	4	0
경상북도	포항시남구	연일읍	연일읍제7투	3766	3169	597	6	3163	2213	943	0	1	4	2
경상북도	포항시남구	연일읍	연일읍제8투	856	674	182	2	672	585	82	1	0	0	4
경상북도	포항시남구	연일읍	연일읍제9투	1568	1229	339	2	1227	1064	157	1	0	1	4
경상북도	포항시남구	오천읍	소계	36361	27061	9300	64	26997	20792	6124	9	6	28	38
경상북도	포항시남구	오천읍	오천읍제1투	3237	2412	825	3	2409	1840	565	1	0	2	1
경상북도	포항시남구	오천읍	오천읍제2투	2303	1763	540	8	1755	1448	301	0	0	2	4
경상북도	포항시남구	오천읍	오천읍제3투	1755	1374	381	2	1372	1129	238	0	0	1	4
경상북도	포항시남구	오천읍	오천읍제4투	1661	1254	407	4	1250	961	287	1	0	0	1
경상북도	포항시남구	오천읍	오천읍제5투	3002	2284	718	5	2279	1868	404	0	0	4	3
경상북도	포항시남구	오천읍	오천읍제6투	1578	1245	333	4	1241	962	273	1	1	2	2
경상북도	포항시남구	오천읍	오천읍제7투	3190	2460	730	7	2453	1974	470	0	1	4	4
경상북도	포항시남구	오천읍	오천읍제8투	2635	2038	597	2	2036	1580	452	0	1	1	2
경상북도	포항시남구	오천읍	오천읍제9투	3970	2707	1263	4	2703	1955	736	2	0	5	5
경상북도	포항시남구	오천읍	오천읍제10투	3916	3076	840	3	3073	2116	949	2	1	3	2
경상북도	포항시남구	오천읍	오천읍제11투	2263	1612	651	1	1611	1172	436	1	1	1	0
경상북도	포항시남구	오천읍	오천읍제12투	2225	1484	741	8	1476	1171	300	0	0	3	2
경상북도	포항시남구	오천읍	오천읍제13투	1726	1307	419	8	1299	1044	247	0	1	0	7
경상북도	포항시남구	오천읍	오천읍제14투	2900	2045	855	5	2040	1572	466	1	0	0	1
경상북도	포항시남구	대송면	소계	4323	3365	958	12	3353	2826	507	2	2	4	12
경상북도	포항시남구	대송면	대송면제1투	1559	1229	330	8	1221	1041	167	1	1	2	9
경상북도	포항시남구	대송면	대송면제2투	1585	1244	341	2	1242	1046	192	1	1	0	2
경상북도	포항시남구	대송면	대송면제3투	1179	892	287	2	890	739	148	0	0	2	1
경상북도	포항시남구	동해면	소계	9154	6926	2228	27	6899	5627	1222	5	6	10	29
경상북도	포항시남구	동해면	동해면제1투	2771	2056	715	6	2050	1606	432	1	0	3	8
경상북도	포항시남구	동해면	동해면제2투	677	527	150	4	523	470	45	0	1	0	7
경상북도	포항시남구	동해면	동해면제3투	907	651	256	0	651	528	120	1	0	0	2
경상북도	포항시남구	동해면	동해면제4투	2918	2231	687	3	2228	1807	408	2	3	3	5
경상북도	포항시남구	동해면	동해면제5투	1881	1461	420	14	1447	1216	217	1	2	4	7
경상북도	포항시남구	장기면	소계	4691	3564	1127	53	3511	3093	376	0	0	4	38
경상북도	포항시남구	장기면	장기면제1투	1641	1236	405	19	1217	1058	147	0	0	0	12
경상북도	포항시남구	장기면	장기면제2투	1678	1262	416	12	1250	1128	114	0	0	0	8
경상북도	포항시남구	장기면	장기면제3투	1372	1066	306	22	1044	907	115	0	0	4	18
경상북도	포항시남구	호미곶면	소계	2143	1640	503	14	1626	1507	104	0	1	1	13
경상북도	포항시남구	호미곶면	호미곶면투표소	2143	1640	503	14	1626	1507	104	0	1	1	13
경상북도	포항시남구	상대동	소계	23419	17599	5820	35	17564	14610	2921	1	4	15	13
경상북도	포항시남구	상대동	상대동제1투	3441	2459	982	9	2450	2014	433	0	1	2	0
경상북도	포항시남구	상대동	상대동제2투	3478	2587	891	3	2584	2130	446	0	1	3	4
경상북도	포항시남구	상대동	상대동제3투	2949	2255	694	5	2250	1852	394	0	1	1	2
경상북도	포항시남구	상대동	상대동제4투	2115	1590	525	4	1586	1309	271	1	0	4	1
경상북도	포항시남구	상대동	상대동제5투	2370	1805	565	3	1802	1503	298	0	0	1	0
경상북도	포항시남구	상대동	상대동제6투	2812	2126	686	4	2122	1773	344	0	0	1	4
경상북도	포항시남구	상대동	상대동제7투	2637	2020	617	6	2014	1680	331	0	0	2	1
경상북도	포항시남구	상대동	상대동제8투	3617	2757	860	1	2756	2349	404	0	1	1	1
경상북도	포항시남구	해도동	소계	18793	13736	5057	28	13708	11606	2073	1	2	12	14
경상북도	포항시남구	해도동	해도동제1투	2868	1996	872	3	1993	1659	327	0	2	0	5
경상북도	포항시남구	해도동	해도동제2투	1909	1383	526	6	1377	1215	161	0	0	0	1
경상북도	포항시남구	해도동	해도동제3투	2497	1870	627	4	1866	1597	266	0	0	1	2
경상북도	포항시남구	해도동	해도동제4투	2205	1670	535	4	1666	1444	219	0	0	1	2
경상북도	포항시남구	해도동	해도동제5투	1607	1166	441	4	1162	1009	151	0	0	1	1
경상북도	포항시남구	해도동	해도동제6투	1779	1292	487	1	1291	1093	193	1	0	3	1
경상북도	포항시남구	해도동	해도동제7투	1794	1330	464	1	1329	1086	238	0	0	3	2
경상북도	포항시남구	해도동	해도동제8투	1913	1420	493	2	1418	1157	258	0	0	3	0
경상북도	포항시남구	해도동	해도동제9투	2221	1609	612	3	1606	1346	260	0	0	0	0
경상북도	포항시남구	송도동	소계	14750	11187	3563	33	11154	9725	1399	3	2	11	14
경상북도	포항시남구	송도동	송도동제1투	2558	1868	690	5	1863	1645	214	0	0	1	3
경상북도	포항시남구	송도동	송도동제2투	2718	2040	678	10	2030	1747	275	2	0	4	2
경상북도	포항시남구	송도동	송도동제3투	2515	1921	594	7	1914	1669	242	0	0	1	2
경상북도	포항시남구	송도동	송도동제4투	2068	1647	421	1	1646	1433	208	0	1	1	3
경상북도	포항시남구	송도동	송도동제5투	2532	1946	586	4	1942	1701	231	1	1	4	4
경상북도	포항시남구	송도동	송도동제6투	2359	1765	594	6	1759	1530	229	0	0	0	0
경상북도	포항시남구	청림동	소계	5459	4157	1302	20	4137	3297	817	1	1	8	13
경상북도	포항시남구	청림동	청림동제1투	1578	1180	398	4	1176	876	292	0	0	3	5
경상북도	포항시남구	청림동	청림동제2투	2709	2070	639	9	2061	1687	367	1	0	2	4
경상북도	포항시남구	청림동	청림동제3투	1172	907	265	7	900	734	158	0	1	3	4
경상북도	포항시남구	제철동	소계	2693	2172	521	7	2165	1572	591	0	0	0	2
경상북도	포항시남구	제철동	제철동투표소	2693	2172	521	7	2165	1572	591	0	0	0	2
경상북도	포항시남구	효곡동	소계	21719	18067	3652	35	18032	12038	5920	4	9	43	18
경상북도	포항시남구	효곡동	효곡동제1투	2821	2281	540	6	2275	1660	605	2	1	3	4
경상북도	포항시남구	효곡동	효곡동제2투	3442	2823	619	6	2817	1640	1167	0	1	6	3
경상북도	포항시남구	효곡동	효곡동제3투	3445	2932	513	5	2927	1952	962	0	2	8	3
경상북도	포항시남구	효곡동	효곡동제4투	3549	2995	554	5	2990	2005	973	1	2	6	3
경상북도	포항시남구	효곡동	효곡동제5투	3186	2681	505	6	2675	1813	848	0	0	12	2
경상북도	포항시남구	효곡동	효곡동제6투	2447	2073	374	4	2069	1364	697	1	0	4	3
경상북도	포항시남구	효곡동	효곡동제7투	2829	2282	547	3	2279	1604	668	0	3	4	0
경상북도	포항시남구	대이동	소계	15122	12199	2923	24	12175	8915	3228	0	4	20	8
경상북도	포항시남구	대이동	대이동제1투	1754	1389	365	4	1385	945	436	0	0	3	1
경상북도	포항시남구	대이동	대이동제2투	2707	2241	466	6	2235	1607	623	0	2	3	0
경상북도	포항시남구	대이동	대이동제3투	2062	1648	414	5	1643	1207	429	0	1	4	2
경상북도	포항시남구	대이동	대이동제4투	1333	928	405	1	927	750	175	0	0	1	1
경상북도	포항시남구	대이동	대이동제5투	3639	3000	639	5	2995	2217	774	0	1	3	0
경상북도	포항시남구	대이동	대이동제6투	3627	2993	634	3	2990	2189	791	0	0	6	4
경상북도	울릉군	계	계	9468	6309	3159	37	6272	5033	1207	2	2	7	21
경상북도	울릉군	재외투표	재외투표	17	9	8	1	8	4	4	0	0	0	0
경상북도	울릉군	국내부재자투표	국내부재자투표	1045	915	130	19	896	625	266	0	1	2	2
경상북도	울릉군	울릉읍	소계	5872	3683	2189	11	3672	3004	658	1	1	2	6
경상북도	울릉군	울릉읍	울릉읍제1투	2410	1483	927	5	1478	1166	307	0	1	2	2
경상북도	울릉군	울릉읍	울릉읍제2투	2890	1848	1042	6	1842	1552	286	1	0	0	3
경상북도	울릉군	울릉읍	울릉읍제3투	572	352	220	0	352	286	65	0	0	0	1
경상북도	울릉군	서면	소계	1331	892	439	0	892	746	139	0	0	2	5
경상북도	울릉군	서면	서면제1투	860	602	258	0	602	498	100	0	0	2	2
경상북도	울릉군	서면	서면제2투	471	290	181	0	290	248	39	0	0	0	3
경상북도	울릉군	북면	소계	1203	810	393	6	804	654	140	1	0	1	8
경상북도	울릉군	북면	북면제1투	802	536	266	6	530	423	102	1	0	1	3
경상북도	울릉군	북면	북면제2투	401	274	127	0	274	231	38	0	0	0	5
경상북도	울릉군	잘못 투입·구분된 투표지	잘못 투입·구분된 투표지	0	0	0	0	0	0	0	0	0	0	0
경상북도	경주시	계	계	214748	168542	46206	783	167759	132579	34357	59	99	230	435
경상북도	경주시	재외투표	재외투표	957	641	316	3	638	384	251	1	0	1	1
경상북도	경주시	국내부재자투표	국내부재자투표	7267	6634	633	120	6514	4241	2206	15	12	20	20
경상북도	경주시	감포읍	소계	5619	3998	1621	35	3963	3480	447	1	2	2	31
경상북도	경주시	감포읍	감포읍제1투	2626	1804	822	11	1793	1567	215	0	0	1	10
경상북도	경주시	감포읍	감포읍제2투	956	696	260	2	694	605	79	1	0	0	9
경상북도	경주시	감포읍	감포읍제3투	2037	1498	539	22	1476	1308	153	0	2	1	12
경상북도	경주시	안강읍	소계	23838	18227	5611	77	18150	14859	3203	4	10	26	48
경상북도	경주시	안강읍	안강읍제1투	3713	2707	1006	13	2694	2319	361	0	0	3	11
경상북도	경주시	안강읍	안강읍제2투	2967	2303	664	13	2290	1977	308	0	1	2	2
경상북도	경주시	안강읍	안강읍제3투	1671	1301	370	14	1287	1084	187	0	1	6	9
경상북도	경주시	안강읍	안강읍제4투	3240	2463	777	9	2454	2034	409	0	3	3	5
경상북도	경주시	안강읍	안강읍제5투	3168	2454	714	7	2447	1984	454	1	1	1	6
경상북도	경주시	안강읍	안강읍제6투	3682	2804	878	4	2800	2182	608	0	2	6	2
경상북도	경주시	안강읍	안강읍제7투	3657	2843	814	8	2835	2158	664	1	2	5	5
경상북도	경주시	안강읍	안강읍제8투	1740	1352	388	9	1343	1121	212	2	0	0	8
경상북도	경주시	건천읍	소계	9372	7144	2228	38	7106	6021	1058	2	0	6	19
경상북도	경주시	건천읍	건천읍제1투	4071	3079	992	17	3062	2571	487	0	0	2	2
경상북도	경주시	건천읍	건천읍제2투	2843	2154	689	11	2143	1799	333	2	0	1	8
경상북도	경주시	건천읍	건천읍제3투	2458	1911	547	10	1901	1651	238	0	0	3	9
경상북도	경주시	외동읍	소계	13540	10256	3284	62	10194	7984	2153	3	11	9	34
경상북도	경주시	외동읍	외동읍제1투	2113	1570	543	12	1558	1267	279	0	2	3	7
경상북도	경주시	외동읍	외동읍제2투	3153	2391	762	8	2383	1689	680	3	4	2	5
경상북도	경주시	외동읍	외동읍제3투	1354	1048	306	7	1041	847	190	0	0	1	3
경상북도	경주시	외동읍	외동읍제4투	1854	1423	431	12	1411	1158	244	0	0	1	8
경상북도	경주시	외동읍	외동읍제5투	2611	2047	564	18	2029	1674	341	0	3	2	9
경상북도	경주시	외동읍	외동읍제6투	2455	1777	678	5	1772	1349	419	0	2	0	2
경상북도	경주시	양북면	소계	3665	2799	866	33	2766	2391	341	0	2	7	25
경상북도	경주시	양북면	양북면투표소	3665	2799	866	33	2766	2391	341	0	2	7	25
경상북도	경주시	양남면	소계	5550	4304	1246	32	4272	3109	1121	2	2	10	28
경상북도	경주시	양남면	양남면제1투	2819	2205	614	22	2183	1738	415	2	1	6	21
경상북도	경주시	양남면	양남면제2투	2731	2099	632	10	2089	1371	706	0	1	4	7
경상북도	경주시	내남면	소계	4573	3565	1008	23	3542	2935	578	3	2	3	21
경상북도	경주시	내남면	내남면제1투	2582	2006	576	12	1994	1644	336	2	1	1	10
경상북도	경주시	내남면	내남면제2투	1991	1559	432	11	1548	1291	242	1	1	2	11
경상북도	경주시	산내면	소계	2934	2261	673	29	2232	1905	300	3	1	4	19
경상북도	경주시	산내면	산내면투표소	2934	2261	673	29	2232	1905	300	3	1	4	19
경상북도	경주시	서면	소계	3271	2549	722	28	2521	2181	319	1	0	3	17
경상북도	경주시	서면	서면투표소	3271	2549	722	28	2521	2181	319	1	0	3	17
경상북도	경주시	현곡면	소계	11694	9616	2078	29	9587	7139	2409	2	2	13	22
경상북도	경주시	현곡면	현곡면제1투	2562	2019	543	9	2010	1581	418	0	1	4	6
경상북도	경주시	현곡면	현곡면제2투	3006	2562	444	2	2560	1786	768	0	1	4	1
경상북도	경주시	현곡면	현곡면제3투	3764	3127	637	10	3117	2162	944	1	0	2	8
경상북도	경주시	현곡면	현곡면제4투	2362	1908	454	8	1900	1610	279	1	0	3	7
경상북도	경주시	강동면	소계	6311	4830	1481	24	4806	3941	833	1	7	7	17
경상북도	경주시	강동면	강동면제1투	2804	2215	589	10	2205	1880	313	0	0	3	9
경상북도	경주시	강동면	강동면제2투	3507	2615	892	14	2601	2061	520	1	7	4	8
경상북도	경주시	천북면	소계	4622	3689	933	18	3671	3113	535	2	1	5	15
경상북도	경주시	천북면	천북면제1투	3364	2687	677	16	2671	2260	394	2	0	5	10
경상북도	경주시	천북면	천북면제2투	1258	1002	256	2	1000	853	141	0	1	0	5
경상북도	경주시	중부동	소계	5308	3992	1316	11	3981	3383	586	1	3	6	2
경상북도	경주시	중부동	중부동제1투	2660	1933	727	2	1931	1614	313	0	0	3	1
경상북도	경주시	중부동	중부동제2투	2648	2059	589	9	2050	1769	273	1	3	3	1
경상북도	경주시	황오동	소계	7333	5616	1717	11	5605	4707	879	3	2	4	10
경상북도	경주시	황오동	황오동제1투	3639	2747	892	4	2743	2303	430	2	2	1	5
경상북도	경주시	황오동	황오동제2투	2589	2067	522	4	2063	1719	337	1	0	2	4
경상북도	경주시	황오동	황오동제3투	1105	802	303	3	799	685	112	0	0	1	1
경상북도	경주시	성건동	소계	14352	10789	3563	27	10762	8723	2008	5	2	9	15
경상북도	경주시	성건동	성건동제1투	2912	2180	732	3	2177	1795	379	0	0	1	2
경상북도	경주시	성건동	성건동제2투	2672	2093	579	6	2087	1760	321	1	0	2	3
경상북도	경주시	성건동	성건동제3투	3104	2384	720	6	2378	1949	417	1	1	3	7
경상북도	경주시	성건동	성건동제4투	3067	2200	867	9	2191	1618	566	3	0	1	3
경상북도	경주시	성건동	성건동제5투	2597	1932	665	3	1929	1601	325	0	1	2	0
경상북도	경주시	황남동	소계	6349	4848	1501	12	4836	4150	673	1	1	5	6
경상북도	경주시	황남동	황남동제1투	1997	1547	450	4	1543	1337	203	0	0	2	1
경상북도	경주시	황남동	황남동제2투	2433	1819	614	3	1816	1535	276	0	1	2	2
경상북도	경주시	황남동	황남동제3투	1919	1482	437	5	1477	1278	194	1	0	1	3
경상북도	경주시	월성동	소계	5982	4657	1325	12	4645	3800	823	2	1	11	8
경상북도	경주시	월성동	월성동제1투	2940	2216	724	6	2210	1930	270	1	0	3	6
경상북도	경주시	월성동	월성동제2투	3042	2441	601	6	2435	1870	553	1	1	8	2
경상북도	경주시	선도동	소계	10675	8538	2137	17	8521	6420	2069	0	5	13	14
경상북도	경주시	선도동	선도동제1투	3466	2742	724	8	2734	2103	617	0	2	3	9
경상북도	경주시	선도동	선도동제2투	4209	3373	836	5	3368	2571	788	0	2	5	2
경상북도	경주시	선도동	선도동제3투	3000	2423	577	4	2419	1746	664	0	1	5	3
경상북도	경주시	용강동	소계	12270	9904	2366	20	9884	7379	2473	1	5	12	14
경상북도	경주시	용강동	용강동제1투	3901	3134	767	5	3129	2406	714	0	1	4	4
경상북도	경주시	용강동	용강동제2투	5014	4113	901	9	4104	2914	1180	0	4	4	2
경상북도	경주시	용강동	용강동제3투	3355	2657	698	6	2651	2059	579	1	0	4	8
경상북도	경주시	황성동	소계	20448	16772	3676	46	16726	12054	4610	2	10	28	22
경상북도	경주시	황성동	황성동제1투	3031	2414	617	8	2406	1815	583	0	0	2	6
경상북도	경주시	황성동	황성동제2투	3389	2775	614	5	2770	2050	707	0	2	9	2
경상북도	경주시	황성동	황성동제3투	3270	2630	640	7	2623	1860	753	1	2	2	5
경상북도	경주시	황성동	황성동제4투	3377	2782	595	7	2775	1943	824	1	3	4	0
경상북도	경주시	황성동	황성동제5투	3819	3194	625	10	3184	2257	913	0	1	6	7
경상북도	경주시	황성동	황성동제6투	3562	2977	585	9	2968	2129	830	0	2	5	2
경상북도	경주시	동천동	소계	19791	15878	3913	43	15835	12557	3235	2	15	16	10
경상북도	경주시	동천동	동천동제1투	3348	2575	773	6	2569	2157	404	1	3	2	2
경상북도	경주시	동천동	동천동제2투	3188	2660	528	4	2656	2030	619	1	4	1	1
경상북도	경주시	동천동	동천동제3투	3583	2841	742	7	2834	2260	567	0	3	4	0
경상북도	경주시	동천동	동천동제4투	3045	2397	648	8	2389	1870	514	0	1	3	1
경상북도	경주시	동천동	동천동제5투	3377	2757	620	10	2747	2169	567	0	2	4	5
경상북도	경주시	동천동	동천동제6투	3250	2648	602	8	2640	2071	564	0	2	2	1
경상북도	경주시	불국동	소계	7235	5612	1623	26	5586	4540	1023	1	3	10	9
경상북도	경주시	불국동	불국동제1투	3606	2742	864	10	2732	2168	554	0	1	4	5
경상북도	경주시	불국동	불국동제2투	3629	2870	759	16	2854	2372	469	1	2	6	4
경상북도	경주시	보덕동	소계	1792	1423	369	7	1416	1183	224	1	0	0	8
경상북도	경주시	보덕동	보덕동투표소	1792	1423	369	7	1416	1183	224	1	0	0	8
경상북도	김천시	계	계	111030	88157	22873	504	87653	73115	14072	30	41	96	299
경상북도	김천시	재외투표	재외투표	665	451	214	4	447	300	146	0	0	0	1
경상북도	김천시	국내부재자투표	국내부재자투표	4802	4176	626	107	4069	2770	1266	10	9	10	4
경상북도	김천시	아포읍	소계	6853	5380	1473	27	5353	4707	632	0	0	2	12
경상북도	김천시	아포읍	아포읍제1투	1847	1505	342	9	1496	1371	120	0	0	0	5
경상북도	김천시	아포읍	아포읍제2투	1648	1349	299	5	1344	1235	107	0	0	0	2
경상북도	김천시	아포읍	아포읍제3투	3358	2526	832	13	2513	2101	405	0	0	2	5
경상북도	김천시	농소면	소계	2792	2300	492	11	2289	2001	274	0	1	1	12
경상북도	김천시	농소면	농소면제1투	1231	1010	221	6	1004	861	138	0	0	0	5
경상북도	김천시	농소면	농소면제2투	1561	1290	271	5	1285	1140	136	0	1	1	7
경상북도	김천시	남면	소계	3070	2412	658	20	2392	2117	260	1	0	1	13
경상북도	김천시	남면	남면제1투	1777	1366	411	8	1358	1199	152	1	0	1	5
경상북도	김천시	남면	남면제2투	1293	1046	247	12	1034	918	108	0	0	0	8
경상북도	김천시	개령면	소계	2492	2031	461	11	2020	1783	225	0	0	1	11
경상북도	김천시	개령면	개령면투표소	2492	2031	461	11	2020	1783	225	0	0	1	11
경상북도	김천시	감문면	소계	3413	2799	614	18	2781	2516	242	0	1	2	20
경상북도	김천시	감문면	감문면제1투	1860	1498	362	16	1482	1321	147	0	1	1	12
경상북도	김천시	감문면	감문면제2투	1553	1301	252	2	1299	1195	95	0	0	1	8
경상북도	김천시	어모면	소계	4204	3216	988	41	3175	2788	351	1	7	8	20
경상북도	김천시	어모면	어모면제1투	2428	1908	520	14	1894	1654	224	0	2	2	12
경상북도	김천시	어모면	어모면제2투	1776	1308	468	27	1281	1134	127	1	5	6	8
경상북도	김천시	봉산면	소계	3013	2445	568	11	2434	2089	326	0	0	4	15
경상북도	김천시	봉산면	봉산면제1투	1697	1367	330	8	1359	1165	185	0	0	2	7
경상북도	김천시	봉산면	봉산면제2투	1316	1078	238	3	1075	924	141	0	0	2	8
경상북도	김천시	대항면	소계	3421	2759	662	25	2734	2358	352	0	1	5	18
경상북도	김천시	대항면	대항면제1투	2085	1634	451	16	1618	1397	205	0	0	3	13
경상북도	김천시	대항면	대항면제2투	1336	1125	211	9	1116	961	147	0	1	2	5
경상북도	김천시	감천면	소계	1908	1566	342	8	1558	1390	156	1	0	1	10
경상북도	김천시	감천면	감천면투표소	1908	1566	342	8	1558	1390	156	1	0	1	10
경상북도	김천시	조마면	소계	2218	1784	434	18	1766	1538	213	0	0	2	13
경상북도	김천시	조마면	조마면투표소	2218	1784	434	18	1766	1538	213	0	0	2	13
경상북도	김천시	구성면	소계	2878	2229	649	15	2214	1950	236	0	1	4	23
경상북도	김천시	구성면	구성면제1투	1443	1148	295	8	1140	1016	111	0	1	4	8
경상북도	김천시	구성면	구성면제2투	1435	1081	354	7	1074	934	125	0	0	0	15
경상북도	김천시	지례면	소계	1688	1302	386	12	1290	1114	154	1	0	3	18
경상북도	김천시	지례면	지례면제1투	1362	1057	305	7	1050	905	128	1	0	3	13
경상북도	김천시	지례면	지례면제2투	326	245	81	5	240	209	26	0	0	0	5
경상북도	김천시	부항면	소계	1197	951	246	15	936	800	114	1	1	2	18
경상북도	김천시	부항면	부항면투표소	1197	951	246	15	936	800	114	1	1	2	18
경상북도	김천시	대덕면	소계	2096	1543	553	17	1526	1295	217	0	0	4	10
경상북도	김천시	대덕면	대덕면투표소	2096	1543	553	17	1526	1295	217	0	0	4	10
경상북도	김천시	증산면	소계	1017	845	172	7	838	710	114	0	1	1	12
경상북도	김천시	증산면	증산면투표소	1017	845	172	7	838	710	114	0	1	1	12
경상북도	김천시	자산동	소계	7577	5964	1613	12	5952	5086	850	3	0	3	10
경상북도	김천시	자산동	자산동제1투	2190	1734	456	6	1728	1511	214	0	0	1	2
경상북도	김천시	자산동	자산동제2투	2614	2050	564	3	2047	1740	299	2	0	1	5
경상북도	김천시	자산동	자산동제3투	2773	2180	593	3	2177	1835	337	1	0	1	3
경상북도	김천시	평화남산동	소계	8663	6650	2013	17	6633	5613	1002	2	1	3	12
경상북도	김천시	평화남산동	평화남산동제1투	1905	1427	478	2	1425	1247	174	0	0	1	3
경상북도	김천시	평화남산동	평화남산동제2투	2412	1811	601	6	1805	1487	313	1	1	2	1
경상북도	김천시	평화남산동	평화남산동제3투	2029	1580	449	5	1575	1297	276	0	0	0	2
경상북도	김천시	평화남산동	평화남산동제4투	2317	1832	485	4	1828	1582	239	1	0	0	6
경상북도	김천시	양금동	소계	4424	3578	846	16	3562	3113	436	0	2	4	7
경상북도	김천시	양금동	양금동제1투	1900	1560	340	6	1554	1376	175	0	0	1	2
경상북도	김천시	양금동	양금동제2투	2524	2018	506	10	2008	1737	261	0	2	3	5
경상북도	김천시	대신동	소계	17920	14360	3560	39	14321	11207	3068	5	7	17	17
경상북도	김천시	대신동	대신동제1투	3599	2767	832	9	2758	2191	558	1	3	2	3
경상북도	김천시	대신동	대신동제2투	2684	2213	471	8	2205	1679	519	1	1	4	1
경상북도	김천시	대신동	대신동제3투	2741	2263	478	6	2257	1765	484	0	1	1	6
경상북도	김천시	대신동	대신동제4투	2725	2330	395	5	2325	1788	535	1	0	0	1
경상북도	김천시	대신동	대신동제5투	1448	1157	291	3	1154	993	159	0	0	0	2
경상북도	김천시	대신동	대신동제6투	4723	3630	1093	8	3622	2791	813	2	2	10	4
경상북도	김천시	대곡동	소계	16901	13245	3656	36	13209	10734	2435	3	7	16	14
경상북도	김천시	대곡동	대곡동제1투	3093	2460	633	7	2453	2027	421	0	2	0	3
경상북도	김천시	대곡동	대곡동제2투	2233	1705	528	1	1704	1462	241	0	0	0	1
경상북도	김천시	대곡동	대곡동제3투	3640	3058	582	10	3048	2355	684	2	0	4	3
경상북도	김천시	대곡동	대곡동제4투	3016	2271	745	3	2268	1874	387	1	3	2	1
경상북도	김천시	대곡동	대곡동제5투	2294	1758	536	9	1749	1402	341	0	2	3	1
경상북도	김천시	대곡동	대곡동제6투	2625	1993	632	6	1987	1614	361	0	0	7	5
경상북도	김천시	지좌동	소계	7818	6171	1647	17	6154	5136	1003	2	2	2	9
경상북도	김천시	지좌동	지좌동제1투	4298	3393	905	10	3383	2786	585	2	1	2	7
경상북도	김천시	지좌동	지좌동제2투	3520	2778	742	7	2771	2350	418	0	1	0	2
경상북도	안동시	계	계	136671	107233	29438	642	106591	84799	21028	67	55	156	486
경상북도	안동시	재외투표	재외투표	502	338	164	3	335	191	141	1	1	1	0
경상북도	안동시	국내부재자투표	국내부재자투표	5875	5316	559	226	5090	3241	1734	28	16	22	49
경상북도	안동시	풍산읍	소계	6250	4707	1543	38	4669	4002	621	1	1	8	36
경상북도	안동시	풍산읍	풍산읍제1투	2142	1576	566	9	1567	1330	227	0	1	2	7
경상북도	안동시	풍산읍	풍산읍제2투	857	664	193	6	658	571	77	0	0	3	7
경상북도	안동시	풍산읍	풍산읍제3투	1331	1035	296	13	1022	892	123	1	0	0	6
경상북도	안동시	풍산읍	풍산읍제4투	1920	1432	488	10	1422	1209	194	0	0	3	16
경상북도	안동시	와룡면	소계	3890	3027	863	26	3001	2554	405	5	3	5	29
경상북도	안동시	와룡면	와룡면제1투	2511	1962	549	17	1945	1654	262	4	3	3	19
경상북도	안동시	와룡면	와룡면제2투	1379	1065	314	9	1056	900	143	1	0	2	10
경상북도	안동시	북후면	소계	3002	2282	720	20	2262	1935	293	4	0	9	21
경상북도	안동시	북후면	북후면제1투	1986	1528	458	16	1512	1300	194	2	0	5	11
경상북도	안동시	북후면	북후면제2투	1016	754	262	4	750	635	99	2	0	4	10
경상북도	안동시	서후면	소계	3284	2498	786	6	2492	2050	420	1	0	3	18
경상북도	안동시	서후면	서후면제1투	2039	1547	492	4	1543	1291	238	1	0	3	10
경상북도	안동시	서후면	서후면제2투	1245	951	294	2	949	759	182	0	0	0	8
경상북도	안동시	풍천면	소계	3937	3054	883	18	3036	2658	341	3	2	3	29
경상북도	안동시	풍천면	풍천면제1투	2238	1702	536	11	1691	1454	220	2	1	2	12
경상북도	안동시	풍천면	풍천면제2투	1195	951	244	6	945	845	89	0	1	1	9
경상북도	안동시	풍천면	풍천면제3투	504	401	103	1	400	359	32	1	0	0	8
경상북도	안동시	일직면	소계	2950	2312	638	14	2298	1992	292	0	0	2	12
경상북도	안동시	일직면	일직면제1투	1372	1099	273	8	1091	964	119	0	0	0	8
경상북도	안동시	일직면	일직면제2투	1578	1213	365	6	1207	1028	173	0	0	2	4
경상북도	안동시	남후면	소계	1855	1466	389	10	1456	1282	151	2	0	1	20
경상북도	안동시	남후면	남후면투표소	1855	1466	389	10	1456	1282	151	2	0	1	20
경상북도	안동시	남선면	소계	2136	1656	480	13	1643	1323	305	1	0	4	10
경상북도	안동시	남선면	남선면제1투	1288	969	319	7	962	773	182	0	0	1	6
경상북도	안동시	남선면	남선면제2투	848	687	161	6	681	550	123	1	0	3	4
경상북도	안동시	임하면	소계	2727	2030	697	14	2016	1746	250	0	0	2	18
경상북도	안동시	임하면	임하면제1투	1988	1439	549	9	1430	1256	160	0	0	1	13
경상북도	안동시	임하면	임하면제2투	739	591	148	5	586	490	90	0	0	1	5
경상북도	안동시	길안면	소계	2880	2179	701	16	2163	1840	286	2	1	3	31
경상북도	안동시	길안면	길안면제1투	1888	1417	471	9	1408	1180	208	1	1	2	16
경상북도	안동시	길안면	길안면제2투	560	418	142	5	413	358	45	1	0	0	9
경상북도	안동시	길안면	길안면제3투	432	344	88	2	342	302	33	0	0	1	6
경상북도	안동시	임동면	소계	1868	1432	436	17	1415	1205	180	0	1	4	25
경상북도	안동시	임동면	임동면투표소	1868	1432	436	17	1415	1205	180	0	1	4	25
경상북도	안동시	예안면	소계	1881	1441	440	12	1429	1193	220	0	2	0	14
경상북도	안동시	예안면	예안면제1투	1279	977	302	11	966	805	151	0	1	0	9
경상북도	안동시	예안면	예안면제2투	602	464	138	1	463	388	69	0	1	0	5
경상북도	안동시	도산면	소계	1774	1395	379	7	1388	1159	206	0	2	4	17
경상북도	안동시	도산면	도산면제1투	1167	906	261	4	902	741	148	0	0	3	10
경상북도	안동시	도산면	도산면제2투	607	489	118	3	486	418	58	0	2	1	7
경상북도	안동시	녹전면	소계	1816	1440	376	10	1430	1202	210	0	1	5	12
경상북도	안동시	녹전면	녹전면제1투	1186	933	253	5	928	778	141	0	0	1	8
경상북도	안동시	녹전면	녹전면제2투	630	507	123	5	502	424	69	0	1	4	4
경상북도	안동시	중구동	소계	4689	3597	1092	7	3590	3019	552	0	0	6	13
경상북도	안동시	중구동	중구동제1투	1782	1349	433	0	1349	1119	220	0	0	2	8
경상북도	안동시	중구동	중구동제2투	1166	895	271	2	893	767	123	0	0	2	1
경상북도	안동시	중구동	중구동제3투	1741	1353	388	5	1348	1133	209	0	0	2	4
경상북도	안동시	명륜동	소계	4822	3823	999	11	3812	2998	801	2	0	5	6
경상북도	안동시	명륜동	명륜동제1투	2673	2108	565	9	2099	1634	460	1	0	1	3
경상북도	안동시	명륜동	명륜동제2투	2149	1715	434	2	1713	1364	341	1	0	4	3
경상북도	안동시	용상동	소계	17220	13440	3780	41	13399	10356	2980	4	7	22	30
경상북도	안동시	용상동	용상동제1투	2323	1861	462	2	1859	1434	415	1	0	3	6
경상북도	안동시	용상동	용상동제2투	1781	1274	507	6	1268	1032	227	0	0	1	8
경상북도	안동시	용상동	용상동제3투	2430	1882	548	4	1878	1512	360	0	2	3	1
경상북도	안동시	용상동	용상동제4투	1678	1298	380	8	1290	1006	279	0	1	3	1
경상북도	안동시	용상동	용상동제5투	1884	1401	483	4	1397	1131	257	2	1	3	3
경상북도	안동시	용상동	용상동제6투	3162	2598	564	4	2594	1920	663	0	1	4	6
경상북도	안동시	용상동	용상동제7투	2802	2266	536	6	2260	1631	619	1	2	5	2
경상북도	안동시	용상동	용상동제8투	1160	860	300	7	853	690	160	0	0	0	3
경상북도	안동시	서구동	소계	6966	5377	1589	14	5363	4508	836	0	2	6	11
경상북도	안동시	서구동	서구동제1투	1679	1243	436	5	1238	1034	198	0	2	4	0
경상북도	안동시	서구동	서구동제2투	2109	1639	470	3	1636	1438	191	0	0	1	6
경상북도	안동시	서구동	서구동제3투	1591	1223	368	2	1221	1012	207	0	0	0	2
경상북도	안동시	서구동	서구동제4투	1587	1272	315	4	1268	1024	240	0	0	1	3
경상북도	안동시	태화동	소계	11244	8622	2622	26	8596	7103	1466	2	1	8	16
경상북도	안동시	태화동	태화동제1투	2044	1491	553	4	1487	1275	204	1	1	0	6
경상북도	안동시	태화동	태화동제2투	2326	1816	510	7	1809	1479	329	0	0	1	0
경상북도	안동시	태화동	태화동제3투	2497	1894	603	7	1887	1609	273	1	0	1	3
경상북도	안동시	태화동	태화동제4투	2306	1801	505	5	1796	1439	350	0	0	4	3
경상북도	안동시	태화동	태화동제5투	2071	1620	451	3	1617	1301	310	0	0	2	4
경상북도	안동시	평화동	소계	6333	4937	1396	9	4928	3978	929	2	2	5	12
경상북도	안동시	평화동	평화동제1투	2147	1692	455	5	1687	1378	300	2	1	2	4
경상북도	안동시	평화동	평화동제2투	1614	1238	376	1	1237	979	252	0	0	1	5
경상북도	안동시	평화동	평화동제3투	2572	2007	565	3	2004	1621	377	0	1	2	3
경상북도	안동시	안기동	소계	5986	4791	1195	5	4786	3834	930	1	4	7	10
경상북도	안동시	안기동	안기동제1투	1509	1233	276	0	1233	970	257	0	2	1	3
경상북도	안동시	안기동	안기동제2투	1925	1496	429	3	1493	1227	259	1	1	2	3
경상북도	안동시	안기동	안기동제3투	2552	2062	490	2	2060	1637	414	0	1	4	4
경상북도	안동시	옥동	소계	15474	12264	3210	37	12227	9195	2992	3	4	10	23
경상북도	안동시	옥동	옥동제1투	3153	2413	740	2	2411	1816	590	0	0	2	3
경상북도	안동시	옥동	옥동제2투	1661	1385	276	5	1380	934	439	0	1	2	4
경상북도	안동시	옥동	옥동제3투	2558	2120	438	6	2114	1650	457	2	1	3	1
경상북도	안동시	옥동	옥동제4투	1716	1233	483	13	1220	1043	168	1	0	1	7
경상북도	안동시	옥동	옥동제5투	2563	2101	462	1	2100	1525	571	0	1	0	3
경상북도	안동시	옥동	옥동제6투	2063	1656	407	5	1651	1190	458	0	0	0	3
경상북도	안동시	옥동	옥동제7투	1760	1356	404	5	1351	1037	309	0	1	2	2
경상북도	안동시	송하동	소계	10502	8275	2227	28	8247	6261	1955	5	1	7	18
경상북도	안동시	송하동	송하동제1투	1917	1435	482	6	1429	1139	280	1	0	2	7
경상북도	안동시	송하동	송하동제2투	2151	1708	443	4	1704	1281	417	1	0	2	3
경상북도	안동시	송하동	송하동제3투	2175	1707	468	7	1700	1327	368	1	0	2	2
경상북도	안동시	송하동	송하동제4투	1952	1572	380	3	1569	1151	412	1	1	1	3
경상북도	안동시	송하동	송하동제5투	2307	1853	454	8	1845	1363	478	1	0	0	3
경상북도	안동시	강남동	소계	6808	5534	1274	14	5520	3974	1532	0	4	4	6
경상북도	안동시	강남동	강남동제1투	1280	941	339	3	938	779	152	0	1	2	4
경상북도	안동시	강남동	강남동제2투	2854	2318	536	8	2310	1677	628	0	3	0	2
경상북도	안동시	강남동	강남동제3투	2674	2275	399	3	2272	1518	752	0	0	2	0
경상북도	안동시	잘못 투입·구분된 투표지	잘못 투입·구분된 투표지	0	0	0	0	0	0	0	0	0	0	0
경상북도	구미시	계	계	312994	245844	67150	584	245260	197062	47485	52	104	185	372
경상북도	구미시	재외투표	재외투표	923	613	310	5	608	378	229	0	0	1	0
경상북도	구미시	국내부재자투표	국내부재자투표	9783	8931	852	93	8838	6271	2515	4	10	14	24
경상북도	구미시	선산읍	소계	12158	9798	2360	52	9746	8770	938	3	4	6	25
경상북도	구미시	선산읍	선산읍제1투	2688	2126	562	5	2121	1908	201	2	0	3	7
경상북도	구미시	선산읍	선산읍제2투	2063	1634	429	4	1630	1413	214	0	0	0	3
경상북도	구미시	선산읍	선산읍제3투	3153	2580	573	23	2557	2343	202	1	3	0	8
경상북도	구미시	선산읍	선산읍제4투	917	765	152	8	757	687	68	0	0	1	1
경상북도	구미시	선산읍	선산읍제5투	3337	2693	644	12	2681	2419	253	0	1	2	6
경상북도	구미시	고아읍	소계	23841	19802	4039	47	19755	16727	2967	7	8	14	32
경상북도	구미시	고아읍	고아읍제1투	2574	2076	498	7	2069	1848	216	0	0	1	4
경상북도	구미시	고아읍	고아읍제2투	3031	2428	603	8	2420	2108	303	2	0	4	3
경상북도	구미시	고아읍	고아읍제3투	4436	3758	678	9	3749	3075	660	1	3	3	7
경상북도	구미시	고아읍	고아읍제4투	4173	3496	677	6	3490	2888	597	0	2	0	3
경상북도	구미시	고아읍	고아읍제5투	2577	2114	463	5	2109	1922	179	2	0	1	5
경상북도	구미시	고아읍	고아읍제6투	3182	2667	515	6	2661	2340	309	2	1	2	7
경상북도	구미시	고아읍	고아읍제7투	3868	3263	605	6	3257	2546	703	0	2	3	3
경상북도	구미시	무을면	소계	1918	1601	317	8	1593	1443	118	1	1	3	27
경상북도	구미시	무을면	무을면투표소	1918	1601	317	8	1593	1443	118	1	1	3	27
경상북도	구미시	옥성면	소계	1756	1413	343	16	1397	1274	102	1	1	1	18
경상북도	구미시	옥성면	옥성면투표소	1756	1413	343	16	1397	1274	102	1	1	1	18
경상북도	구미시	도개면	소계	2215	1755	460	7	1748	1580	154	1	0	1	12
경상북도	구미시	도개면	도개면투표소	2215	1755	460	7	1748	1580	154	1	0	1	12
경상북도	구미시	해평면	소계	4773	3806	967	16	3790	3454	303	2	2	3	26
경상북도	구미시	해평면	해평면제1투	2294	1798	496	7	1791	1631	138	1	2	2	17
경상북도	구미시	해평면	해평면제2투	2479	2008	471	9	1999	1823	165	1	0	1	9
경상북도	구미시	산동면	소계	3241	2547	694	16	2531	2259	262	0	1	0	9
경상북도	구미시	산동면	산동면투표소	3241	2547	694	16	2531	2259	262	0	1	0	9
경상북도	구미시	장천면	소계	3087	2441	646	23	2418	2183	215	1	2	2	15
경상북도	구미시	장천면	장천면투표소	3087	2441	646	23	2418	2183	215	1	2	2	15
경상북도	구미시	송정동	소계	14880	11747	3133	18	11729	9538	2178	2	4	2	5
경상북도	구미시	송정동	송정동제1투	3388	2598	790	6	2592	1906	682	1	2	0	1
경상북도	구미시	송정동	송정동제2투	3253	2477	776	4	2473	2072	401	0	0	0	0
경상북도	구미시	송정동	송정동제3투	4081	3404	677	5	3399	2784	613	0	1	0	1
경상북도	구미시	송정동	송정동제4투	4158	3268	890	3	3265	2776	482	1	1	2	3
경상북도	구미시	원평1동	소계	4242	2793	1449	3	2790	2450	334	1	2	1	2
경상북도	구미시	원평1동	원평1동제1투	3093	1919	1174	1	1918	1680	235	1	1	1	0
경상북도	구미시	원평1동	원평1동제2투	1149	874	275	2	872	770	99	0	1	0	2
경상북도	구미시	원평2동	소계	4062	3100	962	3	3097	2786	307	0	0	1	3
경상북도	구미시	원평2동	원평2동제1투	2294	1712	582	3	1709	1562	147	0	0	0	0
경상북도	구미시	원평2동	원평2동제2투	1768	1388	380	0	1388	1224	160	0	0	1	3
경상북도	구미시	지산동	소계	2520	2037	483	4	2033	1818	209	2	1	1	2
경상북도	구미시	지산동	지산동투표소	2520	2037	483	4	2033	1818	209	2	1	1	2
경상북도	구미시	도량동	소계	23478	19050	4428	31	19019	15588	3392	2	7	15	15
경상북도	구미시	도량동	도량동제1투	2319	1832	487	6	1826	1587	235	0	0	2	2
경상북도	구미시	도량동	도량동제2투	3017	2382	635	7	2375	1987	385	0	1	0	2
경상북도	구미시	도량동	도량동제3투	2743	2241	502	2	2239	1899	336	0	1	1	2
경상북도	구미시	도량동	도량동제4투	3164	2512	652	7	2505	2088	415	0	1	1	0
경상북도	구미시	도량동	도량동제5투	3566	2788	778	8	2780	2283	486	2	2	2	5
경상북도	구미시	도량동	도량동제6투	4444	3701	743	1	3700	2990	700	0	2	6	2
경상북도	구미시	도량동	도량동제7투	4225	3594	631	0	3594	2754	835	0	0	3	2
경상북도	구미시	선주원남동	소계	31359	25703	5656	41	25662	20361	5262	3	5	18	13
경상북도	구미시	선주원남동	선주원남동제1투	4219	3600	619	6	3594	2666	922	1	2	2	1
경상북도	구미시	선주원남동	선주원남동제2투	4834	3811	1023	3	3808	3050	752	0	2	3	1
경상북도	구미시	선주원남동	선주원남동제3투	3426	2435	991	5	2430	1999	429	0	0	0	2
경상북도	구미시	선주원남동	선주원남동제4투	4189	3501	688	7	3494	2734	755	0	0	5	0
경상북도	구미시	선주원남동	선주원남동제5투	4244	3475	769	7	3468	2917	542	2	0	3	4
경상북도	구미시	선주원남동	선주원남동제6투	2984	2408	576	5	2403	2059	344	0	0	0	0
경상북도	구미시	선주원남동	선주원남동제7투	4370	3828	542	4	3824	2924	892	0	1	3	4
경상북도	구미시	선주원남동	선주원남동제8투	3093	2645	448	4	2641	2012	626	0	0	2	1
경상북도	구미시	형곡1동	소계	11843	9802	2041	18	9784	7967	1803	2	2	6	4
경상북도	구미시	형곡1동	형곡1동제1투	2551	2112	439	4	2108	1692	412	0	1	2	1
경상북도	구미시	형곡1동	형곡1동제2투	3487	2862	625	5	2857	2344	509	2	0	0	2
경상북도	구미시	형곡1동	형곡1동제3투	3040	2565	475	6	2559	2083	472	0	0	3	1
경상북도	구미시	형곡1동	형곡1동제4투	2765	2263	502	3	2260	1848	410	0	1	1	0
경상북도	구미시	형곡2동	소계	16086	13165	2921	19	13146	10992	2125	2	5	10	12
경상북도	구미시	형곡2동	형곡2동제1투	3184	2602	582	4	2598	2168	422	2	0	5	1
경상북도	구미시	형곡2동	형곡2동제2투	3626	2932	694	3	2929	2423	501	0	0	1	4
경상북도	구미시	형곡2동	형곡2동제3투	2798	2300	498	1	2299	1883	412	0	2	0	2
경상북도	구미시	형곡2동	형곡2동제4투	3183	2603	580	6	2597	2217	373	0	1	2	4
경상북도	구미시	형곡2동	형곡2동제5투	3295	2728	567	5	2723	2301	417	0	2	2	1
경상북도	구미시	신평1동	소계	3934	3053	881	6	3047	2451	586	0	0	4	6
경상북도	구미시	신평1동	신평1동제1투	2064	1658	406	1	1657	1296	357	0	0	1	3
경상북도	구미시	신평1동	신평1동제2투	1870	1395	475	5	1390	1155	229	0	0	3	3
경상북도	구미시	신평2동	소계	2665	2054	611	6	2048	1767	275	0	1	0	5
경상북도	구미시	신평2동	신평2동투표소	2665	2054	611	6	2048	1767	275	0	1	0	5
경상북도	구미시	비산동	소계	3441	2721	720	1	2720	2218	490	1	5	2	4
경상북도	구미시	비산동	비산동투표소	3441	2721	720	1	2720	2218	490	1	5	2	4
경상북도	구미시	공단1동	소계	4527	3533	994	2	3531	2850	669	0	4	2	6
경상북도	구미시	공단1동	공단1동투표소	4527	3533	994	2	3531	2850	669	0	4	2	6
경상북도	구미시	공단2동	소계	4154	3165	989	3	3162	2109	1040	0	0	7	6
경상북도	구미시	공단2동	공단2동투표소	4154	3165	989	3	3162	2109	1040	0	0	7	6
경상북도	구미시	광평동	소계	3580	2815	765	3	2812	2357	450	1	0	0	4
경상북도	구미시	광평동	광평동투표소	3580	2815	765	3	2812	2357	450	1	0	0	4
경상북도	구미시	상모사곡동	소계	20805	16134	4671	26	16108	13189	2884	4	6	12	13
경상북도	구미시	상모사곡동	상모사곡동제1투	4920	3548	1372	4	3544	2847	683	1	4	3	6
경상북도	구미시	상모사곡동	상모사곡동제2투	1972	1592	380	2	1590	1341	246	0	0	1	2
경상북도	구미시	상모사곡동	상모사곡동제3투	5676	4152	1524	10	4142	3384	748	2	0	6	2
경상북도	구미시	상모사곡동	상모사곡동제4투	2213	1768	445	3	1765	1512	250	1	0	0	2
경상북도	구미시	상모사곡동	상모사곡동제5투	3228	2606	622	3	2603	2092	509	0	1	1	0
경상북도	구미시	상모사곡동	상모사곡동제6투	2796	2468	328	4	2464	2013	448	0	1	1	1
경상북도	구미시	임오동	소계	12052	9668	2384	11	9657	7891	1738	0	7	7	14
경상북도	구미시	임오동	임오동제1투	3914	3141	773	6	3135	2553	574	0	1	1	6
경상북도	구미시	임오동	임오동제2투	2989	2391	598	2	2389	1979	405	0	1	1	3
경상북도	구미시	임오동	임오동제3투	3251	2681	570	1	2680	2202	471	0	3	2	2
경상북도	구미시	임오동	임오동제4투	1898	1455	443	2	1453	1157	288	0	2	3	3
경상북도	구미시	인동동	소계	39515	29090	10425	42	29048	22299	6678	5	13	18	35
경상북도	구미시	인동동	인동동제1투	3666	2630	1036	5	2625	2228	392	1	1	0	3
경상북도	구미시	인동동	인동동제2투	2546	1926	620	7	1919	1366	546	0	2	1	4
경상북도	구미시	인동동	인동동제3투	4125	2933	1192	3	2930	2301	622	0	1	1	5
경상북도	구미시	인동동	인동동제4투	2869	2163	706	5	2158	1786	366	1	0	1	4
경상북도	구미시	인동동	인동동제5투	3168	2307	861	6	2301	1923	371	0	1	2	4
경상북도	구미시	인동동	인동동제6투	3441	2708	733	4	2704	2201	492	0	3	3	5
경상북도	구미시	인동동	인동동제7투	4492	3021	1471	4	3017	2234	778	1	1	2	1
경상북도	구미시	인동동	인동동제8투	3653	2204	1449	2	2202	1720	480	0	0	1	1
경상북도	구미시	인동동	인동동제9투	3708	3127	581	4	3123	2269	846	1	2	3	2
경상북도	구미시	인동동	인동동제10투	5583	4279	1304	2	4277	3010	1259	0	2	2	4
경상북도	구미시	인동동	인동동제11투	2264	1792	472	0	1792	1261	526	1	0	2	2
경상북도	구미시	진미동	소계	18191	11498	6693	27	11471	7862	3574	5	8	10	12
경상북도	구미시	진미동	진미동제1투	3869	2743	1126	17	2726	1423	1287	4	2	2	8
경상북도	구미시	진미동	진미동제2투	4089	2442	1647	3	2439	1832	604	0	2	1	0
경상북도	구미시	진미동	진미동제3투	4910	2845	2065	2	2843	2138	696	0	3	3	3
경상북도	구미시	진미동	진미동제4투	5323	3468	1855	5	3463	2469	987	1	1	4	1
경상북도	구미시	양포동	소계	27965	22009	5956	37	21972	16230	5688	2	5	24	23
경상북도	구미시	양포동	양포동제1투	4944	3621	1323	6	3615	2461	1143	0	0	7	4
경상북도	구미시	양포동	양포동제2투	4752	4002	750	5	3997	2701	1287	1	1	6	1
경상북도	구미시	양포동	양포동제3투	1938	1562	376	4	1558	1248	301	0	0	3	6
경상북도	구미시	양포동	양포동제4투	3516	2699	817	2	2697	2046	645	1	0	3	2
경상북도	구미시	양포동	양포동제5투	3837	3135	702	9	3126	2376	743	0	2	3	2
경상북도	구미시	양포동	양포동제6투	3057	2379	678	3	2376	1901	470	0	0	0	5
경상북도	구미시	양포동	양포동제7투	3077	2398	679	5	2393	1830	560	0	1	0	2
경상북도	구미시	양포동	양포동제8투	2844	2213	631	3	2210	1667	539	0	1	2	1
경상북도	영주시	계	계	92433	72614	19819	339	72275	56360	15493	32	33	88	269
경상북도	영주시	재외투표	재외투표	223	169	54	2	167	70	94	1	0	2	0
경상북도	영주시	국내부재자투표	국내부재자투표	3631	3249	382	59	3190	1961	1192	8	5	8	16
경상북도	영주시	풍기읍	소계	10167	7677	2490	38	7639	6157	1441	5	2	8	26
경상북도	영주시	풍기읍	풍기읍제1투	2387	1728	659	8	1720	1381	330	1	2	5	1
경상북도	영주시	풍기읍	풍기읍제2투	2197	1702	495	8	1694	1388	300	0	0	1	5
경상북도	영주시	풍기읍	풍기읍제3투	2081	1579	502	8	1571	1232	332	0	0	0	7
경상북도	영주시	풍기읍	풍기읍제4투	2201	1643	558	4	1639	1289	338	3	0	2	7
경상북도	영주시	풍기읍	풍기읍제5투	1301	1025	276	10	1015	867	141	1	0	0	6
경상북도	영주시	이산면	소계	2553	1958	595	7	1951	1587	338	2	1	2	21
경상북도	영주시	이산면	이산면제1투	1398	1076	322	3	1073	857	208	1	1	2	4
경상북도	영주시	이산면	이산면제2투	1155	882	273	4	878	730	130	1	0	0	17
경상북도	영주시	평은면	소계	1738	1322	416	3	1319	1115	188	1	0	2	13
경상북도	영주시	평은면	평은면투표소	1738	1322	416	3	1319	1115	188	1	0	2	13
경상북도	영주시	문수면	소계	1804	1456	348	26	1430	1178	228	3	2	4	15
경상북도	영주시	문수면	문수면투표소	1804	1456	348	26	1430	1178	228	3	2	4	15
경상북도	영주시	장수면	소계	2127	1674	453	10	1664	1443	207	0	0	2	12
경상북도	영주시	장수면	장수면제1투	1491	1149	342	5	1144	983	150	0	0	2	9
경상북도	영주시	장수면	장수면제2투	636	525	111	5	520	460	57	0	0	0	3
경상북도	영주시	안정면	소계	2974	2312	662	20	2292	1925	353	0	0	0	14
경상북도	영주시	안정면	안정면제1투	2045	1582	463	16	1566	1311	244	0	0	0	11
경상북도	영주시	안정면	안정면제2투	929	730	199	4	726	614	109	0	0	0	3
경상북도	영주시	봉현면	소계	2751	2149	602	14	2135	1827	292	0	0	1	15
경상북도	영주시	봉현면	봉현면제1투	1904	1447	457	7	1440	1228	206	0	0	0	6
경상북도	영주시	봉현면	봉현면제2투	847	702	145	7	695	599	86	0	0	1	9
경상북도	영주시	순흥면	소계	2106	1695	411	11	1684	1420	248	2	0	0	14
경상북도	영주시	순흥면	순흥면투표소	2106	1695	411	11	1684	1420	248	2	0	0	14
경상북도	영주시	단산면	소계	1948	1564	384	8	1556	1281	254	0	0	4	17
경상북도	영주시	단산면	단산면제1투	1131	887	244	5	882	710	158	0	0	3	11
경상북도	영주시	단산면	단산면제2투	817	677	140	3	674	571	96	0	0	1	6
경상북도	영주시	부석면	소계	3146	2449	697	14	2435	2011	398	2	1	3	20
경상북도	영주시	부석면	부석면제1투	2371	1819	552	11	1808	1500	292	2	0	2	12
경상북도	영주시	부석면	부석면제2투	775	630	145	3	627	511	106	0	1	1	8
경상북도	영주시	상망동	소계	6962	5444	1518	21	5423	4197	1203	1	2	7	13
경상북도	영주시	상망동	상망동제1투	1509	1115	394	5	1110	953	153	0	0	1	3
경상북도	영주시	상망동	상망동제2투	3220	2574	646	3	2571	1907	656	0	1	4	3
경상북도	영주시	상망동	상망동제3투	2233	1755	478	13	1742	1337	394	1	1	2	7
경상북도	영주시	하망동	소계	5902	4711	1191	6	4705	3643	1049	0	2	5	6
경상북도	영주시	하망동	하망동제1투	2351	1839	512	1	1838	1445	388	0	0	1	4
경상북도	영주시	하망동	하망동제2투	1367	1169	198	1	1168	822	342	0	1	2	1
경상북도	영주시	하망동	하망동제3투	2184	1703	481	4	1699	1376	319	0	1	2	1
경상북도	영주시	영주1동	소계	4491	3370	1121	12	3358	2803	540	0	3	3	9
경상북도	영주시	영주1동	영주1동제1투	2380	1802	578	6	1796	1508	280	0	2	1	5
경상북도	영주시	영주1동	영주1동제2투	2111	1568	543	6	1562	1295	260	0	1	2	4
경상북도	영주시	영주2동	소계	3848	3025	823	12	3013	2353	647	0	1	4	8
경상북도	영주시	영주2동	영주2동제1투	2253	1765	488	5	1760	1331	422	0	1	2	4
경상북도	영주시	영주2동	영주2동제2투	1595	1260	335	7	1253	1022	225	0	0	2	4
경상북도	영주시	휴천1동	소계	5411	4321	1090	8	4313	3214	1087	0	3	3	6
경상북도	영주시	휴천1동	휴천1동제1투	2348	1843	505	0	1843	1476	360	0	2	1	4
경상북도	영주시	휴천1동	휴천1동제2투	3063	2478	585	8	2470	1738	727	0	1	2	2
경상북도	영주시	휴천2동	소계	8257	6414	1843	16	6398	4877	1502	2	3	5	9
경상북도	영주시	휴천2동	휴천2동제1투	1617	1220	397	1	1219	973	242	1	0	2	1
경상북도	영주시	휴천2동	휴천2동제2투	2086	1496	590	6	1490	1148	335	0	1	2	4
경상북도	영주시	휴천2동	휴천2동제3투	1340	1025	315	3	1022	849	168	1	2	0	2
경상북도	영주시	휴천2동	휴천2동제4투	1932	1613	319	5	1608	1132	474	0	0	1	1
경상북도	영주시	휴천2동	휴천2동제5투	1282	1060	222	1	1059	775	283	0	0	0	1
경상북도	영주시	휴천3동	소계	7389	5896	1493	15	5881	4360	1500	1	1	10	9
경상북도	영주시	휴천3동	휴천3동제1투	2525	1994	531	4	1990	1586	399	0	0	5	0
경상북도	영주시	휴천3동	휴천3동제2투	2529	1967	562	8	1959	1455	497	1	1	3	2
경상북도	영주시	휴천3동	휴천3동제3투	2335	1935	400	3	1932	1319	604	0	0	2	7
경상북도	영주시	가흥1동	소계	9453	7352	2101	22	7330	5572	1732	2	4	9	11
경상북도	영주시	가흥1동	가흥1동제1투	1322	1003	319	1	1002	796	202	0	0	2	2
경상북도	영주시	가흥1동	가흥1동제2투	1226	952	274	3	949	779	167	0	0	1	2
경상북도	영주시	가흥1동	가흥1동제3투	1246	962	284	2	960	797	159	2	0	2	0
경상북도	영주시	가흥1동	가흥1동제4투	2451	1949	502	4	1945	1437	504	0	3	1	0
경상북도	영주시	가흥1동	가흥1동제5투	3208	2486	722	12	2474	1763	700	0	1	3	7
경상북도	영주시	가흥2동	소계	5552	4407	1145	15	4392	3366	1000	2	3	6	15
경상북도	영주시	가흥2동	가흥2동제1투	2560	2052	508	8	2044	1578	449	1	1	5	10
경상북도	영주시	가흥2동	가흥2동제2투	2992	2355	637	7	2348	1788	551	1	2	1	5
경상북도	영천시	계	계	86316	66924	19392	441	66483	54748	11372	27	28	80	228
경상북도	영천시	재외투표	재외투표	417	255	162	3	252	163	85	1	0	1	2
경상북도	영천시	국내부재자투표	국내부재자투표	2948	2716	232	72	2644	1781	838	5	4	9	7
경상북도	영천시	금호읍	소계	10338	7702	2636	34	7668	6418	1225	1	5	7	12
경상북도	영천시	금호읍	금호읍제1투	2142	1613	529	8	1605	1347	255	0	1	1	1
경상북도	영천시	금호읍	금호읍제2투	2768	2145	623	6	2139	1770	363	0	2	3	1
경상북도	영천시	금호읍	금호읍제3투	1156	895	261	5	890	729	158	0	1	0	2
경상북도	영천시	금호읍	금호읍제4투	1605	1250	355	5	1245	1062	179	1	0	1	2
경상북도	영천시	금호읍	금호읍제5투	893	708	185	4	704	609	90	0	0	1	4
경상북도	영천시	금호읍	금호읍제6투	1774	1091	683	6	1085	901	180	0	1	1	2
경상북도	영천시	청통면	소계	4013	3144	869	22	3122	2641	464	2	2	6	7
경상북도	영천시	청통면	청통면제1투	2681	2078	603	17	2061	1734	317	2	2	3	3
경상북도	영천시	청통면	청통면제2투	1332	1066	266	5	1061	907	147	0	0	3	4
경상북도	영천시	신녕면	소계	3936	3076	860	27	3049	2661	364	3	0	4	17
경상북도	영천시	신녕면	신녕면제1투	2182	1699	483	6	1693	1468	217	2	0	0	6
경상북도	영천시	신녕면	신녕면제2투	1754	1377	377	21	1356	1193	147	1	0	4	11
경상북도	영천시	화산면	소계	3173	2446	727	68	2378	1979	363	5	5	4	22
경상북도	영천시	화산면	화산면제1투	2160	1635	525	59	1576	1308	241	5	4	2	16
경상북도	영천시	화산면	화산면제2투	1013	811	202	9	802	671	122	0	1	2	6
경상북도	영천시	화북면	소계	2021	1547	474	11	1536	1289	230	1	0	2	14
경상북도	영천시	화북면	화북면투표소	2021	1547	474	11	1536	1289	230	1	0	2	14
경상북도	영천시	화남면	소계	2898	2256	642	26	2230	1940	277	1	1	1	10
경상북도	영천시	화남면	화남면제1투	1878	1431	447	22	1409	1243	157	1	1	1	6
경상북도	영천시	화남면	화남면제2투	1020	825	195	4	821	697	120	0	0	0	4
경상북도	영천시	자양면	소계	1065	838	227	11	827	705	111	0	0	1	10
경상북도	영천시	자양면	자양면투표소	1065	838	227	11	827	705	111	0	0	1	10
경상북도	영천시	임고면	소계	3824	2939	885	13	2926	2482	420	0	2	1	21
경상북도	영천시	임고면	임고면제1투	1427	1089	338	4	1085	893	184	0	1	1	6
경상북도	영천시	임고면	임고면제2투	1320	1034	286	5	1029	890	131	0	1	0	7
경상북도	영천시	임고면	임고면제3투	1077	816	261	4	812	699	105	0	0	0	8
경상북도	영천시	고경면	소계	5389	4235	1154	29	4206	3523	655	0	0	7	21
경상북도	영천시	고경면	고경면제1투	1456	1084	372	10	1074	911	156	0	0	1	6
경상북도	영천시	고경면	고경면제2투	2612	2125	487	15	2110	1727	369	0	0	6	8
경상북도	영천시	고경면	고경면제3투	1321	1026	295	4	1022	885	130	0	0	0	7
경상북도	영천시	북안면	소계	4090	3117	973	29	3088	2575	488	0	2	3	20
경상북도	영천시	북안면	북안면제1투	2152	1598	554	22	1576	1330	229	0	1	1	15
경상북도	영천시	북안면	북안면제2투	1938	1519	419	7	1512	1245	259	0	1	2	5
경상북도	영천시	대창면	소계	2882	2248	634	11	2237	1913	308	2	0	1	13
경상북도	영천시	대창면	대창면투표소	2882	2248	634	11	2237	1913	308	2	0	1	13
경상북도	영천시	동부동	소계	19824	15398	4426	39	15359	12284	3026	4	3	21	21
경상북도	영천시	동부동	동부동제1투	3306	2571	735	7	2564	2045	509	1	1	4	4
경상북도	영천시	동부동	동부동제2투	3406	2522	884	7	2515	2046	465	0	0	3	1
경상북도	영천시	동부동	동부동제3투	3308	2611	697	5	2606	2104	497	2	0	3	0
경상북도	영천시	동부동	동부동제4투	2722	2084	638	5	2079	1734	337	0	0	4	4
경상북도	영천시	동부동	동부동제5투	3413	2746	667	9	2737	2136	589	0	2	2	8
경상북도	영천시	동부동	동부동제6투	3669	2864	805	6	2858	2219	629	1	0	5	4
경상북도	영천시	중앙동	소계	7450	5816	1634	24	5792	4658	1114	2	1	5	12
경상북도	영천시	중앙동	중앙동제1투	3839	2910	929	11	2899	2259	627	2	1	2	8
경상북도	영천시	중앙동	중앙동제2투	2455	2023	432	8	2015	1629	381	0	0	2	3
경상북도	영천시	중앙동	중앙동제3투	1156	883	273	5	878	770	106	0	0	1	1
경상북도	영천시	서부동	소계	4791	3680	1111	10	3670	3083	572	0	1	4	10
경상북도	영천시	서부동	서부동제1투	2611	2039	572	5	2034	1689	338	0	1	1	5
경상북도	영천시	서부동	서부동제2투	2180	1641	539	5	1636	1394	234	0	0	3	5
경상북도	영천시	완산동	소계	4014	3070	944	4	3066	2546	515	0	1	1	3
경상북도	영천시	완산동	완산동제1투	2286	1759	527	3	1756	1451	300	0	1	1	3
경상북도	영천시	완산동	완산동제2투	1728	1311	417	1	1310	1095	215	0	0	0	0
경상북도	영천시	남부동	소계	3243	2441	802	8	2433	2107	317	0	1	2	6
경상북도	영천시	남부동	남부동제1투	1233	898	335	0	898	788	107	0	0	1	2
경상북도	영천시	남부동	남부동제2투	2010	1543	467	8	1535	1319	210	0	1	1	4
경상북도	상주시	계	계	87996	69898	18098	473	69425	58560	10254	26	34	89	462
경상북도	상주시	재외투표	재외투표	381	255	126	0	255	179	73	0	1	0	2
경상북도	상주시	국내부재자투표	국내부재자투표	4029	3504	525	86	3418	2331	1049	6	3	9	20
경상북도	상주시	함창읍	소계	5771	4596	1175	23	4573	3981	554	0	1	5	32
경상북도	상주시	함창읍	함창읍제1투	2004	1568	436	6	1562	1352	197	0	0	1	12
경상북도	상주시	함창읍	함창읍제2투	1990	1609	381	8	1601	1369	222	0	0	3	7
경상북도	상주시	함창읍	함창읍제3투	1777	1419	358	9	1410	1260	135	0	1	1	13
경상북도	상주시	사벌면	소계	3591	2985	606	34	2951	2603	313	1	2	2	30
경상북도	상주시	사벌면	사벌면제1투	2315	1907	408	24	1883	1662	196	1	2	2	20
경상북도	상주시	사벌면	사벌면제2투	1276	1078	198	10	1068	941	117	0	0	0	10
경상북도	상주시	중동면	소계	1505	1207	298	10	1197	1093	93	1	0	1	9
경상북도	상주시	중동면	중동면투표소	1505	1207	298	10	1197	1093	93	1	0	1	9
경상북도	상주시	낙동면	소계	3927	3117	810	29	3088	2735	315	1	1	2	34
경상북도	상주시	낙동면	낙동면제1투	1806	1407	399	11	1396	1232	152	0	0	1	11
경상북도	상주시	낙동면	낙동면제2투	1038	816	222	2	814	730	78	1	1	0	4
경상북도	상주시	낙동면	낙동면제3투	1083	894	189	16	878	773	85	0	0	1	19
경상북도	상주시	청리면	소계	2809	2245	564	19	2226	2015	193	0	0	2	16
경상북도	상주시	청리면	청리면제1투	1853	1469	384	11	1458	1311	134	0	0	1	12
경상북도	상주시	청리면	청리면제2투	956	776	180	8	768	704	59	0	0	1	4
경상북도	상주시	공성면	소계	4176	3188	988	27	3161	2825	302	0	2	3	29
경상북도	상주시	공성면	공성면제1투	1654	1287	367	4	1283	1159	116	0	1	0	7
경상북도	상주시	공성면	공성면제2투	1545	1146	399	13	1133	1007	112	0	1	1	12
경상북도	상주시	공성면	공성면제3투	977	755	222	10	745	659	74	0	0	2	10
경상북도	상주시	외남면	소계	1695	1358	337	15	1343	1179	150	0	0	1	13
경상북도	상주시	외남면	외남면투표소	1695	1358	337	15	1343	1179	150	0	0	1	13
경상북도	상주시	내서면	소계	1786	1479	307	12	1467	1280	163	1	1	4	18
경상북도	상주시	내서면	내서면제1투	829	670	159	5	665	598	57	1	0	1	8
경상북도	상주시	내서면	내서면제2투	957	809	148	7	802	682	106	0	1	3	10
경상북도	상주시	모동면	소계	2372	1820	552	10	1810	1457	343	0	1	2	7
경상북도	상주시	모동면	모동면제1투	1315	1001	314	6	995	814	174	0	1	2	4
경상북도	상주시	모동면	모동면제2투	1057	819	238	4	815	643	169	0	0	0	3
경상북도	상주시	모서면	소계	2371	1813	558	20	1793	1500	270	1	1	2	19
경상북도	상주시	모서면	모서면제1투	1649	1255	394	11	1244	1060	174	0	0	1	9
경상북도	상주시	모서면	모서면제2투	722	558	164	9	549	440	96	1	1	1	10
경상북도	상주시	화동면	소계	1901	1506	395	7	1499	1296	185	0	0	3	15
경상북도	상주시	화동면	화동면투표소	1901	1506	395	7	1499	1296	185	0	0	3	15
경상북도	상주시	화서면	소계	2506	1955	551	16	1939	1675	230	0	4	5	25
경상북도	상주시	화서면	화서면제1투	1224	955	269	6	949	821	115	0	0	1	12
경상북도	상주시	화서면	화서면제2투	1282	1000	282	10	990	854	115	0	4	4	13
경상북도	상주시	화북면	소계	1382	1159	223	8	1151	935	195	4	2	4	11
경상북도	상주시	화북면	화북면투표소	1382	1159	223	8	1151	935	195	4	2	4	11
경상북도	상주시	외서면	소계	2607	2075	532	13	2062	1744	287	0	1	1	29
경상북도	상주시	외서면	외서면제1투	1719	1358	361	10	1348	1120	207	0	1	1	19
경상북도	상주시	외서면	외서면제2투	888	717	171	3	714	624	80	0	0	0	10
경상북도	상주시	은척면	소계	1557	1248	309	12	1236	1115	107	0	0	1	13
경상북도	상주시	은척면	은척면제1투	1205	957	248	9	948	850	88	0	0	1	9
경상북도	상주시	은척면	은척면제2투	352	291	61	3	288	265	19	0	0	0	4
경상북도	상주시	공검면	소계	2227	1836	391	14	1822	1624	166	0	2	4	26
경상북도	상주시	공검면	공검면제1투	1340	1103	237	8	1095	983	99	0	2	2	9
경상북도	상주시	공검면	공검면제2투	887	733	154	6	727	641	67	0	0	2	17
경상북도	상주시	이안면	소계	1985	1639	346	19	1620	1456	130	1	1	1	31
경상북도	상주시	이안면	이안면제1투	1291	1062	229	10	1052	944	80	0	1	1	26
경상북도	상주시	이안면	이안면제2투	694	577	117	9	568	512	50	1	0	0	5
경상북도	상주시	화남면	소계	756	574	182	4	570	488	69	0	1	4	8
경상북도	상주시	화남면	화남면투표소	756	574	182	4	570	488	69	0	1	4	8
경상북도	상주시	남원동	소계	9444	7469	1975	21	7448	6162	1268	1	0	7	10
경상북도	상주시	남원동	남원동제1투	2107	1570	537	7	1563	1325	234	0	0	2	2
경상북도	상주시	남원동	남원동제2투	1227	983	244	1	982	834	145	0	0	2	1
경상북도	상주시	남원동	남원동제3투	1732	1413	319	3	1410	1143	262	0	0	2	3
경상북도	상주시	남원동	남원동제4투	1462	1158	304	1	1157	937	218	0	0	1	1
경상북도	상주시	남원동	남원동제5투	1144	936	208	4	932	762	168	1	0	0	1
경상북도	상주시	남원동	남원동제6투	1772	1409	363	5	1404	1161	241	0	0	0	2
경상북도	상주시	북문동	소계	4860	3755	1105	12	3743	3130	594	1	2	4	12
경상북도	상주시	북문동	북문동제1투	1336	1006	330	3	1003	844	155	0	1	1	2
경상북도	상주시	북문동	북문동제2투	1165	935	230	2	933	773	157	1	1	0	1
경상북도	상주시	북문동	북문동제3투	1639	1238	401	4	1234	1000	228	0	0	3	3
경상북도	상주시	북문동	북문동제4투	720	576	144	3	573	513	54	0	0	0	6
경상북도	상주시	계림동	소계	6676	5214	1462	18	5196	4385	789	6	1	2	13
경상북도	상주시	계림동	계림동제1투	2461	1914	547	14	1900	1620	269	4	0	0	7
경상북도	상주시	계림동	계림동제2투	2199	1734	465	2	1732	1429	300	1	0	2	0
경상북도	상주시	계림동	계림동제3투	2016	1566	450	2	1564	1336	220	1	1	0	6
경상북도	상주시	동문동	소계	7283	5725	1558	18	5707	4755	924	0	4	10	14
경상북도	상주시	동문동	동문동제1투	2840	2283	557	4	2279	1794	473	0	3	8	1
경상북도	상주시	동문동	동문동제2투	1541	1180	361	6	1174	1039	125	0	1	0	9
경상북도	상주시	동문동	동문동제3투	1750	1370	380	5	1365	1182	179	0	0	1	3
경상북도	상주시	동문동	동문동제4투	1152	892	260	3	889	740	147	0	0	1	1
경상북도	상주시	동성동	소계	3506	2715	791	8	2707	2332	362	0	0	2	11
경상북도	상주시	동성동	동성동제1투	1501	1158	343	5	1153	966	183	0	0	1	3
경상북도	상주시	동성동	동성동제2투	1010	775	235	1	774	671	99	0	0	1	3
경상북도	상주시	동성동	동성동제3투	995	782	213	2	780	695	80	0	0	0	5
경상북도	상주시	신흥동	소계	6893	5461	1432	18	5443	4285	1130	2	3	8	15
경상북도	상주시	신흥동	신흥동제1투	2533	2036	497	8	2028	1611	409	0	1	4	3
경상북도	상주시	신흥동	신흥동제2투	1367	1037	330	6	1031	892	127	1	1	0	10
경상북도	상주시	신흥동	신흥동제3투	2993	2388	605	4	2384	1782	594	1	1	4	2
경상북도	문경시	계	계	63468	50066	13402	349	49717	41762	7609	24	27	69	226
경상북도	문경시	재외투표	재외투표	211	152	59	2	150	87	63	0	0	0	0
경상북도	문경시	국내부재자투표	국내부재자투표	3654	3149	505	148	3001	2090	861	9	7	17	17
경상북도	문경시	문경읍	소계	6141	4702	1439	26	4676	4135	514	2	0	3	22
경상북도	문경시	문경읍	문경읍제1투	2792	2079	713	9	2070	1827	234	1	0	0	8
경상북도	문경시	문경읍	문경읍제2투	2388	1880	508	10	1870	1660	201	1	0	3	5
경상북도	문경시	문경읍	문경읍제3투	961	743	218	7	736	648	79	0	0	0	9
경상북도	문경시	가은읍	소계	3672	2849	823	25	2824	2407	383	3	4	4	23
경상북도	문경시	가은읍	가은읍제1투	2975	2332	643	19	2313	2021	268	2	1	4	17
경상북도	문경시	가은읍	가은읍제2투	697	517	180	6	511	386	115	1	3	0	6
경상북도	문경시	영순면	소계	2221	1788	433	9	1779	1587	173	0	0	1	18
경상북도	문경시	영순면	영순면투표소	2221	1788	433	9	1779	1587	173	0	0	1	18
경상북도	문경시	산양면	소계	2979	2420	559	10	2410	2128	265	0	3	2	12
경상북도	문경시	산양면	산양면제1투	1498	1199	299	5	1194	1066	119	0	2	2	5
경상북도	문경시	산양면	산양면제2투	1481	1221	260	5	1216	1062	146	0	1	0	7
경상북도	문경시	호계면	소계	2165	1649	516	9	1640	1441	178	0	2	4	15
경상북도	문경시	호계면	호계면투표소	2165	1649	516	9	1640	1441	178	0	2	4	15
경상북도	문경시	산북면	소계	2614	2105	509	16	2089	1827	236	1	2	2	21
경상북도	문경시	산북면	산북면투표소	2614	2105	509	16	2089	1827	236	1	2	2	21
경상북도	문경시	동로면	소계	1558	1209	349	9	1200	1021	162	0	1	3	13
경상북도	문경시	동로면	동로면투표소	1558	1209	349	9	1200	1021	162	0	1	3	13
경상북도	문경시	마성면	소계	3257	2555	702	14	2541	2252	265	1	3	2	18
경상북도	문경시	마성면	마성면제1투	1458	1127	331	7	1120	1005	104	1	1	1	8
경상북도	문경시	마성면	마성면제2투	1799	1428	371	7	1421	1247	161	0	2	1	10
경상북도	문경시	농암면	소계	2304	1855	449	13	1842	1625	191	4	0	1	21
경상북도	문경시	농암면	농암면제1투	1558	1249	309	8	1241	1097	128	1	0	1	14
경상북도	문경시	농암면	농암면제2투	746	606	140	5	601	528	63	3	0	0	7
경상북도	문경시	점촌1동	소계	5040	3909	1131	9	3900	3356	533	0	0	3	8
경상북도	문경시	점촌1동	점촌1동제1투	2074	1570	504	5	1565	1336	226	0	0	2	1
경상북도	문경시	점촌1동	점촌1동제2투	1465	1161	304	0	1161	1014	144	0	0	1	2
경상북도	문경시	점촌1동	점촌1동제3투	1501	1178	323	4	1174	1006	163	0	0	0	5
경상북도	문경시	점촌2동	소계	6535	5082	1453	12	5070	4392	667	0	0	7	4
경상북도	문경시	점촌2동	점촌2동제1투	2447	1900	547	6	1894	1663	226	0	0	2	3
경상북도	문경시	점촌2동	점촌2동제2투	1478	1159	319	3	1156	1012	141	0	0	3	0
경상북도	문경시	점촌2동	점촌2동제3투	2610	2023	587	3	2020	1717	300	0	0	2	1
경상북도	문경시	점촌3동	소계	7724	6002	1722	14	5988	4967	1003	0	1	5	12
경상북도	문경시	점촌3동	점촌3동제1투	3447	2681	766	6	2675	2265	397	0	1	3	9
경상북도	문경시	점촌3동	점촌3동제2투	4277	3321	956	8	3313	2702	606	0	0	2	3
경상북도	문경시	점촌4동	소계	3057	2356	701	17	2339	2026	293	1	0	4	15
경상북도	문경시	점촌4동	점촌4동제1투	1750	1318	432	7	1311	1148	150	1	0	1	11
경상북도	문경시	점촌4동	점촌4동제2투	1307	1038	269	10	1028	878	143	0	0	3	4
경상북도	문경시	점촌5동	소계	10336	8284	2052	16	8268	6421	1822	3	4	11	7
경상북도	문경시	점촌5동	점촌5동제1투	4372	3440	932	9	3431	2666	754	2	2	2	5
경상북도	문경시	점촌5동	점촌5동제2투	2757	2190	567	2	2188	1744	437	1	2	2	2
경상북도	문경시	점촌5동	점촌5동제3투	3207	2654	553	5	2649	2011	631	0	0	7	0
경상북도	예천군	계	계	40063	32134	7929	432	31702	26663	4564	112	47	55	261
경상북도	예천군	재외투표	재외투표	196	142	54	3	139	88	51	0	0	0	0
경상북도	예천군	국내부재자투표	국내부재자투표	2082	1845	237	100	1745	1232	492	3	6	9	3
경상북도	예천군	예천읍	소계	13578	10609	2969	71	10538	8707	1757	31	4	11	28
경상북도	예천군	예천읍	예천읍제1투	2277	1689	588	5	1684	1389	289	2	0	2	2
경상북도	예천군	예천읍	예천읍제2투	2648	2134	514	13	2121	1722	382	5	4	3	5
경상북도	예천군	예천읍	예천읍제3투	2708	2051	657	18	2033	1671	343	8	0	4	7
경상북도	예천군	예천읍	예천읍제4투	2618	2104	514	17	2087	1766	302	9	0	2	8
경상북도	예천군	예천읍	예천읍제5투	3327	2631	696	18	2613	2159	441	7	0	0	6
경상북도	예천군	용문면	소계	2308	1883	425	11	1872	1622	225	1	2	3	19
경상북도	예천군	용문면	용문면투표소	2308	1883	425	11	1872	1622	225	1	2	3	19
경상북도	예천군	상리면	소계	1062	857	205	5	852	719	116	0	0	2	15
경상북도	예천군	상리면	상리면제1투	589	470	119	2	468	388	68	0	0	2	10
경상북도	예천군	상리면	상리면제2투	473	387	86	3	384	331	48	0	0	0	5
경상북도	예천군	하리면	소계	1249	1052	197	10	1042	890	138	2	0	2	10
경상북도	예천군	하리면	하리면투표소	1249	1052	197	10	1042	890	138	2	0	2	10
경상북도	예천군	감천면	소계	2577	2062	515	23	2039	1738	272	1	0	4	24
경상북도	예천군	감천면	감천면제1투	1628	1291	337	18	1273	1079	178	1	0	1	14
경상북도	예천군	감천면	감천면제2투	949	771	178	5	766	659	94	0	0	3	10
경상북도	예천군	보문면	소계	1629	1336	293	20	1316	1133	160	0	0	2	21
경상북도	예천군	보문면	보문면제1투	842	686	156	7	679	585	86	0	0	0	8
경상북도	예천군	보문면	보문면제2투	787	650	137	13	637	548	74	0	0	2	13
경상북도	예천군	호명면	소계	2463	1970	493	35	1935	1677	212	10	2	4	30
경상북도	예천군	호명면	호명면제1투	1348	1079	269	18	1061	922	117	5	1	1	15
경상북도	예천군	호명면	호명면제2투	1115	891	224	17	874	755	95	5	1	3	15
경상북도	예천군	유천면	소계	2566	2042	524	22	2020	1692	296	2	2	4	24
경상북도	예천군	유천면	유천면투표소	2566	2042	524	22	2020	1692	296	2	2	4	24
경상북도	예천군	용궁면	소계	2620	2133	487	23	2110	1860	216	3	1	2	28
경상북도	예천군	용궁면	용궁면제1투	1714	1394	320	12	1382	1221	146	1	1	1	12
경상북도	예천군	용궁면	용궁면제2투	906	739	167	11	728	639	70	2	0	1	16
경상북도	예천군	개포면	소계	1517	1241	276	9	1232	1095	117	0	0	5	15
경상북도	예천군	개포면	개포면투표소	1517	1241	276	9	1232	1095	117	0	0	5	15
경상북도	예천군	지보면	소계	2939	2331	608	51	2280	1942	263	30	21	4	20
경상북도	예천군	지보면	지보면제1투	2088	1669	419	35	1634	1397	186	15	19	3	14
경상북도	예천군	지보면	지보면제2투	851	662	189	16	646	545	77	15	2	1	6
경상북도	예천군	풍양면	소계	3277	2630	647	49	2581	2267	249	29	9	3	24
경상북도	예천군	풍양면	풍양면제1투	1903	1510	393	28	1482	1299	147	16	7	1	12
경상북도	예천군	풍양면	풍양면제2투	1374	1120	254	21	1099	968	102	13	2	2	12
경상북도	예천군	잘못 투입·구분된 투표지	잘못 투입·구분된 투표지	0	1	-1	0	1	1	0	0	0	0	0
경상북도	경산시	계	계	195908	151391	44517	799	150592	118865	30881	124	120	280	322
경상북도	경산시	재외투표	재외투표	759	494	265	1	493	251	241	0	0	1	0
경상북도	경산시	국내부재자투표	국내부재자투표	5126	4803	323	74	4729	3211	1482	5	7	14	10
경상북도	경산시	하양읍	소계	20311	15828	4483	92	15736	12700	2935	13	9	26	53
경상북도	경산시	하양읍	하양읍제1투	2597	1828	769	7	1821	1484	325	2	2	5	3
경상북도	경산시	하양읍	하양읍제2투	2877	2283	594	10	2273	1812	449	0	2	4	6
경상북도	경산시	하양읍	하양읍제3투	4487	3580	907	11	3569	2705	854	1	0	6	3
경상북도	경산시	하양읍	하양읍제4투	990	795	195	6	789	699	82	2	0	2	4
경상북도	경산시	하양읍	하양읍제5투	1609	1246	363	13	1233	995	226	2	0	2	8
경상북도	경산시	하양읍	하양읍제6투	3253	2485	768	28	2457	2071	365	2	1	4	14
경상북도	경산시	하양읍	하양읍제7투	2358	1812	546	14	1798	1512	267	4	3	3	9
경상북도	경산시	하양읍	하양읍제8투	2140	1799	341	3	1796	1422	367	0	1	0	6
경상북도	경산시	진량읍	소계	28464	21553	6911	115	21438	16926	4378	38	16	34	46
경상북도	경산시	진량읍	진량읍제1투	4189	2913	1276	14	2899	2221	671	2	1	2	2
경상북도	경산시	진량읍	진량읍제2투	2401	1830	571	8	1822	1446	369	1	2	0	4
경상북도	경산시	진량읍	진량읍제3투	1832	1313	519	15	1298	1135	148	2	2	2	9
경상북도	경산시	진량읍	진량읍제4투	2811	2086	725	12	2074	1675	387	1	3	3	5
경상북도	경산시	진량읍	진량읍제5투	2389	1696	693	33	1663	1306	323	14	1	5	14
경상북도	경산시	진량읍	진량읍제6투	2847	2305	542	8	2297	1821	467	1	1	3	4
경상북도	경산시	진량읍	진량읍제7투	2393	1891	502	6	1885	1480	397	1	0	4	3
경상북도	경산시	진량읍	진량읍제8투	1257	991	266	6	985	811	159	9	1	3	2
경상북도	경산시	진량읍	진량읍제9투	3454	2627	827	6	2621	2025	588	3	1	4	0
경상북도	경산시	진량읍	진량읍제10투	1992	1577	415	4	1573	1242	324	3	1	2	1
경상북도	경산시	진량읍	진량읍제11투	2899	2324	575	3	2321	1764	545	1	3	6	2
경상북도	경산시	와촌면	소계	5421	4091	1330	35	4056	3457	558	8	4	12	17
경상북도	경산시	와촌면	와촌면제1투	1887	1379	508	11	1368	1189	165	2	1	3	8
경상북도	경산시	와촌면	와촌면제2투	1931	1507	424	13	1494	1255	226	4	3	2	4
경상북도	경산시	와촌면	와촌면제3투	1603	1205	398	11	1194	1013	167	2	0	7	5
경상북도	경산시	자인면	소계	5427	4169	1258	35	4134	3561	526	3	6	19	19
경상북도	경산시	자인면	자인면제1투	1729	1376	353	10	1366	1183	163	3	2	5	10
경상북도	경산시	자인면	자인면제2투	1830	1414	416	12	1402	1210	176	0	2	9	5
경상북도	경산시	자인면	자인면제3투	1868	1379	489	13	1366	1168	187	0	2	5	4
경상북도	경산시	용성면	소계	3254	2578	676	43	2535	2152	337	4	4	10	28
경상북도	경산시	용성면	용성면제1투	1509	1151	358	14	1137	959	156	1	2	4	15
경상북도	경산시	용성면	용성면제2투	1352	1098	254	22	1076	934	130	3	1	3	5
경상북도	경산시	용성면	용성면제3투	393	329	64	7	322	259	51	0	1	3	8
경상북도	경산시	남산면	소계	3351	2627	724	40	2587	2242	312	2	6	14	11
경상북도	경산시	남산면	남산면제1투	2207	1728	479	29	1699	1461	212	2	5	9	10
경상북도	경산시	남산면	남산면제2투	1144	899	245	11	888	781	100	0	1	5	1
경상북도	경산시	압량면	소계	12115	8839	3276	54	8785	6986	1750	11	2	18	18
경상북도	경산시	압량면	압량면제1투	3171	2173	998	7	2166	1701	454	2	0	6	3
경상북도	경산시	압량면	압량면제2투	2369	1826	543	11	1815	1512	287	5	1	5	5
경상북도	경산시	압량면	압량면제3투	2763	2060	703	7	2053	1722	323	1	0	4	3
경상북도	경산시	압량면	압량면제4투	1033	812	221	19	793	675	111	2	1	0	4
경상북도	경산시	압량면	압량면제5투	2779	1968	811	10	1958	1376	575	1	0	3	3
경상북도	경산시	남천면	소계	3006	2404	602	19	2385	2053	300	1	10	4	17
경상북도	경산시	남천면	남천면제1투	1878	1493	385	7	1486	1278	195	0	7	3	3
경상북도	경산시	남천면	남천면제2투	1128	911	217	12	899	775	105	1	3	1	14
경상북도	경산시	중앙동	소계	5909	4510	1399	18	4492	3724	742	2	3	9	12
경상북도	경산시	중앙동	중앙동제1투	3713	2878	835	9	2869	2381	472	2	2	6	6
경상북도	경산시	중앙동	중앙동제2투	2196	1632	564	9	1623	1343	270	0	1	3	6
경상북도	경산시	동부동	소계	24085	18367	5718	78	18289	14415	3796	13	14	24	27
경상북도	경산시	동부동	동부동제1투	2531	1907	624	10	1897	1562	323	2	1	2	7
경상북도	경산시	동부동	동부동제2투	1632	1215	417	16	1199	1050	143	2	2	0	2
경상북도	경산시	동부동	동부동제3투	3060	2271	789	9	2262	1848	403	0	0	4	7
경상북도	경산시	동부동	동부동제4투	2143	1647	496	5	1642	1349	285	1	2	3	2
경상북도	경산시	동부동	동부동제5투	2058	1526	532	5	1521	1237	275	3	1	4	1
경상북도	경산시	동부동	동부동제6투	3141	2384	757	8	2376	1861	508	1	1	3	2
경상북도	경산시	동부동	동부동제7투	3391	2579	812	5	2574	1890	678	2	2	1	1
경상북도	경산시	동부동	동부동제8투	2293	1876	417	6	1870	1395	469	1	2	3	0
경상북도	경산시	동부동	동부동제9투	3836	2962	874	14	2948	2223	712	1	3	4	5
경상북도	경산시	서부1동	소계	30073	23440	6633	73	23367	18102	5186	7	11	35	26
경상북도	경산시	서부1동	서부1동제1투	3457	2763	694	11	2752	2128	611	1	2	6	4
경상북도	경산시	서부1동	서부1동제2투	4984	3742	1242	13	3729	2932	783	1	5	3	5
경상북도	경산시	서부1동	서부1동제3투	2762	2053	709	8	2045	1630	405	1	0	3	6
경상북도	경산시	서부1동	서부1동제4투	2151	1608	543	5	1603	1194	402	1	3	2	1
경상북도	경산시	서부1동	서부1동제5투	2898	2172	726	10	2162	1741	418	1	0	0	2
경상북도	경산시	서부1동	서부1동제6투	3206	2677	529	7	2670	2133	531	0	0	4	2
경상북도	경산시	서부1동	서부1동제7투	3629	2858	771	7	2851	2299	542	0	1	6	3
경상북도	경산시	서부1동	서부1동제8투	3297	2569	728	6	2563	1907	650	2	0	3	1
경상북도	경산시	서부1동	서부1동제9투	3689	2998	691	6	2992	2138	844	0	0	8	2
경상북도	경산시	서부2동	소계	15884	13125	2759	26	13099	10005	3039	5	8	22	20
경상북도	경산시	서부2동	서부2동제1투	2691	2168	523	4	2164	1649	502	2	0	6	5
경상북도	경산시	서부2동	서부2동제2투	2535	2077	458	5	2072	1605	459	1	0	6	1
경상북도	경산시	서부2동	서부2동제3투	3267	2745	522	5	2740	2166	564	1	4	2	3
경상북도	경산시	서부2동	서부2동제4투	2589	2232	357	4	2228	1656	562	0	2	3	5
경상북도	경산시	서부2동	서부2동제5투	2794	2343	451	4	2339	1741	593	1	1	2	1
경상북도	경산시	서부2동	서부2동제6투	2008	1560	448	4	1556	1188	359	0	1	3	5
경상북도	경산시	남부동	소계	13253	10247	3006	37	10210	8055	2121	5	10	12	7
경상북도	경산시	남부동	남부동제1투	3421	2546	875	12	2534	2046	481	1	3	1	2
경상북도	경산시	남부동	남부동제2투	1039	781	258	4	777	660	113	0	0	2	2
경상북도	경산시	남부동	남부동제3투	2282	1801	481	12	1789	1447	332	1	5	1	3
경상북도	경산시	남부동	남부동제4투	3620	2940	680	9	2931	2221	706	2	0	2	0
경상북도	경산시	남부동	남부동제5투	2891	2179	712	0	2179	1681	489	1	2	6	0
경상북도	경산시	북부동	소계	10434	7090	3344	24	7066	5292	1742	5	6	13	8
경상북도	경산시	북부동	북부동제1투	3432	2811	621	7	2804	2090	699	3	3	7	2
경상북도	경산시	북부동	북부동제2투	2795	1535	1260	9	1526	1136	383	2	1	2	2
경상북도	경산시	북부동	북부동제3투	4207	2744	1463	8	2736	2066	660	0	2	4	4
경상북도	경산시	중방동	소계	9036	7209	1827	35	7174	5719	1433	2	4	13	3
경상북도	경산시	중방동	중방동제1투	2569	1926	643	11	1915	1580	330	0	1	4	0
경상북도	경산시	중방동	중방동제2투	2282	1769	513	10	1759	1459	294	0	2	2	2
경상북도	경산시	중방동	중방동제3투	4185	3514	671	14	3500	2680	809	2	1	7	1
경상북도	경산시	잘못 투입·구분된 투표지	잘못 투입·구분된 투표지	0	17	-17	0	17	14	3	0	0	0	0
경상북도	청도군	계	계	38961	30946	8015	250	30696	25625	4830	16	16	34	175
경상북도	청도군	재외투표	재외투표	322	237	85	1	236	167	69	0	0	0	0
경상북도	청도군	국내부재자투표	국내부재자투표	2806	2158	648	63	2095	1586	492	2	3	5	7
경상북도	청도군	청도읍	소계	10124	7907	2217	46	7861	6484	1328	3	2	5	39
경상북도	청도군	청도읍	청도읍제1투	2885	2243	642	5	2238	1822	406	0	0	1	9
경상북도	청도군	청도읍	청도읍제2투	3194	2462	732	10	2452	1974	464	0	1	3	10
경상북도	청도군	청도읍	청도읍제3투	1001	807	194	11	796	673	115	0	0	1	7
경상북도	청도군	청도읍	청도읍제4투	1507	1194	313	10	1184	1003	170	0	1	0	10
경상북도	청도군	청도읍	청도읍제5투	1537	1201	336	10	1191	1012	173	3	0	0	3
경상북도	청도군	화양읍	소계	6187	4935	1252	27	4908	4008	870	1	4	8	17
경상북도	청도군	화양읍	화양읍제1투	1547	1205	342	8	1197	1003	186	0	0	3	5
경상북도	청도군	화양읍	화양읍제2투	2761	2211	550	10	2201	1746	441	1	2	4	7
경상북도	청도군	화양읍	화양읍제3투	812	666	146	2	664	535	125	0	2	0	2
경상북도	청도군	화양읍	화양읍제4투	1067	853	214	7	846	724	118	0	0	1	3
경상북도	청도군	각남면	소계	1878	1592	286	6	1586	1360	207	3	0	2	14
경상북도	청도군	각남면	각남면제1투	1250	1053	197	4	1049	881	161	1	0	1	5
경상북도	청도군	각남면	각남면제2투	628	539	89	2	537	479	46	2	0	1	9
경상북도	청도군	풍각면	소계	3514	2760	754	28	2732	2370	332	0	0	2	28
경상북도	청도군	풍각면	풍각면제1투	2105	1626	479	16	1610	1401	199	0	0	2	8
경상북도	청도군	풍각면	풍각면제2투	865	673	192	9	664	580	71	0	0	0	13
경상북도	청도군	풍각면	풍각면제3투	544	461	83	3	458	389	62	0	0	0	7
경상북도	청도군	각북면	소계	1897	1499	398	11	1488	1288	190	1	0	0	9
경상북도	청도군	각북면	각북면투표소	1897	1499	398	11	1488	1288	190	1	0	0	9
경상북도	청도군	이서면	소계	3803	3139	664	15	3124	2678	423	4	2	7	10
경상북도	청도군	이서면	이서면제1투	2567	2130	437	10	2120	1793	313	2	0	6	6
경상북도	청도군	이서면	이서면제2투	1236	1009	227	5	1004	885	110	2	2	1	4
경상북도	청도군	운문면	소계	2005	1574	431	14	1560	1290	257	0	3	1	9
경상북도	청도군	운문면	운문면제1투	632	487	145	3	484	418	65	0	0	0	1
경상북도	청도군	운문면	운문면제2투	786	615	171	4	611	484	122	0	1	1	3
경상북도	청도군	운문면	운문면제3투	587	472	115	7	465	388	70	0	2	0	5
경상북도	청도군	금천면	소계	3026	2415	611	18	2397	2066	306	2	1	0	22
경상북도	청도군	금천면	금천면제1투	1168	915	253	7	908	775	123	0	1	0	9
경상북도	청도군	금천면	금천면제2투	693	554	139	4	550	483	63	0	0	0	4
경상북도	청도군	금천면	금천면제3투	1165	946	219	7	939	808	120	2	0	0	9
경상북도	청도군	매전면	소계	3399	2730	669	21	2709	2328	356	0	1	4	20
경상북도	청도군	매전면	매전면제1투	914	721	193	1	720	629	84	0	0	1	6
경상북도	청도군	매전면	매전면제2투	806	656	150	4	652	552	94	0	1	1	4
경상북도	청도군	매전면	매전면제3투	594	477	117	6	471	423	45	0	0	0	3
경상북도	청도군	매전면	매전면제4투	1085	876	209	10	866	724	133	0	0	2	7
경상북도	고령군	계	계	30320	23847	6473	164	23683	20030	3437	14	17	39	146
경상북도	고령군	재외투표	재외투표	293	190	103	3	187	137	50	0	0	0	0
경상북도	고령군	국내부재자투표	국내부재자투표	1312	1188	124	41	1147	831	304	2	5	2	3
경상북도	고령군	고령읍	소계	8429	6399	2030	27	6372	5364	966	1	4	6	31
경상북도	고령군	고령읍	고령읍제1투	2192	1703	489	2	1701	1439	250	0	0	2	10
경상북도	고령군	고령읍	고령읍제2투	560	452	108	3	449	392	54	0	0	0	3
경상북도	고령군	고령읍	고령읍제3투	2682	1909	773	11	1898	1592	293	0	2	1	10
경상북도	고령군	고령읍	고령읍제4투	481	378	103	2	376	337	38	0	0	0	1
경상북도	고령군	고령읍	고령읍제5투	2514	1957	557	9	1948	1604	331	1	2	3	7
경상북도	고령군	덕곡면	소계	1305	1056	249	4	1052	923	114	1	0	1	13
경상북도	고령군	덕곡면	덕곡면제1투	802	659	143	1	658	581	69	0	0	1	7
경상북도	고령군	덕곡면	덕곡면제2투	503	397	106	3	394	342	45	1	0	0	6
경상북도	고령군	운수면	소계	1796	1424	372	10	1414	1255	138	0	1	1	19
경상북도	고령군	운수면	운수면제1투	1318	1027	291	7	1020	913	91	0	0	1	15
경상북도	고령군	운수면	운수면제2투	478	397	81	3	394	342	47	0	1	0	4
경상북도	고령군	성산면	소계	2383	1930	453	10	1920	1667	233	1	1	3	15
경상북도	고령군	성산면	성산면제1투	1642	1317	325	4	1313	1129	169	1	1	3	10
경상북도	고령군	성산면	성산면제2투	741	613	128	6	607	538	64	0	0	0	5
경상북도	고령군	다산면	소계	7706	6085	1621	22	6063	5070	955	3	3	19	13
경상북도	고령군	다산면	다산면제1투	2287	1777	510	3	1774	1530	232	1	1	6	4
경상북도	고령군	다산면	다산면제2투	4231	3372	859	10	3362	2746	598	2	2	9	5
경상북도	고령군	다산면	다산면제3투	1188	936	252	9	927	794	125	0	0	4	4
경상북도	고령군	개진면	소계	2030	1605	425	10	1595	1396	178	2	1	3	15
경상북도	고령군	개진면	개진면제1투	967	753	214	3	750	664	77	1	0	1	7
경상북도	고령군	개진면	개진면제2투	1063	852	211	7	845	732	101	1	1	2	8
경상북도	고령군	우곡면	소계	1701	1343	358	18	1325	1148	159	1	0	1	16
경상북도	고령군	우곡면	우곡면제1투	680	527	153	7	520	429	88	0	0	0	3
경상북도	고령군	우곡면	우곡면제2투	1021	816	205	11	805	719	71	1	0	1	13
경상북도	고령군	쌍림면	소계	3365	2627	738	19	2608	2239	340	3	2	3	21
경상북도	고령군	쌍림면	쌍림면제1투	1212	908	304	6	902	772	118	2	0	2	8
경상북도	고령군	쌍림면	쌍림면제2투	923	746	177	8	738	637	92	1	2	0	6
경상북도	고령군	쌍림면	쌍림면제3투	1230	973	257	5	968	830	130	0	0	1	7
경상북도	성주군	계	계	39274	31019	8255	193	30826	26511	4077	12	13	36	177
경상북도	성주군	재외투표	재외투표	240	170	70	2	168	94	71	1	1	0	1
경상북도	성주군	국내부재자투표	국내부재자투표	1514	1375	139	24	1351	985	358	0	1	4	3
경상북도	성주군	성주읍	소계	10082	7838	2244	23	7815	6734	1040	2	2	8	29
경상북도	성주군	성주읍	성주읍제1투	2436	1932	504	5	1927	1678	245	0	0	0	4
경상북도	성주군	성주읍	성주읍제2투	2904	2165	739	7	2158	1846	300	2	0	2	8
경상북도	성주군	성주읍	성주읍제3투	2226	1757	469	4	1753	1531	215	0	0	3	4
경상북도	성주군	성주읍	성주읍제4투	2516	1984	532	7	1977	1679	280	0	2	3	13
경상북도	성주군	선남면	소계	5747	4539	1208	29	4510	3955	533	1	1	3	17
경상북도	성주군	선남면	선남면제1투	2841	2230	611	18	2212	1956	242	1	0	2	11
경상북도	성주군	선남면	선남면제2투	2906	2309	597	11	2298	1999	291	0	1	1	6
경상북도	성주군	용암면	소계	3406	2741	665	31	2710	2360	321	2	2	1	24
경상북도	성주군	용암면	용암면제1투	1672	1348	324	14	1334	1162	161	1	1	0	9
경상북도	성주군	용암면	용암면제2투	1734	1393	341	17	1376	1198	160	1	1	1	15
경상북도	성주군	수륜면	소계	2774	2194	580	9	2185	1856	300	2	0	5	22
경상북도	성주군	수륜면	수륜면제1투	1749	1358	391	3	1355	1147	193	0	0	2	13
경상북도	성주군	수륜면	수륜면제2투	1025	836	189	6	830	709	107	2	0	3	9
경상북도	성주군	가천면	소계	1813	1402	411	10	1392	1209	164	1	2	1	15
경상북도	성주군	가천면	가천면투표소	1813	1402	411	10	1392	1209	164	1	2	1	15
경상북도	성주군	금수면	소계	1040	826	214	9	817	686	112	2	1	1	15
경상북도	성주군	금수면	금수면투표소	1040	826	214	9	817	686	112	2	1	1	15
경상북도	성주군	대가면	소계	2212	1743	469	18	1725	1477	234	0	3	2	9
경상북도	성주군	대가면	대가면투표소	2212	1743	469	18	1725	1477	234	0	3	2	9
경상북도	성주군	벽진면	소계	3048	2393	655	12	2381	2065	303	0	0	3	10
경상북도	성주군	벽진면	벽진면투표소	3048	2393	655	12	2381	2065	303	0	0	3	10
경상북도	성주군	초전면	소계	4359	3411	948	17	3394	2950	417	1	0	6	20
경상북도	성주군	초전면	초전면제1투	2347	1829	518	7	1822	1570	238	1	0	4	9
경상북도	성주군	초전면	초전면제2투	2012	1582	430	10	1572	1380	179	0	0	2	11
경상북도	성주군	월항면	소계	3039	2387	652	9	2378	2140	224	0	0	2	12
경상북도	성주군	월항면	월항면제1투	2026	1567	459	6	1561	1413	140	0	0	0	8
경상북도	성주군	월항면	월항면제2투	1013	820	193	3	817	727	84	0	0	2	4
경상북도	성주군	잘못 투입·구분된 투표지	잘못 투입·구분된 투표지	0	0	0	0	0	0	0	0	0	0	0
경상북도	칠곡군	계	계	93349	71571	21778	257	71314	57485	13560	14	29	68	158
경상북도	칠곡군	재외투표	재외투표	327	230	97	4	226	137	88	0	0	0	1
경상북도	칠곡군	국내부재자투표	국내부재자투표	2461	2238	223	43	2195	1545	631	3	5	3	8
경상북도	칠곡군	왜관읍	소계	24680	19052	5628	71	18981	15722	3192	4	6	20	37
경상북도	칠곡군	왜관읍	왜관읍제1투	3664	2660	1004	10	2650	2226	416	0	0	2	6
경상북도	칠곡군	왜관읍	왜관읍제2투	2738	2126	612	5	2121	1785	328	1	0	4	3
경상북도	칠곡군	왜관읍	왜관읍제3투	1446	976	470	7	969	837	125	1	0	0	6
경상북도	칠곡군	왜관읍	왜관읍제4투	4222	3473	749	11	3462	2880	572	1	0	4	5
경상북도	칠곡군	왜관읍	왜관읍제5투	4636	3728	908	15	3713	2986	716	1	2	2	6
경상북도	칠곡군	왜관읍	왜관읍제6투	2112	1659	453	5	1654	1356	291	0	1	4	2
경상북도	칠곡군	왜관읍	왜관읍제7투	2283	1668	615	7	1661	1401	253	0	1	2	4
경상북도	칠곡군	왜관읍	왜관읍제8투	3579	2762	817	11	2751	2251	491	0	2	2	5
경상북도	칠곡군	북삼읍	소계	18004	13655	4349	28	13627	11362	2233	0	1	16	15
경상북도	칠곡군	북삼읍	북삼읍제1투	2934	2209	725	2	2207	1821	382	0	0	4	0
경상북도	칠곡군	북삼읍	북삼읍제2투	1913	1502	411	5	1497	1359	129	0	0	2	7
경상북도	칠곡군	북삼읍	북삼읍제3투	3779	2680	1099	9	2671	2184	481	0	0	4	2
경상북도	칠곡군	북삼읍	북삼읍제4투	3203	2311	892	4	2307	1894	411	0	0	0	2
경상북도	칠곡군	북삼읍	북삼읍제5투	3078	2398	680	3	2395	2096	293	0	0	3	3
경상북도	칠곡군	북삼읍	북삼읍제6투	3097	2555	542	5	2550	2008	537	0	1	3	1
경상북도	칠곡군	석적읍	소계	21621	15921	5700	29	15892	10994	4850	3	13	14	18
경상북도	칠곡군	석적읍	석적읍제1투	971	739	232	5	734	670	60	1	0	1	2
경상북도	칠곡군	석적읍	석적읍제2투	4924	3314	1610	9	3305	1808	1480	0	8	4	5
경상북도	칠곡군	석적읍	석적읍제3투	4250	3332	918	2	3330	2301	1020	0	2	4	3
경상북도	칠곡군	석적읍	석적읍제4투	4764	3997	767	1	3996	2921	1066	1	3	3	2
경상북도	칠곡군	석적읍	석적읍제5투	718	564	154	3	561	485	73	1	0	0	2
경상북도	칠곡군	석적읍	석적읍제6투	3578	1987	1591	5	1982	1460	520	0	0	0	2
경상북도	칠곡군	석적읍	석적읍제7투	2416	1988	428	4	1984	1349	631	0	0	2	2
경상북도	칠곡군	지천면	소계	4425	3456	969	13	3443	3044	375	1	0	3	20
경상북도	칠곡군	지천면	지천면제1투	3066	2359	707	11	2348	2055	272	1	0	3	17
경상북도	칠곡군	지천면	지천면제2투	1359	1097	262	2	1095	989	103	0	0	0	3
경상북도	칠곡군	동명면	소계	5370	4183	1187	25	4158	3638	499	1	0	5	15
경상북도	칠곡군	동명면	동명면제1투	1945	1500	445	9	1491	1299	181	0	0	3	8
경상북도	칠곡군	동명면	동명면제2투	1986	1523	463	10	1513	1326	179	1	0	2	5
경상북도	칠곡군	동명면	동명면제3투	1439	1160	279	6	1154	1013	139	0	0	0	2
경상북도	칠곡군	가산면	소계	3472	2699	773	9	2690	2363	308	1	0	2	16
경상북도	칠곡군	가산면	가산면제1투	2069	1597	472	5	1592	1394	184	0	0	2	12
경상북도	칠곡군	가산면	가산면제2투	991	796	195	4	792	699	91	1	0	0	1
경상북도	칠곡군	가산면	가산면제3투	412	306	106	0	306	270	33	0	0	0	3
경상북도	칠곡군	약목면	소계	10062	7793	2269	21	7772	6706	1037	1	4	5	19
경상북도	칠곡군	약목면	약목면제1투	2996	2416	580	7	2409	2160	242	0	2	0	5
경상북도	칠곡군	약목면	약목면제2투	3125	2390	735	7	2383	2004	372	1	2	1	3
경상북도	칠곡군	약목면	약목면제3투	1655	1289	366	5	1284	1146	129	0	0	1	8
경상북도	칠곡군	약목면	약목면제4투	2286	1698	588	2	1696	1396	294	0	0	3	3
경상북도	칠곡군	기산면	소계	2927	2344	583	14	2330	1974	347	0	0	0	9
경상북도	칠곡군	기산면	기산면제1투	2363	1885	478	10	1875	1586	284	0	0	0	5
경상북도	칠곡군	기산면	기산면제2투	564	459	105	4	455	388	63	0	0	0	4
경상북도	군위군	계	계	21881	17848	4033	127	17721	15457	2126	4	9	20	105
경상북도	군위군	재외투표	재외투표	253	170	83	4	166	132	33	0	1	0	0
경상북도	군위군	국내부재자투표	국내부재자투표	1106	999	107	14	985	690	289	0	0	4	2
경상북도	군위군	군위읍	소계	6245	4980	1265	20	4960	4278	655	1	2	5	19
경상북도	군위군	군위읍	군위읍제1투	2285	1781	504	7	1774	1507	262	0	1	0	4
경상북도	군위군	군위읍	군위읍제2투	2038	1644	394	6	1638	1395	235	1	1	2	4
경상북도	군위군	군위읍	군위읍제3투	896	711	185	2	709	633	70	0	0	2	4
경상북도	군위군	군위읍	군위읍제4투	1026	844	182	5	839	743	88	0	0	1	7
경상북도	군위군	소보면	소계	2182	1797	385	15	1782	1634	132	1	0	1	14
경상북도	군위군	소보면	소보면제1투	1374	1130	244	10	1120	1032	80	0	0	1	7
경상북도	군위군	소보면	소보면제2투	808	667	141	5	662	602	52	1	0	0	7
경상북도	군위군	효령면	소계	3509	2862	647	16	2846	2486	333	0	5	3	19
경상북도	군위군	효령면	효령면제1투	2222	1776	446	9	1767	1535	214	0	3	2	13
경상북도	군위군	효령면	효령면제2투	1287	1086	201	7	1079	951	119	0	2	1	6
경상북도	군위군	부계면	소계	1834	1515	319	6	1509	1344	154	0	0	0	11
경상북도	군위군	부계면	부계면제1투	883	740	143	4	736	650	83	0	0	0	3
경상북도	군위군	부계면	부계면제2투	951	775	176	2	773	694	71	0	0	0	8
경상북도	군위군	우보면	소계	1906	1614	292	15	1599	1431	154	0	1	4	9
경상북도	군위군	우보면	우보면제1투	1306	1093	213	7	1086	974	103	0	1	2	6
경상북도	군위군	우보면	우보면제2투	600	521	79	8	513	457	51	0	0	2	3
경상북도	군위군	의흥면	소계	2470	1996	474	17	1979	1784	184	0	0	1	10
경상북도	군위군	의흥면	의흥면제1투	1925	1552	373	11	1541	1381	155	0	0	1	4
경상북도	군위군	의흥면	의흥면제2투	545	444	101	6	438	403	29	0	0	0	6
경상북도	군위군	산성면	소계	1195	995	200	8	987	882	95	2	0	1	7
경상북도	군위군	산성면	산성면제1투	606	505	101	2	503	454	45	2	0	0	2
경상북도	군위군	산성면	산성면제2투	589	490	99	6	484	428	50	0	0	1	5
경상북도	군위군	고로면	소계	1181	920	261	12	908	796	97	0	0	1	14
경상북도	군위군	고로면	고로면제1투	561	423	138	3	420	360	55	0	0	1	4
경상북도	군위군	고로면	고로면제2투	620	497	123	9	488	436	42	0	0	0	10
경상북도	의성군	계	계	51609	40089	11520	262	39827	34294	5167	23	15	44	284
경상북도	의성군	재외투표	재외투표	630	435	195	2	433	342	89	1	1	0	0
경상북도	의성군	국내부재자투표	국내부재자투표	1809	1638	171	30	1608	1066	530	2	5	3	2
경상북도	의성군	의성읍	소계	11617	8763	2854	36	8727	7288	1397	2	1	5	34
경상북도	의성군	의성읍	의성읍제1투	2217	1606	611	5	1601	1342	252	0	0	2	5
경상북도	의성군	의성읍	의성읍제2투	3251	2480	771	6	2474	2043	419	0	0	0	12
경상북도	의성군	의성읍	의성읍제3투	3346	2579	767	12	2567	2114	443	1	1	1	7
경상북도	의성군	의성읍	의성읍제4투	2803	2098	705	13	2085	1789	283	1	0	2	10
경상북도	의성군	단촌면	소계	1984	1558	426	13	1545	1350	177	0	0	1	17
경상북도	의성군	단촌면	단촌면투표소	1984	1558	426	13	1545	1350	177	0	0	1	17
경상북도	의성군	점곡면	소계	1696	1331	365	8	1323	1108	194	2	1	1	17
경상북도	의성군	점곡면	점곡면투표소	1696	1331	365	8	1323	1108	194	2	1	1	17
경상북도	의성군	옥산면	소계	1839	1389	450	12	1377	1165	195	2	0	1	14
경상북도	의성군	옥산면	옥산면투표소	1839	1389	450	12	1377	1165	195	2	0	1	14
경상북도	의성군	사곡면	소계	1552	1208	344	5	1203	1064	128	0	1	0	10
경상북도	의성군	사곡면	사곡면투표소	1552	1208	344	5	1203	1064	128	0	1	0	10
경상북도	의성군	춘산면	소계	1477	1142	335	6	1136	987	129	1	0	1	18
경상북도	의성군	춘산면	춘산면투표소	1477	1142	335	6	1136	987	129	1	0	1	18
경상북도	의성군	가음면	소계	1431	1097	334	6	1091	962	118	1	0	1	9
경상북도	의성군	가음면	가음면투표소	1431	1097	334	6	1091	962	118	1	0	1	9
경상북도	의성군	금성면	소계	4229	3304	925	17	3287	2896	367	1	1	3	19
경상북도	의성군	금성면	금성면제1투	2462	1899	563	13	1886	1668	210	0	0	3	5
경상북도	의성군	금성면	금성면제2투	1767	1405	362	4	1401	1228	157	1	1	0	14
경상북도	의성군	봉양면	소계	3529	2773	756	14	2759	2419	318	2	2	4	14
경상북도	의성군	봉양면	봉양면제1투	773	632	141	1	631	580	48	0	1	1	1
경상북도	의성군	봉양면	봉양면제2투	2756	2141	615	13	2128	1839	270	2	1	3	13
경상북도	의성군	비안면	소계	2413	1851	562	11	1840	1634	188	2	2	3	11
경상북도	의성군	비안면	비안면투표소	2413	1851	562	11	1840	1634	188	2	2	3	11
경상북도	의성군	구천면	소계	1788	1391	397	13	1378	1243	122	0	0	2	11
경상북도	의성군	구천면	구천면투표소	1788	1391	397	13	1378	1243	122	0	0	2	11
경상북도	의성군	단밀면	소계	1874	1474	400	4	1470	1302	150	0	0	2	16
경상북도	의성군	단밀면	단밀면투표소	1874	1474	400	4	1470	1302	150	0	0	2	16
경상북도	의성군	단북면	소계	1866	1494	372	12	1482	1355	118	1	0	0	8
경상북도	의성군	단북면	단북면투표소	1866	1494	372	12	1482	1355	118	1	0	0	8
경상북도	의성군	안계면	소계	4145	3228	917	17	3211	2842	345	2	0	4	18
경상북도	의성군	안계면	안계면제1투	2262	1746	516	6	1740	1543	190	1	0	1	5
경상북도	의성군	안계면	안계면제2투	1883	1482	401	11	1471	1299	155	1	0	3	13
경상북도	의성군	다인면	소계	3933	3050	883	21	3029	2727	271	3	0	3	25
경상북도	의성군	다인면	다인면제1투	2019	1547	472	11	1536	1401	122	1	0	0	12
경상북도	의성군	다인면	다인면제2투	1914	1503	411	10	1493	1326	149	2	0	3	13
경상북도	의성군	신평면	소계	808	641	167	5	636	559	66	1	1	1	8
경상북도	의성군	신평면	신평면투표소	808	641	167	5	636	559	66	1	1	1	8
경상북도	의성군	안평면	소계	2127	1649	478	14	1635	1429	181	0	0	6	19
경상북도	의성군	안평면	안평면투표소	2127	1649	478	14	1635	1429	181	0	0	6	19
경상북도	의성군	안사면	소계	862	673	189	16	657	556	84	0	0	3	14
경상북도	의성군	안사면	안사면투표소	862	673	189	16	657	556	84	0	0	3	14
경상북도	청송군	계	계	23445	18310	5135	121	18189	15054	2946	16	8	19	146
경상북도	청송군	재외투표	재외투표	176	120	56	1	119	92	27	0	0	0	0
경상북도	청송군	국내부재자투표	국내부재자투표	941	841	100	26	815	514	287	4	1	1	8
경상북도	청송군	청송읍	소계	4322	3391	931	16	3375	2771	578	1	1	5	19
경상북도	청송군	청송읍	청송읍제1투	1416	1108	308	6	1102	871	223	0	0	3	5
경상북도	청송군	청송읍	청송읍제2투	667	539	128	3	536	452	78	1	1	0	4
경상북도	청송군	청송읍	청송읍제3투	1388	1061	327	5	1056	878	168	0	0	2	8
경상북도	청송군	청송읍	청송읍제4투	851	683	168	2	681	570	109	0	0	0	2
경상북도	청송군	부동면	소계	1754	1368	386	10	1358	1136	202	1	3	0	16
경상북도	청송군	부동면	부동면제1투	982	752	230	8	744	633	97	0	2	0	12
경상북도	청송군	부동면	부동면제2투	772	616	156	2	614	503	105	1	1	0	4
경상북도	청송군	부남면	소계	2263	1761	502	10	1751	1460	271	2	0	1	17
경상북도	청송군	부남면	부남면제1투	1126	891	235	7	884	732	142	2	0	0	8
경상북도	청송군	부남면	부남면제2투	1137	870	267	3	867	728	129	0	0	1	9
경상북도	청송군	현동면	소계	1828	1448	380	10	1438	1260	169	1	1	1	6
경상북도	청송군	현동면	현동면투표소	1828	1448	380	10	1438	1260	169	1	1	1	6
경상북도	청송군	현서면	소계	2280	1807	473	9	1798	1490	291	1	1	6	9
경상북도	청송군	현서면	현서면제1투	1630	1265	365	5	1260	1056	195	1	1	3	4
경상북도	청송군	현서면	현서면제2투	650	542	108	4	538	434	96	0	0	3	5
경상북도	청송군	안덕면	소계	2457	1914	543	11	1903	1650	237	0	0	3	13
경상북도	청송군	안덕면	안덕면제1투	1902	1457	445	8	1449	1249	187	0	0	2	11
경상북도	청송군	안덕면	안덕면제2투	555	457	98	3	454	401	50	0	0	1	2
경상북도	청송군	파천면	소계	1722	1320	402	10	1310	1119	161	3	1	1	25
경상북도	청송군	파천면	파천면제1투	987	756	231	8	748	636	94	2	1	0	15
경상북도	청송군	파천면	파천면제2투	735	564	171	2	562	483	67	1	0	1	10
경상북도	청송군	진보면	소계	5702	4340	1362	18	4322	3562	723	3	0	1	33
경상북도	청송군	진보면	진보면제1투	1942	1461	481	6	1455	1236	216	0	0	0	3
경상북도	청송군	진보면	진보면제2투	1837	1379	458	6	1373	1113	247	1	0	0	12
경상북도	청송군	진보면	진보면제3투	963	743	220	2	741	584	148	1	0	0	8
경상북도	청송군	진보면	진보면제4투	960	757	203	4	753	629	112	1	0	1	10
경상북도	영양군	계	계	15914	12321	3593	110	12211	9818	2247	9	8	20	109
경상북도	영양군	재외투표	재외투표	58	43	15	0	43	31	12	0	0	0	0
경상북도	영양군	국내부재자투표	국내부재자투표	669	620	49	21	599	357	226	1	1	4	10
경상북도	영양군	영양읍	소계	6121	4675	1446	26	4649	3768	841	1	2	6	31
경상북도	영양군	영양읍	영양읍제1투	1993	1511	482	11	1500	1206	277	0	2	1	14
경상북도	영양군	영양읍	영양읍제2투	2061	1616	445	6	1610	1304	293	0	0	3	10
경상북도	영양군	영양읍	영양읍제3투	2067	1548	519	9	1539	1258	271	1	0	2	7
경상북도	영양군	입암면	소계	2081	1612	469	9	1603	1367	216	1	1	2	16
경상북도	영양군	입암면	입암면투표소	2081	1612	469	9	1603	1367	216	1	1	2	16
경상북도	영양군	청기면	소계	1674	1312	362	17	1295	1091	185	3	0	2	14
경상북도	영양군	청기면	청기면제1투	1092	849	243	8	841	714	116	1	0	2	8
경상북도	영양군	청기면	청기면제2투	582	463	119	9	454	377	69	2	0	0	6
경상북도	영양군	일월면	소계	1645	1260	385	15	1245	980	247	1	0	2	15
경상북도	영양군	일월면	일월면투표소	1645	1260	385	15	1245	980	247	1	0	2	15
경상북도	영양군	수비면	소계	1631	1238	393	13	1225	934	269	2	4	4	12
경상북도	영양군	수비면	수비면투표소	1631	1238	393	13	1225	934	269	2	4	4	12
경상북도	영양군	석보면	소계	2035	1561	474	9	1552	1290	251	0	0	0	11
경상북도	영양군	석보면	석보면제1투	1566	1200	366	4	1196	994	197	0	0	0	5
경상북도	영양군	석보면	석보면제2투	469	361	108	5	356	296	54	0	0	0	6
경상북도	영덕군	계	계	35215	27535	7680	196	27339	23816	3314	11	12	25	161
경상북도	영덕군	재외투표	재외투표	121	85	36	1	84	49	34	0	1	0	0
경상북도	영덕군	국내부재자투표	국내부재자투표	1920	1699	221	51	1648	1246	394	3	3	0	2
경상북도	영덕군	영덕읍	소계	8595	6673	1922	29	6644	5717	905	2	2	4	14
경상북도	영덕군	영덕읍	영덕읍제1투	2377	1783	594	4	1779	1469	302	1	0	4	3
경상북도	영덕군	영덕읍	영덕읍제2투	2601	2033	568	7	2026	1753	273	0	0	0	0
경상북도	영덕군	영덕읍	영덕읍제3투	2333	1831	502	6	1825	1581	239	1	0	0	4
경상북도	영덕군	영덕읍	영덕읍제4투	1284	1026	258	12	1014	914	91	0	2	0	7
경상북도	영덕군	강구면	소계	6100	4618	1482	28	4590	4115	455	0	1	1	18
경상북도	영덕군	강구면	강구면제1투	2213	1646	567	10	1636	1462	164	0	0	1	9
경상북도	영덕군	강구면	강구면제2투	2286	1791	495	16	1775	1612	157	0	0	0	6
경상북도	영덕군	강구면	강구면제3투	1601	1181	420	2	1179	1041	134	0	1	0	3
경상북도	영덕군	남정면	소계	2311	1862	449	15	1847	1655	171	0	1	4	16
경상북도	영덕군	남정면	남정면제1투	1672	1333	339	11	1322	1172	135	0	1	4	10
경상북도	영덕군	남정면	남정면제2투	639	529	110	4	525	483	36	0	0	0	6
경상북도	영덕군	달산면	소계	1232	931	301	5	926	799	107	0	0	3	17
경상북도	영덕군	달산면	달산면제1투	942	705	237	4	701	608	77	0	0	2	14
경상북도	영덕군	달산면	달산면제2투	290	226	64	1	225	191	30	0	0	1	3
경상북도	영덕군	지품면	소계	2015	1625	390	10	1615	1413	183	1	0	5	13
경상북도	영덕군	지품면	지품면제1투	1423	1160	263	6	1154	1031	112	0	0	4	7
경상북도	영덕군	지품면	지품면제2투	592	465	127	4	461	382	71	1	0	1	6
경상북도	영덕군	축산면	소계	2692	2120	572	11	2109	1883	202	0	2	4	18
경상북도	영덕군	축산면	축산면제1투	850	695	155	5	690	613	64	0	1	0	12
경상북도	영덕군	축산면	축산면제2투	1842	1425	417	6	1419	1270	138	0	1	4	6
경상북도	영덕군	영해면	소계	5832	4451	1381	27	4424	3846	549	3	1	3	22
경상북도	영덕군	영해면	영해면제1투	1826	1357	469	6	1351	1154	189	0	0	0	8
경상북도	영덕군	영해면	영해면제2투	2103	1616	487	3	1613	1401	205	3	0	1	3
경상북도	영덕군	영해면	영해면제3투	1903	1478	425	18	1460	1291	155	0	1	2	11
경상북도	영덕군	병곡면	소계	2714	2115	599	9	2106	1911	167	2	1	1	24
경상북도	영덕군	병곡면	병곡면제1투	1317	1027	290	6	1021	913	88	1	1	1	17
경상북도	영덕군	병곡면	병곡면제2투	1397	1088	309	3	1085	998	79	1	0	0	7
경상북도	영덕군	창수면	소계	1683	1356	327	10	1346	1182	147	0	0	0	17
경상북도	영덕군	창수면	창수면제1투	1075	856	219	5	851	759	82	0	0	0	10
경상북도	영덕군	창수면	창수면제2투	608	500	108	5	495	423	65	0	0	0	7
경상북도	영덕군	잘못 투입·구분된 투표지	잘못 투입·구분된 투표지	0	0	0	0	0	0	0	0	0	0	0
경상북도	봉화군	계	계	29457	23006	6451	213	22793	18408	3989	37	38	60	261
경상북도	봉화군	재외투표	재외투표	80	47	33	0	47	20	27	0	0	0	0
경상북도	봉화군	국내부재자투표	국내부재자투표	1236	1123	113	23	1100	723	370	1	0	2	4
경상북도	봉화군	봉화읍	소계	8182	6382	1800	26	6356	5149	1159	3	4	7	34
경상북도	봉화군	봉화읍	봉화읍제1투	2934	2278	656	7	2271	1774	485	0	2	0	10
경상북도	봉화군	봉화읍	봉화읍제2투	2037	1597	440	6	1591	1318	257	2	1	5	8
경상북도	봉화군	봉화읍	봉화읍제3투	1765	1385	380	8	1377	1129	236	1	1	0	10
경상북도	봉화군	봉화읍	봉화읍제4투	1446	1122	324	5	1117	928	181	0	0	2	6
경상북도	봉화군	물야면	소계	2910	2266	644	16	2250	1882	328	0	0	4	36
경상북도	봉화군	물야면	물야면제1투	1432	1112	320	9	1103	926	162	0	0	2	13
경상북도	봉화군	물야면	물야면제2투	1478	1154	324	7	1147	956	166	0	0	2	23
경상북도	봉화군	봉성면	소계	2034	1614	420	15	1599	1336	230	3	2	5	23
경상북도	봉화군	봉성면	봉성면제1투	956	753	203	6	747	613	112	3	2	3	14
경상북도	봉화군	봉성면	봉성면제2투	1078	861	217	9	852	723	118	0	0	2	9
경상북도	봉화군	법전면	소계	1927	1466	461	28	1438	1198	199	9	0	9	23
경상북도	봉화군	법전면	법전면제1투	1190	915	275	18	897	730	138	8	0	6	15
경상북도	봉화군	법전면	법전면제2투	737	551	186	10	541	468	61	1	0	3	8
경상북도	봉화군	춘양면	소계	4136	3228	908	35	3193	2667	457	12	3	22	32
경상북도	봉화군	춘양면	춘양면제1투	1414	1122	292	8	1114	973	132	3	0	1	5
경상북도	봉화군	춘양면	춘양면제2투	1413	1128	285	13	1115	927	161	5	0	12	10
경상북도	봉화군	춘양면	춘양면제3투	1309	978	331	14	964	767	164	4	3	9	17
경상북도	봉화군	소천면	소계	2086	1612	474	25	1587	1231	308	5	16	3	24
경상북도	봉화군	소천면	소천면제1투	788	576	212	5	571	460	96	1	6	2	6
경상북도	봉화군	소천면	소천면제2투	605	484	121	6	478	362	101	3	5	1	6
경상북도	봉화군	소천면	소천면제3투	693	552	141	14	538	409	111	1	5	0	12
경상북도	봉화군	석포면	소계	1661	1249	412	11	1238	953	260	1	9	3	12
경상북도	봉화군	석포면	석포면제1투	1378	1031	347	11	1020	781	218	1	8	3	9
경상북도	봉화군	석포면	석포면제2투	283	218	65	0	218	172	42	0	1	0	3
경상북도	봉화군	재산면	소계	1468	1113	355	12	1101	861	219	0	1	0	20
경상북도	봉화군	재산면	재산면제1투	1343	1017	326	9	1008	783	205	0	1	0	19
경상북도	봉화군	재산면	재산면제2투	125	96	29	3	93	78	14	0	0	0	1
경상북도	봉화군	명호면	소계	2025	1545	480	8	1537	1247	262	2	1	3	22
경상북도	봉화군	명호면	명호면제1투	1549	1156	393	4	1152	928	205	2	1	2	14
경상북도	봉화군	명호면	명호면제2투	476	389	87	4	385	319	57	0	0	1	8
경상북도	봉화군	상운면	소계	1712	1361	351	14	1347	1141	170	1	2	2	31
경상북도	봉화군	상운면	상운면투표소	1712	1361	351	14	1347	1141	170	1	2	2	31
경상북도	봉화군	잘못 투입·구분된 투표지	잘못 투입·구분된 투표지	0	0	0	0	0	0	0	0	0	0	0
경상북도	울진군	계	계	42919	33221	9698	236	32985	26387	6341	8	12	49	188
경상북도	울진군	재외투표	재외투표	150	100	50	0	100	57	43	0	0	0	0
경상북도	울진군	국내부재자투표	국내부재자투표	1902	1725	177	39	1686	1099	578	1	3	3	2
경상북도	울진군	울진읍	소계	10184	8054	2130	28	8026	6109	1886	0	1	12	18
경상북도	울진군	울진읍	울진읍제1투	2521	1922	599	7	1915	1510	401	0	0	1	3
경상북도	울진군	울진읍	울진읍제2투	2550	2039	511	7	2032	1501	523	0	0	2	6
경상북도	울진군	울진읍	울진읍제3투	2994	2405	589	5	2400	1765	624	0	1	2	8
경상북도	울진군	울진읍	울진읍제4투	2119	1688	431	9	1679	1333	338	0	0	7	1
경상북도	울진군	평해읍	소계	2777	2153	624	18	2135	1859	255	1	2	1	17
경상북도	울진군	평해읍	평해읍제1투	1377	1054	323	9	1045	887	149	0	1	0	8
경상북도	울진군	평해읍	평해읍제2투	1400	1099	301	9	1090	972	106	1	1	1	9
경상북도	울진군	북면	소계	5406	4130	1276	27	4103	2817	1259	0	2	6	19
경상북도	울진군	북면	북면제1투	2678	1929	749	11	1918	1506	399	0	1	2	10
경상북도	울진군	북면	북면제2투	628	492	136	11	481	389	85	0	0	2	5
경상북도	울진군	북면	북면제3투	2100	1709	391	5	1704	922	775	0	1	2	4
경상북도	울진군	서면	소계	1400	1082	318	13	1069	913	144	0	0	5	7
경상북도	울진군	서면	서면제1투	1131	867	264	7	860	746	106	0	0	3	5
경상북도	울진군	서면	서면제2투	269	215	54	6	209	167	38	0	0	2	2
경상북도	울진군	근남면	소계	2469	1903	566	11	1892	1589	287	0	1	2	13
경상북도	울진군	근남면	근남면투표소	2469	1903	566	11	1892	1589	287	0	1	2	13
경상북도	울진군	원남면	소계	2020	1571	449	14	1557	1302	228	0	1	3	23
경상북도	울진군	원남면	원남면투표소	2020	1571	449	14	1557	1302	228	0	1	3	23
경상북도	울진군	기성면	소계	2463	1897	566	25	1872	1599	239	1	1	5	27
경상북도	울진군	기성면	기성면투표소	2463	1897	566	25	1872	1599	239	1	1	5	27
경상북도	울진군	온정면	소계	1757	1391	366	20	1371	1214	129	3	0	3	22
경상북도	울진군	온정면	온정면제1투	1177	924	253	11	913	810	86	2	0	3	12
경상북도	울진군	온정면	온정면제2투	580	467	113	9	458	404	43	1	0	0	10
경상북도	울진군	죽변면	소계	5680	4144	1536	18	4126	3400	700	2	1	2	21
경상북도	울진군	죽변면	죽변면제1투	2506	1814	692	7	1807	1526	269	1	0	0	11
경상북도	울진군	죽변면	죽변면제2투	3174	2330	844	11	2319	1874	431	1	1	2	10
경상북도	울진군	후포면	소계	6711	5071	1640	23	5048	4429	593	0	0	7	19
경상북도	울진군	후포면	후포면제1투	1723	1292	431	4	1288	1171	109	0	0	1	7
경상북도	울진군	후포면	후포면제2투	2536	1912	624	9	1903	1680	213	0	0	3	7
경상북도	울진군	후포면	후포면제3투	2452	1867	585	10	1857	1578	271	0	0	3	5
경상남도	창원시의창구	계	계	199932	155306	44626	754	154552	93834	60126	78	83	216	215
경상남도	창원시의창구	재외투표	재외투표	720	445	275	3	442	200	238	1	0	1	2
경상남도	창원시의창구	국내부재자투표	국내부재자투표	6607	6184	423	92	6092	3123	2921	9	8	12	19
경상남도	창원시의창구	동읍	소계	17591	13706	3885	73	13633	8268	5289	8	10	26	32
경상남도	창원시의창구	동읍	동읍제1투	2123	1777	346	3	1774	1053	708	1	3	5	4
경상남도	창원시의창구	동읍	동읍제2투	3441	2552	889	17	2535	1559	958	1	3	8	6
경상남도	창원시의창구	동읍	동읍제3투	2220	1718	502	12	1706	1030	667	1	1	5	2
경상남도	창원시의창구	동읍	동읍제4투	2903	2328	575	8	2320	1207	1102	2	0	4	5
경상남도	창원시의창구	동읍	동읍제5투	3659	2798	861	17	2781	1688	1087	0	1	1	4
경상남도	창원시의창구	동읍	동읍제6투	1822	1418	404	6	1412	933	466	1	2	1	9
경상남도	창원시의창구	동읍	동읍제7투	1423	1115	308	10	1105	798	301	2	0	2	2
경상남도	창원시의창구	북면	소계	9282	7015	2267	79	6936	5008	1882	9	10	5	22
경상남도	창원시의창구	북면	북면제1투	2073	1604	469	19	1585	1179	402	0	0	0	4
경상남도	창원시의창구	북면	북면제2투	1616	1238	378	13	1225	904	314	3	1	1	2
경상남도	창원시의창구	북면	북면제3투	4456	3314	1142	37	3277	2263	995	2	5	3	9
경상남도	창원시의창구	북면	북면제4투	1137	859	278	10	849	662	171	4	4	1	7
경상남도	창원시의창구	대산면	소계	6372	4835	1537	50	4785	3130	1623	9	3	5	15
경상남도	창원시의창구	대산면	대산면제1투	3163	2406	757	26	2380	1540	820	8	1	3	8
경상남도	창원시의창구	대산면	대산면제2투	3209	2429	780	24	2405	1590	803	1	2	2	7
경상남도	창원시의창구	의창동	소계	29140	22688	6452	90	22598	14437	8083	15	11	25	27
경상남도	창원시의창구	의창동	의창동제1투	2863	2174	689	8	2166	1518	636	4	2	3	3
경상남도	창원시의창구	의창동	의창동제2투	3971	3125	846	16	3109	2022	1075	2	2	3	5
경상남도	창원시의창구	의창동	의창동제3투	3883	3080	803	9	3071	1810	1251	1	1	4	4
경상남도	창원시의창구	의창동	의창동제4투	4136	3200	936	13	3187	2034	1149	1	0	2	1
경상남도	창원시의창구	의창동	의창동제5투	4123	3329	794	11	3318	2148	1157	2	1	5	5
경상남도	창원시의창구	의창동	의창동제6투	5342	3989	1353	16	3973	2394	1567	0	0	7	5
경상남도	창원시의창구	의창동	의창동제7투	2536	1969	567	15	1954	1261	688	2	1	1	1
경상남도	창원시의창구	의창동	의창동제8투	2286	1822	464	2	1820	1250	560	3	4	0	3
경상남도	창원시의창구	팔용동	소계	32680	26333	6347	85	26248	15300	10875	4	4	42	23
경상남도	창원시의창구	팔용동	팔용동제1투	4031	3173	858	12	3161	1837	1310	2	0	8	4
경상남도	창원시의창구	팔용동	팔용동제2투	3822	2805	1017	11	2794	1764	1023	1	0	5	1
경상남도	창원시의창구	팔용동	팔용동제3투	3962	2977	985	6	2971	1799	1163	0	1	4	4
경상남도	창원시의창구	팔용동	팔용동제4투	4138	3482	656	10	3472	1937	1529	0	1	4	1
경상남도	창원시의창구	팔용동	팔용동제5투	4138	3567	571	10	3557	1935	1613	0	0	6	3
경상남도	창원시의창구	팔용동	팔용동제6투	3440	2662	778	15	2647	1601	1040	1	0	2	3
경상남도	창원시의창구	팔용동	팔용동제7투	3949	3277	672	13	3264	1668	1585	0	1	6	4
경상남도	창원시의창구	팔용동	팔용동제8투	2829	2415	414	7	2408	1417	985	0	1	3	2
경상남도	창원시의창구	팔용동	팔용동제9투	2371	1975	396	1	1974	1342	627	0	0	4	1
경상남도	창원시의창구	명곡동	소계	40956	31432	9524	119	31313	19316	11917	4	12	35	29
경상남도	창원시의창구	명곡동	명곡동제1투	4438	3536	902	25	3511	2145	1358	0	1	2	5
경상남도	창원시의창구	명곡동	명곡동제2투	4419	3541	878	11	3530	2093	1430	1	1	4	1
경상남도	창원시의창구	명곡동	명곡동제3투	4331	3542	789	15	3527	2172	1342	0	2	6	5
경상남도	창원시의창구	명곡동	명곡동제4투	3759	2617	1142	11	2606	1575	1021	0	2	4	4
경상남도	창원시의창구	명곡동	명곡동제5투	5140	4152	988	7	4145	2552	1587	2	1	3	0
경상남도	창원시의창구	명곡동	명곡동제6투	3539	2577	962	7	2570	1617	946	0	0	4	3
경상남도	창원시의창구	명곡동	명곡동제7투	3926	2934	992	7	2927	1928	994	0	0	1	4
경상남도	창원시의창구	명곡동	명곡동제8투	4029	2951	1078	17	2934	1819	1105	0	2	7	1
경상남도	창원시의창구	명곡동	명곡동제9투	3698	2715	983	9	2706	1714	985	0	3	2	2
경상남도	창원시의창구	명곡동	명곡동제10투	3677	2867	810	10	2857	1701	1149	1	0	2	4
경상남도	창원시의창구	봉림동	소계	29673	21732	7941	91	21641	12948	8612	8	11	35	27
경상남도	창원시의창구	봉림동	봉림동제1투	4355	3129	1226	10	3119	2018	1088	1	3	3	6
경상남도	창원시의창구	봉림동	봉림동제2투	4113	2962	1151	14	2948	1744	1191	2	0	9	2
경상남도	창원시의창구	봉림동	봉림동제3투	3959	2859	1100	9	2850	1756	1084	0	1	5	4
경상남도	창원시의창구	봉림동	봉림동제4투	3702	2728	974	16	2712	1608	1098	0	1	3	2
경상남도	창원시의창구	봉림동	봉림동제5투	4912	3619	1293	23	3596	2085	1494	2	1	7	7
경상남도	창원시의창구	봉림동	봉림동제6투	4794	3457	1337	10	3447	1999	1435	3	3	5	2
경상남도	창원시의창구	봉림동	봉림동제7투	3838	2978	860	9	2969	1738	1222	0	2	3	4
경상남도	창원시의창구	용지동	소계	26911	20932	5979	72	20860	12102	8684	11	14	30	19
경상남도	창원시의창구	용지동	용지동제1투	2292	1833	459	7	1826	1004	816	0	2	3	1
경상남도	창원시의창구	용지동	용지동제2투	3536	2826	710	12	2814	1632	1171	1	0	5	5
경상남도	창원시의창구	용지동	용지동제3투	2862	2300	562	7	2293	1239	1048	2	1	1	2
경상남도	창원시의창구	용지동	용지동제4투	3692	2850	842	5	2845	1616	1221	0	2	5	1
경상남도	창원시의창구	용지동	용지동제5투	3649	2686	963	13	2673	1653	1007	4	0	5	4
경상남도	창원시의창구	용지동	용지동제6투	4815	3482	1333	11	3471	2073	1384	2	6	5	1
경상남도	창원시의창구	용지동	용지동제7투	3558	2982	576	10	2972	1835	1124	2	2	6	3
경상남도	창원시의창구	용지동	용지동제8투	2507	1973	534	7	1966	1050	913	0	1	0	2
경상남도	창원시의창구	잘못 투입·구분된 투표지	잘못 투입·구분된 투표지	0	4	-4	0	4	2	2	0	0	0	0
경상남도	창원시성산구	계	계	186559	150912	35647	518	150394	82487	67332	82	113	231	149
경상남도	창원시성산구	재외투표	재외투표	770	519	251	0	519	242	272	1	2	2	0
경상남도	창원시성산구	국내부재자투표	국내부재자투표	7005	6530	475	75	6455	3162	3227	13	12	24	17
경상남도	창원시성산구	반송동	소계	35248	29234	6014	75	29159	16706	12367	13	7	40	26
경상남도	창원시성산구	반송동	반송동제1투	2865	2421	444	5	2416	1424	984	0	0	6	2
경상남도	창원시성산구	반송동	반송동제2투	3211	2763	448	13	2750	1562	1177	2	1	5	3
경상남도	창원시성산구	반송동	반송동제3투	2871	2480	391	4	2476	1349	1118	2	0	5	2
경상남도	창원시성산구	반송동	반송동제4투	2902	2534	368	6	2528	1379	1144	1	0	4	0
경상남도	창원시성산구	반송동	반송동제5투	3110	2736	374	6	2730	1466	1257	1	0	4	2
경상남도	창원시성산구	반송동	반송동제6투	3077	2555	522	3	2552	1429	1120	1	0	2	0
경상남도	창원시성산구	반송동	반송동제7투	3661	3167	494	6	3161	1757	1396	0	0	5	3
경상남도	창원시성산구	반송동	반송동제8투	3697	2764	933	5	2759	1723	1031	1	0	2	2
경상남도	창원시성산구	반송동	반송동제9투	3223	2409	814	5	2404	1486	905	3	2	1	7
경상남도	창원시성산구	반송동	반송동제10투	3409	2590	819	14	2576	1516	1054	2	1	2	1
경상남도	창원시성산구	반송동	반송동제11투	3222	2815	407	8	2807	1615	1181	0	3	4	4
경상남도	창원시성산구	중앙동	소계	18130	12686	5444	50	12636	7028	5564	5	8	17	14
경상남도	창원시성산구	중앙동	중앙동제1투	3215	2098	1117	7	2091	1226	857	0	2	2	4
경상남도	창원시성산구	중앙동	중앙동제2투	3229	1914	1315	5	1909	1099	802	1	3	2	2
경상남도	창원시성산구	중앙동	중앙동제3투	2993	2085	908	12	2073	1322	741	2	0	3	5
경상남도	창원시성산구	중앙동	중앙동제4투	2891	2076	815	12	2064	1098	962	0	0	4	0
경상남도	창원시성산구	중앙동	중앙동제5투	3430	2608	822	9	2599	1366	1229	0	0	3	1
경상남도	창원시성산구	중앙동	중앙동제6투	2372	1905	467	5	1900	917	973	2	3	3	2
경상남도	창원시성산구	상남동	소계	23596	19147	4449	41	19106	10717	8319	7	14	36	13
경상남도	창원시성산구	상남동	상남동제1투	3735	3136	599	5	3131	1615	1502	2	3	5	4
경상남도	창원시성산구	상남동	상남동제2투	3187	2574	613	9	2565	1334	1220	1	2	4	4
경상남도	창원시성산구	상남동	상남동제3투	3898	3290	608	8	3282	1905	1369	1	1	6	0
경상남도	창원시성산구	상남동	상남동제4투	4161	3440	721	3	3437	2057	1364	2	3	9	2
경상남도	창원시성산구	상남동	상남동제5투	4247	3376	871	9	3367	1813	1547	1	1	5	0
경상남도	창원시성산구	상남동	상남동제6투	4368	3331	1037	7	3324	1993	1317	0	4	7	3
경상남도	창원시성산구	사파동	소계	41203	33506	7697	120	33386	17934	15329	20	28	47	28
경상남도	창원시성산구	사파동	사파동제1투	5170	3906	1264	9	3897	2205	1679	2	3	5	3
경상남도	창원시성산구	사파동	사파동제2투	3499	2677	822	16	2661	1611	1039	0	3	6	2
경상남도	창원시성산구	사파동	사파동제3투	2195	1812	383	8	1804	917	874	2	3	4	4
경상남도	창원시성산구	사파동	사파동제4투	3768	3086	682	13	3073	1675	1379	2	6	7	4
경상남도	창원시성산구	사파동	사파동제5투	4616	3834	782	8	3826	1999	1813	1	3	4	6
경상남도	창원시성산구	사파동	사파동제6투	3512	3004	508	10	2994	1584	1398	1	1	8	2
경상남도	창원시성산구	사파동	사파동제7투	2942	2112	830	16	2096	1283	806	4	1	2	0
경상남도	창원시성산구	사파동	사파동제8투	3986	3308	678	12	3296	1728	1557	3	1	5	2
경상남도	창원시성산구	사파동	사파동제9투	4212	3535	677	14	3521	1856	1655	2	3	3	2
경상남도	창원시성산구	사파동	사파동제10투	3221	2806	415	6	2800	1433	1364	0	0	1	2
경상남도	창원시성산구	사파동	사파동제11투	4082	3426	656	8	3418	1643	1765	3	4	2	1
경상남도	창원시성산구	가음정동	소계	32849	26608	6241	90	26518	14390	12037	11	24	27	29
경상남도	창원시성산구	가음정동	가음정동제1투	4405	3359	1046	5	3354	1669	1671	2	0	9	3
경상남도	창원시성산구	가음정동	가음정동제2투	2919	2284	635	19	2265	1226	1031	0	5	0	3
경상남도	창원시성산구	가음정동	가음정동제3투	2949	2370	579	4	2366	1289	1068	1	2	3	3
경상남도	창원시성산구	가음정동	가음정동제4투	4455	3705	750	9	3696	1983	1710	0	1	1	1
경상남도	창원시성산구	가음정동	가음정동제5투	3986	3426	560	7	3419	1895	1513	1	4	3	3
경상남도	창원시성산구	가음정동	가음정동제6투	3677	3131	546	8	3123	1806	1307	0	3	3	4
경상남도	창원시성산구	가음정동	가음정동제7투	3299	2527	772	10	2517	1510	995	3	4	2	3
경상남도	창원시성산구	가음정동	가음정동제8투	2934	2406	528	9	2397	1151	1235	1	3	2	5
경상남도	창원시성산구	가음정동	가음정동제9투	4225	3400	825	19	3381	1861	1507	3	2	4	4
경상남도	창원시성산구	성주동	소계	19787	16247	3540	41	16206	8564	7591	3	12	25	11
경상남도	창원시성산구	성주동	성주동제1투	2783	2269	514	3	2266	1319	942	0	1	2	2
경상남도	창원시성산구	성주동	성주동제2투	3289	2548	741	9	2539	1119	1403	0	8	7	2
경상남도	창원시성산구	성주동	성주동제3투	4041	3231	810	16	3215	1583	1619	3	2	6	2
경상남도	창원시성산구	성주동	성주동제4투	2643	2278	365	4	2274	1136	1133	0	1	2	2
경상남도	창원시성산구	성주동	성주동제5투	3754	3174	580	3	3171	1872	1291	0	0	6	2
경상남도	창원시성산구	성주동	성주동제6투	3277	2747	530	6	2741	1535	1203	0	0	2	1
경상남도	창원시성산구	웅남동	소계	7971	6435	1536	26	6409	3744	2626	9	6	13	11
경상남도	창원시성산구	웅남동	웅남동제1투	1923	1496	427	4	1492	937	547	2	2	1	3
경상남도	창원시성산구	웅남동	웅남동제2투	2669	2208	461	11	2197	1262	923	3	2	6	1
경상남도	창원시성산구	웅남동	웅남동제3투	2292	1871	421	9	1862	1119	730	3	2	6	2
경상남도	창원시성산구	웅남동	웅남동제4투	1087	860	227	2	858	426	426	1	0	0	5
경상남도	창원시성산구	잘못 투입·구분된 투표지	잘못 투입·구분된 투표지	0	0	0	0	0	0	0	0	0	0	0
경상남도	창원시마산합포구	계	계	153218	118829	34389	628	118201	82970	34740	72	51	144	224
경상남도	창원시마산합포구	재외투표	재외투표	905	608	297	4	604	333	265	2	0	3	1
경상남도	창원시마산합포구	국내부재자투표	국내부재자투표	4641	4342	299	88	4254	2247	1945	10	11	12	29
경상남도	창원시마산합포구	구산면	소계	4520	3358	1162	38	3320	2546	747	2	2	0	23
경상남도	창원시마산합포구	구산면	구산면제1투	1790	1351	439	12	1339	990	340	1	1	0	7
경상남도	창원시마산합포구	구산면	구산면제2투	2730	2007	723	26	1981	1556	407	1	1	0	16
경상남도	창원시마산합포구	진동면	소계	8628	6638	1990	49	6589	4609	1948	5	4	9	14
경상남도	창원시마산합포구	진동면	진동면제1투	1142	896	246	6	890	682	203	1	3	0	1
경상남도	창원시마산합포구	진동면	진동면제2투	3317	2529	788	24	2505	1784	706	2	1	4	8
경상남도	창원시마산합포구	진동면	진동면제3투	4169	3213	956	19	3194	2143	1039	2	0	5	5
경상남도	창원시마산합포구	진북면	소계	3495	2609	886	23	2586	1971	596	3	0	1	15
경상남도	창원시마산합포구	진북면	진북면제1투	2568	1922	646	17	1905	1426	464	2	0	1	12
경상남도	창원시마산합포구	진북면	진북면제2투	927	687	240	6	681	545	132	1	0	0	3
경상남도	창원시마산합포구	진전면	소계	3940	3007	933	56	2951	2354	563	3	1	2	28
경상남도	창원시마산합포구	진전면	진전면제1투	2477	1887	590	26	1861	1482	364	2	0	1	12
경상남도	창원시마산합포구	진전면	진전면제2투	1463	1120	343	30	1090	872	199	1	1	1	16
경상남도	창원시마산합포구	현동	소계	1851	1450	401	11	1439	1124	306	1	0	3	5
경상남도	창원시마산합포구	현동	현동제1투	1344	1043	301	9	1034	808	220	0	0	2	4
경상남도	창원시마산합포구	현동	현동제2투	507	407	100	2	405	316	86	1	0	1	1
경상남도	창원시마산합포구	가포동	소계	1323	1018	305	1	1017	756	256	1	1	0	3
경상남도	창원시마산합포구	가포동	가포동투표소	1323	1018	305	1	1017	756	256	1	1	0	3
경상남도	창원시마산합포구	월영동	소계	25249	20109	5140	58	20051	13100	6906	6	1	24	14
경상남도	창원시마산합포구	월영동	월영동제1투	2759	1991	768	10	1981	1300	677	0	0	2	2
경상남도	창원시마산합포구	월영동	월영동제2투	3116	2292	824	3	2289	1611	672	1	0	1	4
경상남도	창원시마산합포구	월영동	월영동제3투	3302	2620	682	11	2609	1721	883	1	0	3	1
경상남도	창원시마산합포구	월영동	월영동제4투	3658	2878	780	8	2870	1845	1018	1	0	4	2
경상남도	창원시마산합포구	월영동	월영동제5투	2738	2264	474	7	2257	1538	716	0	0	3	0
경상남도	창원시마산합포구	월영동	월영동제6투	2884	2434	450	6	2428	1559	860	2	0	5	2
경상남도	창원시마산합포구	월영동	월영동제7투	3353	2798	555	9	2789	1791	990	1	0	4	3
경상남도	창원시마산합포구	월영동	월영동제8투	3439	2832	607	4	2828	1735	1090	0	1	2	0
경상남도	창원시마산합포구	문화동	소계	11080	8537	2543	34	8503	6043	2435	1	4	12	8
경상남도	창원시마산합포구	문화동	문화동제1투	3820	2846	974	12	2834	2014	810	1	1	4	4
경상남도	창원시마산합포구	문화동	문화동제2투	3188	2445	743	12	2433	1751	675	0	0	4	3
경상남도	창원시마산합포구	문화동	문화동제3투	4072	3246	826	10	3236	2278	950	0	3	4	1
경상남도	창원시마산합포구	반월동	소계	7234	5757	1477	24	5733	3958	1757	4	1	7	6
경상남도	창원시마산합포구	반월동	반월동제1투	4995	4019	976	14	4005	2666	1328	3	1	5	2
경상남도	창원시마산합포구	반월동	반월동제2투	2239	1738	501	10	1728	1292	429	1	0	2	4
경상남도	창원시마산합포구	중앙동	소계	7015	5603	1412	20	5583	3881	1687	4	4	5	2
경상남도	창원시마산합포구	중앙동	중앙동제1투	3188	2492	696	9	2483	1742	732	3	2	4	0
경상남도	창원시마산합포구	중앙동	중앙동제2투	3827	3111	716	11	3100	2139	955	1	2	1	2
경상남도	창원시마산합포구	완월동	소계	9433	7336	2097	34	7302	5149	2122	7	3	10	11
경상남도	창원시마산합포구	완월동	완월동제1투	2514	1814	700	8	1806	1338	463	0	0	1	4
경상남도	창원시마산합포구	완월동	완월동제2투	3105	2455	650	14	2441	1744	684	3	3	2	5
경상남도	창원시마산합포구	완월동	완월동제3투	3814	3067	747	12	3055	2067	975	4	0	7	2
경상남도	창원시마산합포구	자산동	소계	11139	8735	2404	35	8700	6251	2421	4	5	9	10
경상남도	창원시마산합포구	자산동	자산동제1투	3810	3113	697	8	3105	2224	875	1	1	1	3
경상남도	창원시마산합포구	자산동	자산동제2투	2247	1597	650	7	1590	1201	383	0	2	3	1
경상남도	창원시마산합포구	자산동	자산동제3투	2304	1799	505	13	1786	1300	479	1	0	1	5
경상남도	창원시마산합포구	자산동	자산동제4투	2778	2226	552	7	2219	1526	684	2	2	4	1
경상남도	창원시마산합포구	동서동	소계	9300	7198	2102	21	7177	5227	1929	2	2	11	6
경상남도	창원시마산합포구	동서동	동서동제1투	3606	2616	990	10	2606	2033	568	0	0	4	1
경상남도	창원시마산합포구	동서동	동서동제2투	3347	2624	723	7	2617	1833	776	2	1	3	2
경상남도	창원시마산합포구	동서동	동서동제3투	2347	1958	389	4	1954	1361	585	0	1	4	3
경상남도	창원시마산합포구	성호동	소계	4028	2987	1041	24	2963	2235	716	3	2	3	4
경상남도	창원시마산합포구	성호동	성호동투표소	4028	2987	1041	24	2963	2235	716	3	2	3	4
경상남도	창원시마산합포구	교방동	소계	9166	7065	2101	27	7038	4897	2119	2	1	6	13
경상남도	창원시마산합포구	교방동	교방동제1투	3066	2294	772	7	2287	1666	616	1	0	2	2
경상남도	창원시마산합포구	교방동	교방동제2투	3738	2979	759	10	2969	1870	1091	1	1	2	4
경상남도	창원시마산합포구	교방동	교방동제3투	2362	1792	570	10	1782	1361	412	0	0	2	7
경상남도	창원시마산합포구	노산동	소계	6397	4901	1496	19	4882	3602	1259	3	0	4	14
경상남도	창원시마산합포구	노산동	노산동제1투	3202	2591	611	9	2582	1835	738	1	0	2	6
경상남도	창원시마산합포구	노산동	노산동제2투	3195	2310	885	10	2300	1767	521	2	0	2	8
경상남도	창원시마산합포구	오동동	소계	4551	3129	1422	13	3116	2334	775	1	0	2	4
경상남도	창원시마산합포구	오동동	오동동제1투	2722	1859	863	7	1852	1358	490	0	0	2	2
경상남도	창원시마산합포구	오동동	오동동제2투	1829	1270	559	6	1264	976	285	1	0	0	2
경상남도	창원시마산합포구	합포동	소계	6862	5076	1786	20	5056	3752	1284	1	4	6	9
경상남도	창원시마산합포구	합포동	합포동제1투	3617	2766	851	10	2756	1969	774	1	3	3	6
경상남도	창원시마산합포구	합포동	합포동제2투	3245	2310	935	10	2300	1783	510	0	1	3	3
경상남도	창원시마산합포구	산호동	소계	12461	9366	3095	29	9337	6601	2704	7	5	15	5
경상남도	창원시마산합포구	산호동	산호동제1투	3194	2469	725	12	2457	1739	705	4	2	4	3
경상남도	창원시마산합포구	산호동	산호동제2투	2681	1907	774	7	1900	1338	558	0	0	4	0
경상남도	창원시마산합포구	산호동	산호동제3투	3569	2782	787	5	2777	1929	836	1	3	6	2
경상남도	창원시마산합포구	산호동	산호동제4투	3017	2208	809	5	2203	1595	605	2	0	1	0
경상남도	창원시마산합포구	잘못 투입·구분된 투표지	잘못 투입·구분된 투표지	0	0	0	0	0	0	0	0	0	0	0
경상남도	창원시마산회원구	계	계	176017	138388	37629	631	137757	91940	45353	76	52	154	182
경상남도	창원시마산회원구	재외투표	재외투표	579	388	191	2	386	162	223	0	0	1	0
경상남도	창원시마산회원구	국내부재자투표	국내부재자투표	5009	4692	317	82	4610	2445	2117	7	8	10	23
경상남도	창원시마산회원구	내서읍	소계	51522	41689	9833	138	41551	26057	15365	17	11	47	54
경상남도	창원시마산회원구	내서읍	내서읍제1투	524	423	101	5	418	328	89	0	0	0	1
경상남도	창원시마산회원구	내서읍	내서읍제2투	4284	3543	741	8	3535	2177	1353	1	0	2	2
경상남도	창원시마산회원구	내서읍	내서읍제3투	2769	2238	531	10	2228	1416	804	2	1	3	2
경상남도	창원시마산회원구	내서읍	내서읍제4투	3774	3287	487	9	3278	1999	1270	1	0	4	4
경상남도	창원시마산회원구	내서읍	내서읍제5투	3522	2805	717	5	2800	1854	936	3	1	3	3
경상남도	창원시마산회원구	내서읍	내서읍제6투	3334	2683	651	13	2670	1828	830	1	0	7	4
경상남도	창원시마산회원구	내서읍	내서읍제7투	4303	3352	951	13	3339	2253	1078	0	2	1	5
경상남도	창원시마산회원구	내서읍	내서읍제8투	4053	3095	958	14	3081	2001	1069	1	0	4	6
경상남도	창원시마산회원구	내서읍	내서읍제9투	3386	2519	867	14	2505	1699	792	1	0	3	10
경상남도	창원시마산회원구	내서읍	내서읍제10투	4746	3896	850	6	3890	2326	1554	2	2	2	4
경상남도	창원시마산회원구	내서읍	내서읍제11투	3560	2858	702	6	2852	1666	1182	0	2	2	0
경상남도	창원시마산회원구	내서읍	내서읍제12투	4856	3912	944	14	3898	2358	1529	2	2	4	3
경상남도	창원시마산회원구	내서읍	내서읍제13투	4462	3734	728	7	3727	2172	1542	1	1	5	6
경상남도	창원시마산회원구	내서읍	내서읍제14투	3290	2804	486	11	2793	1585	1202	0	0	4	2
경상남도	창원시마산회원구	내서읍	내서읍제15투	659	540	119	3	537	395	135	2	0	3	2
경상남도	창원시마산회원구	회원1동	소계	10876	8346	2530	52	8294	6182	2092	1	1	10	8
경상남도	창원시마산회원구	회원1동	회원1동제1투	3781	2922	859	23	2899	2220	674	1	0	2	2
경상남도	창원시마산회원구	회원1동	회원1동제2투	3915	3007	908	11	2996	2187	797	0	0	7	5
경상남도	창원시마산회원구	회원1동	회원1동제3투	3180	2417	763	18	2399	1775	621	0	1	1	1
경상남도	창원시마산회원구	회원2동	소계	11982	9022	2960	39	8983	6521	2433	7	5	5	12
경상남도	창원시마산회원구	회원2동	회원2동제1투	2962	2118	844	9	2109	1589	512	3	0	2	3
경상남도	창원시마산회원구	회원2동	회원2동제2투	2957	2288	669	8	2280	1626	647	2	1	1	3
경상남도	창원시마산회원구	회원2동	회원2동제3투	3333	2547	786	14	2533	1868	656	1	4	2	2
경상남도	창원시마산회원구	회원2동	회원2동제4투	2730	2069	661	8	2061	1438	618	1	0	0	4
경상남도	창원시마산회원구	석전1동	소계	6975	5381	1594	33	5348	3779	1549	3	4	4	9
경상남도	창원시마산회원구	석전1동	석전1동제1투	2701	2114	587	8	2106	1473	626	1	1	2	3
경상남도	창원시마산회원구	석전1동	석전1동제2투	1992	1490	502	11	1479	1067	407	1	2	0	2
경상남도	창원시마산회원구	석전1동	석전1동제3투	2282	1777	505	14	1763	1239	516	1	1	2	4
경상남도	창원시마산회원구	석전2동	소계	7970	6089	1881	28	6061	4338	1700	5	2	6	10
경상남도	창원시마산회원구	석전2동	석전2동제1투	1998	1607	391	7	1600	1159	432	1	0	3	5
경상남도	창원시마산회원구	석전2동	석전2동제2투	2557	1909	648	15	1894	1356	530	3	1	1	3
경상남도	창원시마산회원구	석전2동	석전2동제3투	3415	2573	842	6	2567	1823	738	1	1	2	2
경상남도	창원시마산회원구	회성동	소계	7008	5281	1727	44	5237	3830	1382	7	3	2	13
경상남도	창원시마산회원구	회성동	회성동제1투	3142	2337	805	12	2325	1701	614	3	1	1	5
경상남도	창원시마산회원구	회성동	회성동제2투	2834	2168	666	27	2141	1583	549	3	0	0	6
경상남도	창원시마산회원구	회성동	회성동제3투	1032	776	256	5	771	546	219	1	2	1	2
경상남도	창원시마산회원구	양덕1동	소계	11111	8450	2661	29	8421	5731	2662	5	4	11	8
경상남도	창원시마산회원구	양덕1동	양덕1동제1투	3768	2855	913	7	2848	1945	895	2	2	1	3
경상남도	창원시마산회원구	양덕1동	양덕1동제2투	3687	2892	795	13	2879	1958	912	3	1	5	0
경상남도	창원시마산회원구	양덕1동	양덕1동제3투	3656	2703	953	9	2694	1828	855	0	1	5	5
경상남도	창원시마산회원구	양덕2동	소계	22590	18314	4276	51	18263	12084	6130	10	4	26	9
경상남도	창원시마산회원구	양덕2동	양덕2동제1투	4177	3411	766	8	3403	2173	1221	0	2	5	2
경상남도	창원시마산회원구	양덕2동	양덕2동제2투	3877	3233	644	7	3226	2128	1090	2	0	4	2
경상남도	창원시마산회원구	양덕2동	양덕2동제3투	3489	2693	796	10	2683	1808	865	3	2	4	1
경상남도	창원시마산회원구	양덕2동	양덕2동제4투	2990	2356	634	7	2349	1554	789	2	0	3	1
경상남도	창원시마산회원구	양덕2동	양덕2동제5투	3180	2415	765	12	2403	1561	834	3	0	2	3
경상남도	창원시마산회원구	양덕2동	양덕2동제6투	4877	4206	671	7	4199	2860	1331	0	0	8	0
경상남도	창원시마산회원구	합성1동	소계	8744	6594	2150	33	6561	4597	1942	1	1	10	10
경상남도	창원시마산회원구	합성1동	합성1동제1투	3160	2353	807	16	2337	1602	727	0	0	4	4
경상남도	창원시마산회원구	합성1동	합성1동제2투	2847	2161	686	9	2152	1518	627	0	0	4	3
경상남도	창원시마산회원구	합성1동	합성1동제3투	2737	2080	657	8	2072	1477	588	1	1	2	3
경상남도	창원시마산회원구	합성2동	소계	8872	6559	2313	22	6537	4545	1976	3	1	4	8
경상남도	창원시마산회원구	합성2동	합성2동제1투	2890	2192	698	10	2182	1482	694	1	1	1	3
경상남도	창원시마산회원구	합성2동	합성2동제2투	3199	2305	894	7	2298	1649	646	0	0	0	3
경상남도	창원시마산회원구	합성2동	합성2동제3투	2783	2062	721	5	2057	1414	636	2	0	3	2
경상남도	창원시마산회원구	구암1동	소계	9793	7629	2164	35	7594	5077	2491	6	4	8	8
경상남도	창원시마산회원구	구암1동	구암1동제1투	3503	2673	830	16	2657	1800	853	0	0	1	3
경상남도	창원시마산회원구	구암1동	구암1동제2투	2543	1989	554	4	1985	1359	614	3	3	4	2
경상남도	창원시마산회원구	구암1동	구암1동제3투	3747	2967	780	15	2952	1918	1024	3	1	3	3
경상남도	창원시마산회원구	구암2동	소계	9296	7318	1978	31	7287	4775	2487	3	4	10	8
경상남도	창원시마산회원구	구암2동	구암2동제1투	3130	2516	614	9	2507	1642	855	0	2	6	2
경상남도	창원시마산회원구	구암2동	구암2동제2투	4248	3373	875	13	3360	2199	1153	2	1	3	2
경상남도	창원시마산회원구	구암2동	구암2동제3투	1918	1429	489	9	1420	934	479	1	1	1	4
경상남도	창원시마산회원구	봉암동	소계	3690	2636	1054	12	2624	1817	804	1	0	0	2
경상남도	창원시마산회원구	봉암동	봉암동제1투	1545	1121	424	6	1115	729	385	0	0	0	1
경상남도	창원시마산회원구	봉암동	봉암동제2투	2145	1515	630	6	1509	1088	419	1	0	0	1
경상남도	창원시마산회원구	잘못 투입·구분된 투표지	잘못 투입·구분된 투표지	0	0	0	0	0	0	0	0	0	0	0
경상남도	창원시진해구	계	계	138512	106832	31680	494	106338	68464	37511	60	57	122	124
경상남도	창원시진해구	재외투표	재외투표	771	515	256	3	512	315	193	1	1	2	0
경상남도	창원시진해구	국내부재자투표	국내부재자투표	7093	6586	507	105	6481	4087	2320	14	18	19	23
경상남도	창원시진해구	중앙동	소계	4957	3874	1083	4	3870	2721	1134	1	0	8	6
경상남도	창원시진해구	중앙동	중앙동투표소	4957	3874	1083	4	3870	2721	1134	1	0	8	6
경상남도	창원시진해구	태평동	소계	5325	4040	1285	21	4019	2853	1148	3	0	11	4
경상남도	창원시진해구	태평동	태평동제1투	2821	2114	707	13	2101	1496	599	1	0	4	1
경상남도	창원시진해구	태평동	태평동제2투	2504	1926	578	8	1918	1357	549	2	0	7	3
경상남도	창원시진해구	충무동	소계	3755	2762	993	13	2749	2086	656	1	3	1	2
경상남도	창원시진해구	충무동	충무동투표소	3755	2762	993	13	2749	2086	656	1	3	1	2
경상남도	창원시진해구	여좌동	소계	9629	7370	2259	32	7338	5303	2010	4	1	10	10
경상남도	창원시진해구	여좌동	여좌동제1투	2158	1613	545	11	1602	1168	428	2	0	2	2
경상남도	창원시진해구	여좌동	여좌동제2투	3740	2871	869	12	2859	2053	795	0	0	8	3
경상남도	창원시진해구	여좌동	여좌동제3투	3731	2886	845	9	2877	2082	787	2	1	0	5
경상남도	창원시진해구	태백동	소계	5877	4413	1464	23	4390	3256	1122	5	2	2	3
경상남도	창원시진해구	태백동	태백동제1투	3094	2334	760	14	2320	1688	627	3	1	1	0
경상남도	창원시진해구	태백동	태백동제2투	2783	2079	704	9	2070	1568	495	2	1	1	3
경상남도	창원시진해구	경화동	소계	8666	6717	1949	20	6697	4445	2228	3	2	9	10
경상남도	창원시진해구	경화동	경화동제1투	4085	3022	1063	11	3011	2121	879	2	1	3	5
경상남도	창원시진해구	경화동	경화동제2투	4581	3695	886	9	3686	2324	1349	1	1	6	5
경상남도	창원시진해구	병암동	소계	6663	5097	1566	25	5072	3341	1724	1	0	3	3
경상남도	창원시진해구	병암동	병암동제1투	3297	2547	750	14	2533	1671	859	1	0	1	1
경상남도	창원시진해구	병암동	병암동제2투	3366	2550	816	11	2539	1670	865	0	0	2	2
경상남도	창원시진해구	석동	소계	13575	10959	2616	32	10927	6491	4420	1	6	8	1
경상남도	창원시진해구	석동	석동제1투	5900	4575	1325	13	4562	2714	1843	0	2	3	0
경상남도	창원시진해구	석동	석동제2투	3599	2897	702	4	2893	1728	1159	1	3	1	1
경상남도	창원시진해구	석동	석동제3투	4076	3487	589	15	3472	2049	1418	0	1	4	0
경상남도	창원시진해구	이동	소계	9330	6851	2479	25	6826	4577	2232	0	3	5	9
경상남도	창원시진해구	이동	이동제1투	3359	2398	961	8	2390	1600	785	0	0	0	5
경상남도	창원시진해구	이동	이동제2투	2865	2094	771	9	2085	1424	655	0	1	2	3
경상남도	창원시진해구	이동	이동제3투	3106	2359	747	8	2351	1553	792	0	2	3	1
경상남도	창원시진해구	자은동	소계	8920	6998	1922	28	6970	4363	2591	1	5	6	4
경상남도	창원시진해구	자은동	자은동제1투	3846	3061	785	6	3055	1929	1122	0	0	3	1
경상남도	창원시진해구	자은동	자은동제2투	5074	3937	1137	22	3915	2434	1469	1	5	3	3
경상남도	창원시진해구	덕산동	소계	7828	6096	1732	25	6071	4045	2003	3	3	6	11
경상남도	창원시진해구	덕산동	덕산동제1투	4105	3140	965	16	3124	2144	965	3	3	4	5
경상남도	창원시진해구	덕산동	덕산동제2투	3723	2956	767	9	2947	1901	1038	0	0	2	6
경상남도	창원시진해구	풍호동	소계	12909	10529	2380	28	10501	6611	3857	5	4	8	16
경상남도	창원시진해구	풍호동	풍호동제1투	4709	3799	910	9	3790	2394	1386	1	0	3	6
경상남도	창원시진해구	풍호동	풍호동제2투	3852	3237	615	12	3225	2017	1201	0	2	3	2
경상남도	창원시진해구	풍호동	풍호동제3투	4348	3493	855	7	3486	2200	1270	4	2	2	8
경상남도	창원시진해구	웅천동	소계	3958	2959	999	32	2927	2275	634	3	3	5	7
경상남도	창원시진해구	웅천동	웅천동제1투	2783	2081	702	24	2057	1586	458	2	1	5	5
경상남도	창원시진해구	웅천동	웅천동제2투	1175	878	297	8	870	689	176	1	2	0	2
경상남도	창원시진해구	웅동1동	소계	6400	4635	1765	20	4615	2832	1769	4	1	4	5
경상남도	창원시진해구	웅동1동	웅동1동제1투	3143	2313	830	11	2302	1419	879	1	0	2	1
경상남도	창원시진해구	웅동1동	웅동1동제2투	3257	2322	935	9	2313	1413	890	3	1	2	4
경상남도	창원시진해구	웅동2동	소계	22856	16428	6428	58	16370	8860	7470	10	5	15	10
경상남도	창원시진해구	웅동2동	웅동2동제1투	6927	4121	2806	24	4097	2396	1689	3	0	4	5
경상남도	창원시진해구	웅동2동	웅동2동제2투	4171	3078	1093	14	3064	1809	1246	4	1	1	3
경상남도	창원시진해구	웅동2동	웅동2동제3투	4411	3580	831	4	3576	1823	1746	1	1	5	0
경상남도	창원시진해구	웅동2동	웅동2동제4투	4114	3154	960	9	3145	1508	1633	1	1	2	0
경상남도	창원시진해구	웅동2동	웅동2동제5투	3233	2495	738	7	2488	1324	1156	1	2	3	2
경상남도	창원시진해구	잘못 투입·구분된 투표지	잘못 투입·구분된 투표지	0	3	-3	0	3	3	0	0	0	0	0
경상남도	진주시	계	계	264401	208886	55515	1395	207491	140404	66038	152	105	294	498
경상남도	진주시	재외투표	재외투표	1117	799	318	3	796	408	374	3	1	4	6
경상남도	진주시	국내부재자투표	국내부재자투표	8644	7919	725	135	7784	3968	3740	18	12	21	25
경상남도	진주시	문산읍	소계	7032	5529	1503	77	5452	3740	1673	10	4	8	17
경상남도	진주시	문산읍	문산읍제1투	4234	3300	934	53	3247	2240	979	8	2	4	14
경상남도	진주시	문산읍	문산읍제2투	2798	2229	569	24	2205	1500	694	2	2	4	3
경상남도	진주시	내동면	소계	3212	2607	605	18	2589	1727	845	0	3	3	11
경상남도	진주시	내동면	내동면투표소	3212	2607	605	18	2589	1727	845	0	3	3	11
경상남도	진주시	정촌면	소계	2626	2069	557	35	2034	1549	466	2	2	3	12
경상남도	진주시	정촌면	정촌면투표소	2626	2069	557	35	2034	1549	466	2	2	3	12
경상남도	진주시	금곡면	소계	2284	1814	470	32	1782	1323	437	2	4	5	11
경상남도	진주시	금곡면	금곡면투표소	2284	1814	470	32	1782	1323	437	2	4	5	11
경상남도	진주시	진성면	소계	2044	1579	465	13	1566	1135	405	4	1	5	16
경상남도	진주시	진성면	진성면투표소	2044	1579	465	13	1566	1135	405	4	1	5	16
경상남도	진주시	일반성면	소계	2615	2009	606	14	1995	1494	479	5	1	2	14
경상남도	진주시	일반성면	일반성면투표소	2615	2009	606	14	1995	1494	479	5	1	2	14
경상남도	진주시	이반성면	소계	1616	1264	352	37	1227	891	312	2	2	3	17
경상남도	진주시	이반성면	이반성면투표소	1616	1264	352	37	1227	891	312	2	2	3	17
경상남도	진주시	사봉면	소계	1598	1256	342	31	1225	887	321	2	0	3	12
경상남도	진주시	사봉면	사봉면투표소	1598	1256	342	31	1225	887	321	2	0	3	12
경상남도	진주시	지수면	소계	1522	1145	377	18	1127	802	304	3	0	2	16
경상남도	진주시	지수면	지수면투표소	1522	1145	377	18	1127	802	304	3	0	2	16
경상남도	진주시	대곡면	소계	3522	2626	896	46	2580	1924	628	3	1	2	22
경상남도	진주시	대곡면	대곡면투표소	3522	2626	896	46	2580	1924	628	3	1	2	22
경상남도	진주시	금산면	소계	16132	13041	3091	50	12991	7878	5054	5	10	15	29
경상남도	진주시	금산면	금산면제1투	3658	2873	785	18	2855	1920	911	0	4	4	16
경상남도	진주시	금산면	금산면제2투	4868	3891	977	13	3878	2425	1429	4	5	5	10
경상남도	진주시	금산면	금산면제3투	3254	2657	597	5	2652	1547	1100	1	1	2	1
경상남도	진주시	금산면	금산면제4투	4352	3620	732	14	3606	1986	1614	0	0	4	2
경상남도	진주시	집현면	소계	4331	3311	1020	55	3256	2282	945	2	4	4	19
경상남도	진주시	집현면	집현면투표소	4331	3311	1020	55	3256	2282	945	2	4	4	19
경상남도	진주시	미천면	소계	1702	1322	380	23	1299	988	287	2	0	3	19
경상남도	진주시	미천면	미천면투표소	1702	1322	380	23	1299	988	287	2	0	3	19
경상남도	진주시	명석면	소계	4013	3101	912	41	3060	2358	684	1	1	2	14
경상남도	진주시	명석면	명석면투표소	4013	3101	912	41	3060	2358	684	1	1	2	14
경상남도	진주시	대평면	소계	1039	839	200	13	826	645	176	1	1	1	2
경상남도	진주시	대평면	대평면투표소	1039	839	200	13	826	645	176	1	1	1	2
경상남도	진주시	수곡면	소계	2186	1745	441	33	1712	1237	453	2	3	4	13
경상남도	진주시	수곡면	수곡면투표소	2186	1745	441	33	1712	1237	453	2	3	4	13
경상남도	진주시	망경동	소계	13230	10834	2396	53	10781	7408	3337	5	2	20	9
경상남도	진주시	망경동	망경동제1투	3551	2730	821	23	2707	2023	673	2	1	5	3
경상남도	진주시	망경동	망경동제2투	3552	2877	675	14	2863	1997	857	3	1	1	4
경상남도	진주시	망경동	망경동제3투	2971	2548	423	4	2544	1731	802	0	0	11	0
경상남도	진주시	망경동	망경동제4투	3156	2679	477	12	2667	1657	1005	0	0	3	2
경상남도	진주시	강남동	소계	4700	3661	1039	19	3642	2699	937	0	0	2	4
경상남도	진주시	강남동	강남동제1투	2570	1992	578	7	1985	1454	528	0	0	2	1
경상남도	진주시	강남동	강남동제2투	2130	1669	461	12	1657	1245	409	0	0	0	3
경상남도	진주시	칠암동	소계	8154	6470	1684	31	6439	4299	2113	3	3	14	7
경상남도	진주시	칠암동	칠암동제1투	2805	2104	701	13	2091	1321	760	1	0	5	4
경상남도	진주시	칠암동	칠암동제2투	2783	2212	571	9	2203	1608	585	2	1	5	2
경상남도	진주시	칠암동	칠암동제3투	2566	2154	412	9	2145	1370	768	0	2	4	1
경상남도	진주시	성지동	소계	5173	3819	1354	16	3803	2831	958	2	1	5	6
경상남도	진주시	성지동	성지동투표소	5173	3819	1354	16	3803	2831	958	2	1	5	6
경상남도	진주시	중앙동	소계	3673	2709	964	18	2691	2115	571	3	1	0	1
경상남도	진주시	중앙동	중앙동투표소	3673	2709	964	18	2691	2115	571	3	1	0	1
경상남도	진주시	봉안동	소계	5573	4053	1520	29	4024	2980	1026	5	2	8	3
경상남도	진주시	봉안동	봉안동제1투	2610	1860	750	15	1845	1386	450	4	1	3	1
경상남도	진주시	봉안동	봉안동제2투	2963	2193	770	14	2179	1594	576	1	1	5	2
경상남도	진주시	상봉동동	소계	5824	4338	1486	27	4311	3205	1089	6	1	1	9
경상남도	진주시	상봉동동	상봉동동제1투	2959	2162	797	13	2149	1588	551	4	1	0	5
경상남도	진주시	상봉동동	상봉동동제2투	2865	2176	689	14	2162	1617	538	2	0	1	4
경상남도	진주시	상봉서동	소계	8362	6424	1938	30	6394	4652	1713	5	3	6	15
경상남도	진주시	상봉서동	상봉서동제1투	4256	3279	977	14	3265	2482	771	3	0	1	8
경상남도	진주시	상봉서동	상봉서동제2투	4106	3145	961	16	3129	2170	942	2	3	5	7
경상남도	진주시	봉수동	소계	3729	2825	904	12	2813	2170	624	3	2	4	10
경상남도	진주시	봉수동	봉수동투표소	3729	2825	904	12	2813	2170	624	3	2	4	10
경상남도	진주시	옥봉동	소계	5488	4079	1409	25	4054	3114	908	6	0	7	19
경상남도	진주시	옥봉동	옥봉동제1투	2814	2064	750	17	2047	1587	441	5	0	2	12
경상남도	진주시	옥봉동	옥봉동제2투	2674	2015	659	8	2007	1527	467	1	0	5	7
경상남도	진주시	상대1동	소계	11630	8798	2832	50	8748	6143	2577	1	6	8	13
경상남도	진주시	상대1동	상대1동제1투	3694	2848	846	11	2837	1986	843	0	1	2	5
경상남도	진주시	상대1동	상대1동제2투	3944	2974	970	24	2950	2037	902	0	3	3	5
경상남도	진주시	상대1동	상대1동제3투	3992	2976	1016	15	2961	2120	832	1	2	3	3
경상남도	진주시	상대2동	소계	9810	7535	2275	29	7506	5260	2231	1	0	5	9
경상남도	진주시	상대2동	상대2동제1투	2689	1908	781	8	1900	1313	584	0	0	1	2
경상남도	진주시	상대2동	상대2동제2투	3252	2464	788	7	2457	1730	722	0	0	1	4
경상남도	진주시	상대2동	상대2동제3투	3869	3163	706	14	3149	2217	925	1	0	3	3
경상남도	진주시	하대1동	소계	11741	9179	2562	32	9147	6205	2919	4	1	7	11
경상남도	진주시	하대1동	하대1동제1투	3689	2814	875	9	2805	1940	858	2	1	3	1
경상남도	진주시	하대1동	하대1동제2투	4010	3212	798	16	3196	2109	1079	1	0	3	4
경상남도	진주시	하대1동	하대1동제3투	4042	3153	889	7	3146	2156	982	1	0	1	6
경상남도	진주시	하대2동	소계	9614	7727	1887	41	7686	5251	2401	4	6	18	6
경상남도	진주시	하대2동	하대2동제1투	3368	2807	561	15	2792	1824	955	0	1	12	0
경상남도	진주시	하대2동	하대2동제2투	2882	2232	650	15	2217	1567	637	2	3	5	3
경상남도	진주시	하대2동	하대2동제3투	3364	2688	676	11	2677	1860	809	2	2	1	3
경상남도	진주시	상평동	소계	10499	8167	2332	20	8147	5674	2443	5	7	10	8
경상남도	진주시	상평동	상평동제1투	3205	2405	800	6	2399	1699	691	3	2	3	1
경상남도	진주시	상평동	상평동제2투	3037	2341	696	8	2333	1715	608	0	1	3	6
경상남도	진주시	상평동	상평동제3투	4257	3421	836	6	3415	2260	1144	2	4	4	1
경상남도	진주시	초장동	소계	10511	8791	1720	35	8756	5677	3037	3	0	20	19
경상남도	진주시	초장동	초장동제1투	3672	2909	763	10	2899	1996	887	3	0	6	7
경상남도	진주시	초장동	초장동제2투	3337	2836	501	19	2817	1861	940	0	0	8	8
경상남도	진주시	초장동	초장동제3투	3502	3046	456	6	3040	1820	1210	0	0	6	4
경상남도	진주시	평거동	소계	20833	16892	3941	75	16817	10495	6273	6	4	17	22
경상남도	진주시	평거동	평거동제1투	3782	2873	909	26	2847	1971	869	0	1	1	5
경상남도	진주시	평거동	평거동제2투	4186	3392	794	10	3382	2083	1291	1	0	5	2
경상남도	진주시	평거동	평거동제3투	3940	3309	631	18	3291	2004	1276	2	1	2	6
경상남도	진주시	평거동	평거동제4투	4603	3681	922	10	3671	2186	1473	1	0	6	5
경상남도	진주시	평거동	평거동제5투	4322	3637	685	11	3626	2251	1364	2	2	3	4
경상남도	진주시	신안동	소계	11180	8973	2207	38	8935	6097	2806	5	4	13	10
경상남도	진주시	신안동	신안동제1투	4447	3650	797	17	3633	2392	1231	2	2	3	3
경상남도	진주시	신안동	신안동제2투	3514	2866	648	11	2855	1957	882	1	2	7	6
경상남도	진주시	신안동	신안동제3투	3219	2457	762	10	2447	1748	693	2	0	3	1
경상남도	진주시	이현동	소계	11585	9107	2478	33	9074	6198	2847	4	3	11	11
경상남도	진주시	이현동	이현동제1투	4076	3391	685	11	3380	2259	1110	0	0	4	7
경상남도	진주시	이현동	이현동제2투	3683	2749	934	6	2743	1960	770	3	2	4	4
경상남도	진주시	이현동	이현동제3투	3826	2967	859	16	2951	1979	967	1	1	3	0
경상남도	진주시	판문동	소계	9844	7851	1993	42	7809	5053	2719	4	4	11	18
경상남도	진주시	판문동	판문동제1투	3537	2723	814	19	2704	1828	857	3	3	3	10
경상남도	진주시	판문동	판문동제2투	3645	2902	743	17	2885	1888	985	1	0	6	5
경상남도	진주시	판문동	판문동제3투	2662	2226	436	6	2220	1337	877	0	1	2	3
경상남도	진주시	가호동	소계	16013	12676	3337	66	12610	7639	4926	10	5	17	13
경상남도	진주시	가호동	가호동제1투	4070	3171	899	23	3148	1971	1162	2	2	5	6
경상남도	진주시	가호동	가호동제2투	4239	3293	946	15	3278	1893	1376	2	2	5	0
경상남도	진주시	가호동	가호동제3투	3695	2910	785	18	2892	1911	967	5	1	2	6
경상남도	진주시	가호동	가호동제4투	4009	3302	707	10	3292	1864	1421	1	0	5	1
경상남도	진주시	잘못 투입·구분된 투표지	잘못 투입·구분된 투표지	0	3	-3	0	3	3	0	0	0	0	0
경상남도	통영시	계	계	110617	82118	28499	580	81538	56873	24216	53	42	101	253
경상남도	통영시	재외투표	재외투표	312	203	109	2	201	98	103	0	0	0	0
경상남도	통영시	국내부재자투표	국내부재자투표	3573	3238	335	67	3171	1546	1590	5	8	13	9
경상남도	통영시	산양읍	소계	4758	3402	1356	46	3356	2569	740	5	3	5	34
경상남도	통영시	산양읍	산양읍제1투	3528	2545	983	33	2512	1897	579	5	3	4	24
경상남도	통영시	산양읍	산양읍제2투	827	564	263	6	558	452	102	0	0	0	4
경상남도	통영시	산양읍	산양읍제3투	286	205	81	3	202	155	41	0	0	1	5
경상남도	통영시	산양읍	산양읍제4투	117	88	29	4	84	65	18	0	0	0	1
경상남도	통영시	용남면	소계	8452	6376	2076	44	6332	4334	1960	3	3	10	22
경상남도	통영시	용남면	용남면제1투	2173	1597	576	6	1591	1055	530	1	1	2	2
경상남도	통영시	용남면	용남면제2투	3269	2418	851	24	2394	1710	667	2	1	4	10
경상남도	통영시	용남면	용남면제3투	322	226	96	3	223	193	25	0	1	0	4
경상남도	통영시	용남면	용남면제4투	2688	2135	553	11	2124	1376	738	0	0	4	6
경상남도	통영시	도산면	소계	2902	2240	662	28	2212	1662	512	4	2	9	23
경상남도	통영시	도산면	도산면제1투	1901	1440	461	17	1423	1060	340	2	0	6	15
경상남도	통영시	도산면	도산면제2투	513	420	93	5	415	331	75	1	1	2	5
경상남도	통영시	도산면	도산면제3투	488	380	108	6	374	271	97	1	1	1	3
경상남도	통영시	광도면	소계	17551	13077	4474	76	13001	7992	4953	7	2	11	36
경상남도	통영시	광도면	광도면제1투	1843	1381	462	16	1365	989	363	1	1	1	10
경상남도	통영시	광도면	광도면제2투	3195	2215	980	15	2200	1280	906	2	0	2	10
경상남도	통영시	광도면	광도면제3투	2093	1547	546	18	1529	1115	401	0	0	2	11
경상남도	통영시	광도면	광도면제4투	5704	4440	1264	16	4424	2636	1778	2	1	4	3
경상남도	통영시	광도면	광도면제5투	4716	3494	1222	11	3483	1972	1505	2	0	2	2
경상남도	통영시	욕지면	소계	1842	1224	618	13	1211	981	212	2	1	3	12
경상남도	통영시	욕지면	욕지면제1투	1366	882	484	8	874	690	171	1	0	3	9
경상남도	통영시	욕지면	욕지면제2투	189	137	52	2	135	103	27	1	1	0	3
경상남도	통영시	욕지면	욕지면제3투	287	205	82	3	202	188	14	0	0	0	0
경상남도	통영시	한산면	소계	2092	1576	516	25	1551	1350	177	0	0	0	24
경상남도	통영시	한산면	한산면제1투	1750	1334	416	24	1310	1157	134	0	0	0	19
경상남도	통영시	한산면	한산면제2투	168	135	33	1	134	119	14	0	0	0	1
경상남도	통영시	한산면	한산면제3투	174	107	67	0	107	74	29	0	0	0	4
경상남도	통영시	사량면	소계	1487	1097	390	17	1080	850	215	2	2	1	10
경상남도	통영시	사량면	사량면제1투	953	694	259	9	685	540	135	2	2	1	5
경상남도	통영시	사량면	사량면제2투	534	403	131	8	395	310	80	0	0	0	5
경상남도	통영시	도천동	소계	9274	6785	2489	56	6729	4947	1754	3	6	8	11
경상남도	통영시	도천동	도천동제1투	2970	2190	780	22	2168	1587	569	1	3	5	3
경상남도	통영시	도천동	도천동제2투	2527	1782	745	19	1763	1358	402	0	0	1	2
경상남도	통영시	도천동	도천동제3투	2238	1645	593	9	1636	1142	490	1	3	0	0
경상남도	통영시	도천동	도천동제4투	1539	1168	371	6	1162	860	293	1	0	2	6
경상남도	통영시	명정동	소계	3734	2655	1079	15	2640	2075	556	1	0	2	6
경상남도	통영시	명정동	명정동제1투	1895	1344	551	9	1335	1035	297	1	0	1	1
경상남도	통영시	명정동	명정동제2투	1839	1311	528	6	1305	1040	259	0	0	1	5
경상남도	통영시	중앙동	소계	5147	3691	1456	24	3667	2844	810	2	0	5	6
경상남도	통영시	중앙동	중앙동제1투	3092	2202	890	14	2188	1699	480	1	0	4	4
경상남도	통영시	중앙동	중앙동제2투	2055	1489	566	10	1479	1145	330	1	0	1	2
경상남도	통영시	정량동	소계	9125	6512	2613	29	6483	4870	1596	4	0	2	11
경상남도	통영시	정량동	정량동제1투	3061	2113	948	8	2105	1596	504	0	0	1	4
경상남도	통영시	정량동	정량동제2투	3226	2345	881	7	2338	1761	570	3	0	1	3
경상남도	통영시	정량동	정량동제3투	2838	2054	784	14	2040	1513	522	1	0	0	4
경상남도	통영시	북신동	소계	9145	6935	2210	24	6911	5143	1750	1	1	4	12
경상남도	통영시	북신동	북신동제1투	3521	2775	746	8	2767	1959	802	0	0	3	3
경상남도	통영시	북신동	북신동제2투	3076	2306	770	7	2299	1771	525	0	0	0	3
경상남도	통영시	북신동	북신동제3투	2548	1854	694	9	1845	1413	423	1	1	1	6
경상남도	통영시	무전동	소계	10686	8194	2492	32	8162	5413	2722	5	2	8	12
경상남도	통영시	무전동	무전동제1투	3926	2778	1148	16	2762	1979	773	1	0	2	7
경상남도	통영시	무전동	무전동제2투	3328	2638	690	7	2631	1663	957	2	2	3	4
경상남도	통영시	무전동	무전동제3투	3432	2778	654	9	2769	1771	992	2	0	3	1
경상남도	통영시	미수동	소계	9731	7289	2442	32	7257	4950	2281	2	5	11	8
경상남도	통영시	미수동	미수동제1투	2619	1891	728	11	1880	1403	471	1	2	2	1
경상남도	통영시	미수동	미수동제2투	3026	2296	730	14	2282	1500	776	1	2	2	1
경상남도	통영시	미수동	미수동제3투	2019	1455	564	4	1451	1038	406	0	0	3	4
경상남도	통영시	미수동	미수동제4투	2067	1647	420	3	1644	1009	628	0	1	4	2
경상남도	통영시	봉평동	소계	10806	7624	3182	50	7574	5249	2285	7	7	9	17
경상남도	통영시	봉평동	봉평동제1투	2548	1804	744	13	1791	1235	549	1	2	0	4
경상남도	통영시	봉평동	봉평동제2투	3179	2237	942	20	2217	1559	646	1	3	4	4
경상남도	통영시	봉평동	봉평동제3투	2754	1917	837	12	1905	1323	569	2	2	4	5
경상남도	통영시	봉평동	봉평동제4투	2325	1666	659	5	1661	1132	521	3	0	1	4
경상남도	통영시	잘못 투입·구분된 투표지	잘못 투입·구분된 투표지	0	0	0	0	0	0	0	0	0	0	0
경상남도	고성군	계	계	48227	35555	12672	439	35116	25076	9673	70	27	53	217
경상남도	고성군	재외투표	재외투표	473	299	174	1	298	194	103	0	0	0	1
경상남도	고성군	국내부재자투표	국내부재자투표	1651	1519	132	45	1474	769	693	4	3	1	4
경상남도	고성군	고성읍	소계	19923	14468	5455	94	14374	9790	4492	18	9	19	46
경상남도	고성군	고성읍	고성읍제1투	4188	2983	1205	13	2970	2005	957	2	1	3	2
경상남도	고성군	고성읍	고성읍제2투	5396	4032	1364	12	4020	2697	1311	4	2	3	3
경상남도	고성군	고성읍	고성읍제3투	2255	1524	731	17	1507	1053	439	1	2	3	9
경상남도	고성군	고성읍	고성읍제4투	2271	1641	630	10	1631	1176	444	2	0	3	6
경상남도	고성군	고성읍	고성읍제5투	3431	2524	907	26	2498	1611	868	3	2	2	12
경상남도	고성군	고성읍	고성읍제6투	959	737	222	7	730	511	209	2	1	3	4
경상남도	고성군	고성읍	고성읍제7투	1423	1027	396	9	1018	737	264	4	1	2	10
경상남도	고성군	삼산면	소계	1683	1193	490	16	1177	862	301	3	2	1	8
경상남도	고성군	삼산면	삼산면투표소	1683	1193	490	16	1177	862	301	3	2	1	8
경상남도	고성군	하일면	소계	1788	1300	488	17	1283	1030	223	6	1	5	18
경상남도	고성군	하일면	하일면투표소	1788	1300	488	17	1283	1030	223	6	1	5	18
경상남도	고성군	하이면	소계	2448	1869	579	31	1838	1403	403	6	2	5	19
경상남도	고성군	하이면	하이면투표소	2448	1869	579	31	1838	1403	403	6	2	5	19
경상남도	고성군	상리면	소계	1547	1187	360	16	1171	829	334	0	1	1	6
경상남도	고성군	상리면	상리면투표소	1547	1187	360	16	1171	829	334	0	1	1	6
경상남도	고성군	대가면	소계	1527	1157	370	15	1142	869	252	2	1	3	15
경상남도	고성군	대가면	대가면투표소	1527	1157	370	15	1142	869	252	2	1	3	15
경상남도	고성군	영현면	소계	898	693	205	16	677	492	164	7	1	2	11
경상남도	고성군	영현면	영현면투표소	898	693	205	16	677	492	164	7	1	2	11
경상남도	고성군	영오면	소계	1401	1091	310	35	1056	794	250	4	0	1	7
경상남도	고성군	영오면	영오면투표소	1401	1091	310	35	1056	794	250	4	0	1	7
경상남도	고성군	개천면	소계	1091	859	232	13	846	633	202	0	1	2	8
경상남도	고성군	개천면	개천면제1투	707	560	147	7	553	416	131	0	0	2	4
경상남도	고성군	개천면	개천면제2투	384	299	85	6	293	217	71	0	1	0	4
경상남도	고성군	구만면	소계	1011	757	254	13	744	512	225	2	0	2	3
경상남도	고성군	구만면	구만면투표소	1011	757	254	13	744	512	225	2	0	2	3
경상남도	고성군	회화면	소계	3408	2502	906	29	2473	1960	495	3	0	1	14
경상남도	고성군	회화면	회화면투표소	3408	2502	906	29	2473	1960	495	3	0	1	14
경상남도	고성군	마암면	소계	1656	1237	419	33	1204	863	319	5	2	1	14
경상남도	고성군	마암면	마암면투표소	1656	1237	419	33	1204	863	319	5	2	1	14
경상남도	고성군	동해면	소계	3307	2327	980	31	2296	1784	486	5	2	3	16
경상남도	고성군	동해면	동해면제1투	1775	1239	536	18	1221	953	255	3	0	1	9
경상남도	고성군	동해면	동해면제2투	1532	1088	444	13	1075	831	231	2	2	2	7
경상남도	고성군	거류면	소계	4415	3097	1318	34	3063	2292	731	5	2	6	27
경상남도	고성군	거류면	거류면제1투	2996	2060	936	20	2040	1507	505	3	1	6	18
경상남도	고성군	거류면	거류면제2투	1419	1037	382	14	1023	785	226	2	1	0	9
경상남도	고성군	잘못 투입·구분된 투표지	잘못 투입·구분된 투표지	0	0	0	0	0	0	0	0	0	0	0
경상남도	사천시	계	계	92267	70371	21896	672	69699	48033	21237	59	35	81	254
경상남도	사천시	재외투표	재외투표	425	281	144	1	280	163	115	0	1	1	0
경상남도	사천시	국내부재자투표	국내부재자투표	2914	2672	242	67	2605	1378	1203	4	4	8	8
경상남도	사천시	사천읍	소계	13158	9902	3256	64	9838	6449	3344	9	5	10	21
경상남도	사천시	사천읍	사천읍제1투	4410	3305	1105	15	3290	1956	1327	1	0	3	3
경상남도	사천시	사천읍	사천읍제2투	3238	2366	872	11	2355	1566	775	1	3	2	8
경상남도	사천시	사천읍	사천읍제3투	2284	1694	590	13	1681	1186	488	2	0	0	5
경상남도	사천시	사천읍	사천읍제4투	3226	2537	689	25	2512	1741	754	5	2	5	5
경상남도	사천시	정동면	소계	8375	6651	1724	53	6598	3986	2580	4	3	8	17
경상남도	사천시	정동면	정동면제1투	2197	1783	414	14	1769	1172	592	1	0	2	2
경상남도	사천시	정동면	정동면제2투	2594	2134	460	8	2126	1181	931	2	1	4	7
경상남도	사천시	정동면	정동면제3투	3584	2734	850	31	2703	1633	1057	1	2	2	8
경상남도	사천시	사남면	소계	8637	6848	1789	49	6799	4129	2645	0	3	3	19
경상남도	사천시	사남면	사남면제1투	2724	2083	641	28	2055	1526	513	0	2	0	14
경상남도	사천시	사남면	사남면제2투	2836	2294	542	8	2286	1294	989	0	1	0	2
경상남도	사천시	사남면	사남면제3투	3077	2471	606	13	2458	1309	1143	0	0	3	3
경상남도	사천시	용현면	소계	6583	4827	1756	37	4790	3336	1432	2	1	3	16
경상남도	사천시	용현면	용현면제1투	2700	1948	752	12	1936	1320	605	2	0	1	8
경상남도	사천시	용현면	용현면제2투	3883	2879	1004	25	2854	2016	827	0	1	2	8
경상남도	사천시	축동면	소계	1793	1418	375	18	1400	1118	268	1	2	1	10
경상남도	사천시	축동면	축동면투표소	1793	1418	375	18	1400	1118	268	1	2	1	10
경상남도	사천시	곤양면	소계	3524	2664	860	35	2629	1915	677	8	1	4	24
경상남도	사천시	곤양면	곤양면제1투	2613	1937	676	26	1911	1372	512	4	1	3	19
경상남도	사천시	곤양면	곤양면제2투	911	727	184	9	718	543	165	4	0	1	5
경상남도	사천시	곤명면	소계	2852	2267	585	26	2241	1673	543	4	1	3	17
경상남도	사천시	곤명면	곤명면제1투	1373	1073	300	15	1058	793	249	2	0	1	13
경상남도	사천시	곤명면	곤명면제2투	1479	1194	285	11	1183	880	294	2	1	2	4
경상남도	사천시	서포면	소계	3622	2655	967	48	2607	1983	585	0	1	4	34
경상남도	사천시	서포면	서포면투표소	3622	2655	967	48	2607	1983	585	0	1	4	34
경상남도	사천시	동서동	소계	7200	5219	1981	48	5171	4142	994	3	3	8	21
경상남도	사천시	동서동	동서동제1투	2741	1990	751	17	1973	1594	367	1	1	4	6
경상남도	사천시	동서동	동서동제2투	2262	1619	643	13	1606	1299	298	2	1	1	5
경상남도	사천시	동서동	동서동제3투	1894	1408	486	16	1392	1078	303	0	1	3	7
경상남도	사천시	동서동	동서동제4투	303	202	101	2	200	171	26	0	0	0	3
경상남도	사천시	선구동	소계	5312	3939	1373	30	3909	2834	1061	4	0	4	6
경상남도	사천시	선구동	선구동제1투	1818	1303	515	8	1295	938	352	0	0	3	2
경상남도	사천시	선구동	선구동제2투	1564	1168	396	10	1158	890	263	2	0	1	2
경상남도	사천시	선구동	선구동제3투	1930	1468	462	12	1456	1006	446	2	0	0	2
경상남도	사천시	동서금동	소계	4937	3554	1383	29	3525	2727	784	2	1	3	8
경상남도	사천시	동서금동	동서금동제1투	3022	2150	872	13	2137	1598	530	2	0	3	4
경상남도	사천시	동서금동	동서금동제2투	1915	1404	511	16	1388	1129	254	0	1	0	4
경상남도	사천시	벌용동	소계	12471	9466	3005	52	9414	6622	2752	11	4	11	14
경상남도	사천시	벌용동	벌용동제1투	3148	2288	860	15	2273	1691	573	2	1	1	5
경상남도	사천시	벌용동	벌용동제2투	2733	2096	637	9	2087	1565	512	6	1	3	0
경상남도	사천시	벌용동	벌용동제3투	2998	2271	727	13	2258	1593	660	1	1	0	3
경상남도	사천시	벌용동	벌용동제4투	3592	2811	781	15	2796	1773	1007	2	1	7	6
경상남도	사천시	향촌동	소계	5683	4327	1356	65	4262	3043	1185	5	4	4	21
경상남도	사천시	향촌동	향촌동제1투	4129	3163	966	23	3140	2214	906	3	3	3	11
경상남도	사천시	향촌동	향촌동제2투	1554	1164	390	42	1122	829	279	2	1	1	10
경상남도	사천시	남양동	소계	4781	3681	1100	50	3631	2535	1069	2	1	6	18
경상남도	사천시	남양동	남양동제1투	4124	3166	958	43	3123	2142	965	2	1	1	12
경상남도	사천시	남양동	남양동제2투	657	515	142	7	508	393	104	0	0	5	6
경상남도	사천시	잘못 투입·구분된 투표지	잘못 투입·구분된 투표지	0	0	0	0	0	0	0	0	0	0	0
경상남도	김해시	계	계	382157	290612	91545	1372	289240	150925	137372	144	112	310	377
경상남도	김해시	재외투표	재외투표	1348	907	441	9	898	402	492	1	0	2	1
경상남도	김해시	국내부재자투표	국내부재자투표	10111	9478	633	146	9332	4312	4933	12	21	14	40
경상남도	김해시	진영읍	소계	30388	22614	7774	114	22500	10692	11733	11	6	29	29
경상남도	김해시	진영읍	진영읍제1투	2326	1771	555	12	1759	961	788	0	0	3	7
경상남도	김해시	진영읍	진영읍제2투	4266	3204	1062	26	3178	1497	1674	1	1	5	0
경상남도	김해시	진영읍	진영읍제3투	3858	3072	786	5	3067	1278	1783	1	2	1	2
경상남도	김해시	진영읍	진영읍제4투	3849	3201	648	6	3195	1436	1754	0	0	4	1
경상남도	김해시	진영읍	진영읍제5투	4815	3288	1527	6	3282	1563	1708	4	1	4	2
경상남도	김해시	진영읍	진영읍제6투	4453	3082	1371	26	3056	1514	1525	2	0	8	7
경상남도	김해시	진영읍	진영읍제7투	4043	3033	1010	18	3015	1428	1578	2	2	2	3
경상남도	김해시	진영읍	진영읍제8투	2778	1963	815	15	1948	1015	923	1	0	2	7
경상남도	김해시	장유면	소계	87306	68614	18692	213	68401	33850	34384	22	16	70	59
경상남도	김해시	장유면	장유면제1투	5005	3969	1036	12	3957	1855	2096	0	1	2	3
경상남도	김해시	장유면	장유면제2투	4751	3690	1061	10	3680	1737	1936	1	1	2	3
경상남도	김해시	장유면	장유면제3투	4354	3453	901	13	3440	1648	1782	1	0	4	5
경상남도	김해시	장유면	장유면제4투	4876	3966	910	12	3954	1917	2030	0	1	4	2
경상남도	김해시	장유면	장유면제5투	5014	4105	909	16	4089	2161	1916	3	2	6	1
경상남도	김해시	장유면	장유면제6투	3281	2380	901	8	2372	1134	1233	1	0	1	3
경상남도	김해시	장유면	장유면제7투	3954	3119	835	9	3110	1592	1511	0	1	2	4
경상남도	김해시	장유면	장유면제8투	4303	3539	764	9	3530	1672	1852	0	0	2	4
경상남도	김해시	장유면	장유면제9투	3896	3023	873	8	3015	1582	1425	0	1	4	3
경상남도	김해시	장유면	장유면제10투	3734	2948	786	14	2934	1500	1420	3	2	8	1
경상남도	김해시	장유면	장유면제11투	4290	3458	832	10	3448	1674	1768	1	0	3	2
경상남도	김해시	장유면	장유면제12투	4690	3582	1108	13	3569	1697	1866	1	0	3	2
경상남도	김해시	장유면	장유면제13투	3734	2576	1158	9	2567	1509	1053	1	0	2	2
경상남도	김해시	장유면	장유면제14투	4967	3830	1137	12	3818	2013	1793	1	0	5	6
경상남도	김해시	장유면	장유면제15투	5020	4122	898	7	4115	1897	2207	1	1	6	3
경상남도	김해시	장유면	장유면제16투	3596	2980	616	8	2972	1488	1475	2	0	5	2
경상남도	김해시	장유면	장유면제17투	4790	3601	1189	11	3590	1810	1770	2	1	4	3
경상남도	김해시	장유면	장유면제18투	5195	4220	975	13	4207	2140	2056	1	0	6	4
경상남도	김해시	장유면	장유면제19투	4579	3354	1225	13	3341	1670	1662	2	2	0	5
경상남도	김해시	장유면	장유면제20투	3277	2699	578	6	2693	1154	1533	1	3	1	1
경상남도	김해시	주촌면	소계	3274	2376	898	18	2358	1530	818	2	0	4	4
경상남도	김해시	주촌면	주촌면투표소	3274	2376	898	18	2358	1530	818	2	0	4	4
경상남도	김해시	진례면	소계	6565	4807	1758	38	4769	2999	1745	3	1	6	15
경상남도	김해시	진례면	진례면제1투	3121	2289	832	13	2276	1462	803	2	0	4	5
경상남도	김해시	진례면	진례면제2투	3444	2518	926	25	2493	1537	942	1	1	2	10
경상남도	김해시	한림면	소계	8177	5868	2309	70	5798	3054	2695	9	2	10	28
경상남도	김해시	한림면	한림면제1투	1795	1257	538	11	1246	687	553	1	0	1	4
경상남도	김해시	한림면	한림면제2투	2157	1567	590	22	1545	870	659	4	1	1	10
경상남도	김해시	한림면	한림면제3투	2473	1762	711	17	1745	854	877	1	0	6	7
경상남도	김해시	한림면	한림면제4투	1752	1282	470	20	1262	643	606	3	1	2	7
경상남도	김해시	생림면	소계	3887	2935	952	26	2909	1817	1079	4	1	3	5
경상남도	김해시	생림면	생림면제1투	1972	1452	520	12	1440	896	539	1	0	1	3
경상남도	김해시	생림면	생림면제2투	1915	1483	432	14	1469	921	540	3	1	2	2
경상남도	김해시	상동면	소계	3101	2269	832	33	2236	1400	809	5	6	4	12
경상남도	김해시	상동면	상동면제1투	2405	1754	651	33	1721	1069	629	5	5	3	10
경상남도	김해시	상동면	상동면제2투	696	515	181	0	515	331	180	0	1	1	2
경상남도	김해시	대동면	소계	6893	5254	1639	41	5213	3216	1974	6	4	2	11
경상남도	김해시	대동면	대동면제1투	2135	1626	509	9	1617	973	636	1	1	0	6
경상남도	김해시	대동면	대동면제2투	2603	1964	639	17	1947	1181	760	3	1	1	1
경상남도	김해시	대동면	대동면제3투	2155	1664	491	15	1649	1062	578	2	2	1	4
경상남도	김해시	동상동	소계	8133	5916	2217	27	5889	3570	2300	4	2	5	8
경상남도	김해시	동상동	동상동제1투	4763	3537	1226	12	3525	2043	1471	1	0	5	5
경상남도	김해시	동상동	동상동제2투	3370	2379	991	15	2364	1527	829	3	2	0	3
경상남도	김해시	회현동	소계	7484	5417	2067	27	5390	3318	2054	6	0	5	7
경상남도	김해시	회현동	회현동제1투	3594	2710	884	13	2697	1652	1037	2	0	2	4
경상남도	김해시	회현동	회현동제2투	3890	2707	1183	14	2693	1666	1017	4	0	3	3
경상남도	김해시	부원동	소계	6544	4514	2030	19	4495	2754	1725	3	3	6	4
경상남도	김해시	부원동	부원동제1투	3147	2159	988	11	2148	1262	878	1	1	4	2
경상남도	김해시	부원동	부원동제2투	3397	2355	1042	8	2347	1492	847	2	2	2	2
경상남도	김해시	내외동	소계	62367	46943	15424	210	46733	24108	22509	18	16	46	36
경상남도	김해시	내외동	내외동제1투	3814	2882	932	11	2871	1389	1478	2	1	0	1
경상남도	김해시	내외동	내외동제2투	3397	2358	1039	18	2340	1272	1064	0	2	0	2
경상남도	김해시	내외동	내외동제3투	2961	2130	831	12	2118	1184	931	0	0	2	1
경상남도	김해시	내외동	내외동제4투	4289	3132	1157	10	3122	1628	1488	1	1	3	1
경상남도	김해시	내외동	내외동제5투	5452	4234	1218	19	4215	2199	2003	1	1	8	3
경상남도	김해시	내외동	내외동제6투	4987	4137	850	11	4126	2020	2095	3	0	5	3
경상남도	김해시	내외동	내외동제7투	3881	2462	1419	7	2455	1365	1085	1	0	3	1
경상남도	김해시	내외동	내외동제8투	3765	2899	866	15	2884	1466	1414	0	0	1	3
경상남도	김해시	내외동	내외동제9투	4179	3402	777	9	3393	1655	1728	3	0	5	2
경상남도	김해시	내외동	내외동제10투	3666	2927	739	10	2917	1410	1496	1	2	7	1
경상남도	김해시	내외동	내외동제11투	3597	2530	1067	17	2513	1345	1160	2	3	2	1
경상남도	김해시	내외동	내외동제12투	4100	3353	747	17	3336	1760	1567	0	1	2	6
경상남도	김해시	내외동	내외동제13투	4930	3364	1566	15	3349	1806	1531	3	1	3	5
경상남도	김해시	내외동	내외동제14투	4646	3557	1089	22	3535	1744	1785	1	3	2	0
경상남도	김해시	내외동	내외동제15투	4703	3576	1127	17	3559	1865	1684	0	1	3	6
경상남도	김해시	북부동	소계	54122	42040	12082	130	41910	20970	20830	11	18	41	40
경상남도	김해시	북부동	북부동제1투	3707	2562	1145	11	2551	1495	1051	0	1	2	2
경상남도	김해시	북부동	북부동제2투	4389	3526	863	12	3514	1655	1851	1	3	2	2
경상남도	김해시	북부동	북부동제3투	5016	3701	1315	15	3686	1742	1940	0	0	3	1
경상남도	김해시	북부동	북부동제4투	3167	2311	856	15	2296	1283	997	2	1	4	9
경상남도	김해시	북부동	북부동제5투	4465	3344	1121	11	3333	1758	1568	1	2	3	1
경상남도	김해시	북부동	북부동제6투	1482	1070	412	6	1064	595	465	0	1	3	0
경상남도	김해시	북부동	북부동제7투	4340	3410	930	7	3403	1768	1628	1	1	4	1
경상남도	김해시	북부동	북부동제8투	4738	3684	1054	11	3673	1929	1732	3	1	4	4
경상남도	김해시	북부동	북부동제9투	3835	3055	780	10	3045	1350	1687	1	0	4	3
경상남도	김해시	북부동	북부동제10투	4000	3356	644	7	3349	1535	1807	0	2	3	2
경상남도	김해시	북부동	북부동제11투	4722	3780	942	9	3771	1782	1978	1	2	2	6
경상남도	김해시	북부동	북부동제12투	3781	3012	769	8	3004	1486	1503	1	4	3	7
경상남도	김해시	북부동	북부동제13투	4497	3579	918	4	3575	1658	1911	0	0	4	2
경상남도	김해시	북부동	북부동제14투	1983	1650	333	4	1646	934	712	0	0	0	0
경상남도	김해시	칠산서부동	소계	7711	5731	1980	29	5702	3344	2340	2	4	4	8
경상남도	김해시	칠산서부동	칠산서부동제1투	2550	1907	643	11	1896	1172	718	2	0	2	2
경상남도	김해시	칠산서부동	칠산서부동제2투	5161	3824	1337	18	3806	2172	1622	0	4	2	6
경상남도	김해시	활천동	소계	35416	26003	9413	103	25900	13994	11836	9	3	23	35
경상남도	김해시	활천동	활천동제1투	4961	3491	1470	23	3468	1967	1489	3	1	4	4
경상남도	김해시	활천동	활천동제2투	4681	3452	1229	12	3440	1772	1662	1	0	3	2
경상남도	김해시	활천동	활천동제3투	4545	3351	1194	17	3334	1818	1507	0	0	3	6
경상남도	김해시	활천동	활천동제4투	5914	4323	1591	16	4307	2398	1898	3	1	3	4
경상남도	김해시	활천동	활천동제5투	5396	3987	1409	16	3971	2021	1934	1	0	7	8
경상남도	김해시	활천동	활천동제6투	4683	3751	932	8	3743	1991	1743	1	0	2	6
경상남도	김해시	활천동	활천동제7투	5236	3648	1588	11	3637	2027	1603	0	1	1	5
경상남도	김해시	삼안동	소계	32580	23712	8868	97	23615	12701	10835	13	8	31	27
경상남도	김해시	삼안동	삼안동제1투	4829	3407	1422	20	3387	1813	1565	3	0	5	1
경상남도	김해시	삼안동	삼안동제2투	2836	2149	687	12	2137	1243	889	0	0	2	3
경상남도	김해시	삼안동	삼안동제3투	5008	3884	1124	12	3872	2050	1810	2	0	10	0
경상남도	김해시	삼안동	삼안동제4투	4203	2833	1370	12	2821	1563	1246	1	1	6	4
경상남도	김해시	삼안동	삼안동제5투	4262	3446	816	10	3436	1758	1667	2	3	3	3
경상남도	김해시	삼안동	삼안동제6투	3347	2468	879	9	2459	1263	1182	2	2	2	8
경상남도	김해시	삼안동	삼안동제7투	3962	2912	1050	14	2898	1570	1322	1	1	2	2
경상남도	김해시	삼안동	삼안동제8투	4133	2613	1520	8	2605	1441	1154	2	1	1	6
경상남도	김해시	불암동	소계	6750	5208	1542	22	5186	2893	2276	3	1	5	8
경상남도	김해시	불암동	불암동제1투	5305	4196	1109	15	4181	2252	1918	2	1	4	4
경상남도	김해시	불암동	불암동제2투	1445	1012	433	7	1005	641	358	1	0	1	4
경상남도	김해시	잘못 투입·구분된 투표지	잘못 투입·구분된 투표지	0	6	-6	0	6	1	5	0	0	0	0
경상남도	밀양시	계	계	91440	69417	22023	664	68753	47709	20591	76	42	92	243
경상남도	밀양시	재외투표	재외투표	562	354	208	4	350	194	155	1	0	0	0
경상남도	밀양시	국내부재자투표	국내부재자투표	3209	2930	279	63	2867	1436	1380	9	14	11	17
경상남도	밀양시	삼랑진읍	소계	6395	4676	1719	60	4616	3312	1275	9	2	5	13
경상남도	밀양시	삼랑진읍	삼랑진읍제1투	2790	2123	667	29	2094	1528	552	8	0	3	3
경상남도	밀양시	삼랑진읍	삼랑진읍제2투	2306	1594	712	19	1575	1106	460	1	1	2	5
경상남도	밀양시	삼랑진읍	삼랑진읍제3투	1299	959	340	12	947	678	263	0	1	0	5
경상남도	밀양시	하남읍	소계	7144	5154	1990	68	5086	3667	1386	6	3	5	19
경상남도	밀양시	하남읍	하남읍제1투	1405	1052	353	13	1039	787	246	1	1	0	4
경상남도	밀양시	하남읍	하남읍제2투	1811	1288	523	14	1274	914	352	1	1	0	6
경상남도	밀양시	하남읍	하남읍제3투	1658	1246	412	24	1222	891	318	3	0	3	7
경상남도	밀양시	하남읍	하남읍제4투	2270	1568	702	17	1551	1075	470	1	1	2	2
경상남도	밀양시	부북면	소계	5360	4118	1242	43	4075	2965	1083	4	2	5	16
경상남도	밀양시	부북면	부북면제1투	1716	1297	419	11	1286	927	350	1	1	1	6
경상남도	밀양시	부북면	부북면제2투	1622	1280	342	19	1261	884	368	3	0	4	2
경상남도	밀양시	부북면	부북면제3투	2022	1541	481	13	1528	1154	365	0	1	0	8
경상남도	밀양시	상동면	소계	2715	2081	634	27	2054	1426	601	5	0	4	18
경상남도	밀양시	상동면	상동면제1투	1910	1455	455	18	1437	995	427	2	0	1	12
경상남도	밀양시	상동면	상동면제2투	805	626	179	9	617	431	174	3	0	3	6
경상남도	밀양시	산외면	소계	2519	1956	563	18	1938	1383	541	4	0	5	5
경상남도	밀양시	산외면	산외면제1투	1399	1097	302	9	1088	780	299	2	0	4	3
경상남도	밀양시	산외면	산외면제2투	1120	859	261	9	850	603	242	2	0	1	2
경상남도	밀양시	산내면	소계	3409	2616	793	44	2572	1964	580	6	1	6	15
경상남도	밀양시	산내면	산내면제1투	2173	1656	517	31	1625	1255	350	4	1	4	11
경상남도	밀양시	산내면	산내면제2투	1236	960	276	13	947	709	230	2	0	2	4
경상남도	밀양시	단장면	소계	3761	2829	932	55	2774	2017	729	3	3	2	20
경상남도	밀양시	단장면	단장면제1투	928	698	230	18	680	508	166	0	0	0	6
경상남도	밀양시	단장면	단장면제2투	1512	1158	354	25	1133	791	332	2	1	1	6
경상남도	밀양시	단장면	단장면제3투	1321	973	348	12	961	718	231	1	2	1	8
경상남도	밀양시	상남면	소계	8288	6206	2082	50	6156	4321	1792	4	3	10	26
경상남도	밀양시	상남면	상남면제1투	2531	1929	602	24	1905	1370	521	1	1	3	9
경상남도	밀양시	상남면	상남면제2투	2600	1980	620	12	1968	1285	675	1	0	3	4
경상남도	밀양시	상남면	상남면제3투	3157	2297	860	14	2283	1666	596	2	2	4	13
경상남도	밀양시	초동면	소계	3225	2434	791	39	2395	1786	583	2	2	3	19
경상남도	밀양시	초동면	초동면투표소	3225	2434	791	39	2395	1786	583	2	2	3	19
경상남도	밀양시	무안면	소계	4923	3787	1136	57	3730	2804	894	5	2	5	20
경상남도	밀양시	무안면	무안면제1투	2670	2049	621	38	2011	1538	457	3	1	4	8
경상남도	밀양시	무안면	무안면제2투	2253	1738	515	19	1719	1266	437	2	1	1	12
경상남도	밀양시	청도면	소계	1679	1319	360	23	1296	961	323	2	2	2	6
경상남도	밀양시	청도면	청도면투표소	1679	1319	360	23	1296	961	323	2	2	2	6
경상남도	밀양시	내일동	소계	3305	2363	942	8	2355	1832	514	0	0	2	7
경상남도	밀양시	내일동	내일동제1투	2654	1866	788	7	1859	1430	423	0	0	2	4
경상남도	밀양시	내일동	내일동제2투	651	497	154	1	496	402	91	0	0	0	3
경상남도	밀양시	내이동	소계	8396	6213	2183	19	6194	4262	1916	0	1	4	11
경상남도	밀양시	내이동	내이동제1투	2829	2184	645	9	2175	1490	678	0	0	3	4
경상남도	밀양시	내이동	내이동제2투	2169	1576	593	7	1569	1119	447	0	0	0	3
경상남도	밀양시	내이동	내이동제3투	3398	2453	945	3	2450	1653	791	0	1	1	4
경상남도	밀양시	교동	소계	5380	4068	1312	17	4051	2677	1357	3	3	6	5
경상남도	밀양시	교동	교동제1투	1951	1478	473	11	1467	966	492	0	2	4	3
경상남도	밀양시	교동	교동제2투	3429	2590	839	6	2584	1711	865	3	1	2	2
경상남도	밀양시	삼문동	소계	14268	11223	3045	41	11182	7203	3946	6	3	13	11
경상남도	밀양시	삼문동	삼문동제1투	3120	2526	594	7	2519	1622	891	3	1	0	2
경상남도	밀양시	삼문동	삼문동제2투	2842	2118	724	8	2110	1513	590	1	0	4	2
경상남도	밀양시	삼문동	삼문동제3투	4905	3941	964	13	3928	2416	1498	0	1	8	5
경상남도	밀양시	삼문동	삼문동제4투	3401	2638	763	13	2625	1652	967	2	1	1	2
경상남도	밀양시	가곡동	소계	6902	5090	1812	28	5062	3499	1536	7	1	4	15
경상남도	밀양시	가곡동	가곡동제1투	3752	2723	1029	19	2704	1855	840	3	0	2	4
경상남도	밀양시	가곡동	가곡동제2투	3150	2367	783	9	2358	1644	696	4	1	2	11
경상남도	밀양시	잘못 투입·구분된 투표지	잘못 투입·구분된 투표지	0	0	0	0	0	0	0	0	0	0	0
경상남도	거제시	계	계	176499	130166	46333	810	129356	71757	57003	61	82	165	288
경상남도	거제시	재외투표	재외투표	541	371	170	1	370	156	213	0	1	0	0
경상남도	거제시	국내부재자투표	국내부재자투표	4531	4162	369	66	4096	1778	2294	4	4	9	7
경상남도	거제시	일운면	소계	5705	4105	1600	22	4083	2684	1378	1	4	5	11
경상남도	거제시	일운면	일운면제1투	4359	3103	1256	21	3082	1962	1104	1	4	4	7
경상남도	거제시	일운면	일운면제2투	1346	1002	344	1	1001	722	274	0	0	1	4
경상남도	거제시	동부면	소계	3049	2304	745	53	2251	1637	589	1	1	3	20
경상남도	거제시	동부면	동부면투표소	3049	2304	745	53	2251	1637	589	1	1	3	20
경상남도	거제시	남부면	소계	1645	1240	405	23	1217	923	275	3	0	3	13
경상남도	거제시	남부면	남부면투표소	1645	1240	405	23	1217	923	275	3	0	3	13
경상남도	거제시	거제면	소계	5679	4246	1433	53	4193	2912	1246	3	1	8	23
경상남도	거제시	거제면	거제면제1투	3502	2612	890	25	2587	1734	835	1	1	5	11
경상남도	거제시	거제면	거제면제2투	2177	1634	543	28	1606	1178	411	2	0	3	12
경상남도	거제시	둔덕면	소계	2984	2212	772	31	2181	1623	543	0	1	3	11
경상남도	거제시	둔덕면	둔덕면투표소	2984	2212	772	31	2181	1623	543	0	1	3	11
경상남도	거제시	사등면	소계	7560	5471	2089	44	5427	3854	1524	7	3	8	31
경상남도	거제시	사등면	사등면제1투	4062	2866	1196	16	2850	1953	876	4	2	4	11
경상남도	거제시	사등면	사등면제2투	2496	1831	665	22	1809	1295	498	3	1	3	9
경상남도	거제시	사등면	사등면제3투	1002	774	228	6	768	606	150	0	0	1	11
경상남도	거제시	연초면	소계	7817	5282	2535	32	5250	3227	2003	1	4	5	10
경상남도	거제시	연초면	연초면제1투	4089	2832	1257	14	2818	1749	1058	1	3	3	4
경상남도	거제시	연초면	연초면제2투	2814	1789	1025	12	1777	1056	716	0	0	2	3
경상남도	거제시	연초면	연초면제3투	914	661	253	6	655	422	229	0	1	0	3
경상남도	거제시	하청면	소계	4095	2981	1114	29	2952	2169	753	1	2	4	23
경상남도	거제시	하청면	하청면제1투	2977	2177	800	22	2155	1531	607	1	2	3	11
경상남도	거제시	하청면	하청면제2투	1118	804	314	7	797	638	146	0	0	1	12
경상남도	거제시	장목면	소계	4455	3141	1314	37	3104	2418	657	6	3	2	18
경상남도	거제시	장목면	장목면제1투	3203	2261	942	28	2233	1734	475	5	3	2	14
경상남도	거제시	장목면	장목면제2투	1252	880	372	9	871	684	182	1	0	0	4
경상남도	거제시	장승포동	소계	3397	2268	1129	61	2207	1269	919	3	0	2	14
경상남도	거제시	장승포동	장승포동투표소	3397	2268	1129	61	2207	1269	919	3	0	2	14
경상남도	거제시	마전동	소계	4262	2967	1295	13	2954	1233	1703	1	3	7	7
경상남도	거제시	마전동	마전동투표소	4262	2967	1295	13	2954	1233	1703	1	3	7	7
경상남도	거제시	능포동	소계	9619	7079	2540	41	7038	3401	3607	2	7	11	10
경상남도	거제시	능포동	능포동제1투	3379	2237	1142	17	2220	1123	1087	1	2	3	4
경상남도	거제시	능포동	능포동제2투	3127	2596	531	6	2590	1019	1557	1	5	5	3
경상남도	거제시	능포동	능포동제3투	3113	2246	867	18	2228	1259	963	0	0	3	3
경상남도	거제시	아주동	소계	8872	6569	2303	17	6552	2688	3836	2	15	5	6
경상남도	거제시	아주동	아주동제1투	3660	2597	1063	7	2590	1080	1494	2	8	2	4
경상남도	거제시	아주동	아주동제2투	3256	2365	891	7	2358	984	1367	0	4	1	2
경상남도	거제시	아주동	아주동제3투	1956	1607	349	3	1604	624	975	0	3	2	0
경상남도	거제시	옥포1동	소계	6764	4674	2090	15	4659	2393	2245	3	5	5	8
경상남도	거제시	옥포1동	옥포1동제1투	3835	2628	1207	10	2618	1365	1241	2	3	2	5
경상남도	거제시	옥포1동	옥포1동제2투	2929	2046	883	5	2041	1028	1004	1	2	3	3
경상남도	거제시	옥포2동	소계	21655	15642	6013	75	15567	7761	7752	6	6	24	18
경상남도	거제시	옥포2동	옥포2동제1투	3470	2429	1041	8	2421	1247	1164	2	0	5	3
경상남도	거제시	옥포2동	옥포2동제2투	3767	2733	1034	13	2720	1370	1339	1	0	5	5
경상남도	거제시	옥포2동	옥포2동제3투	3252	2375	877	6	2369	1161	1205	0	1	2	0
경상남도	거제시	옥포2동	옥포2동제4투	3519	2491	1028	16	2475	1329	1136	3	1	4	2
경상남도	거제시	옥포2동	옥포2동제5투	3412	2528	884	11	2517	1199	1310	0	2	4	2
경상남도	거제시	옥포2동	옥포2동제6투	3555	2613	942	14	2599	1162	1429	0	2	4	2
경상남도	거제시	옥포2동	옥포2동제7투	680	473	207	7	466	293	169	0	0	0	4
경상남도	거제시	장평동	소계	20398	14563	5835	58	14505	7723	6742	1	6	17	16
경상남도	거제시	장평동	장평동제1투	2278	1597	681	5	1592	674	912	1	2	2	1
경상남도	거제시	장평동	장평동제2투	3774	2805	969	12	2793	1477	1307	0	2	6	1
경상남도	거제시	장평동	장평동제3투	3314	2182	1132	5	2177	1220	949	0	0	2	6
경상남도	거제시	장평동	장평동제4투	3208	2302	906	14	2288	1291	989	0	1	3	4
경상남도	거제시	장평동	장평동제5투	3819	2686	1133	12	2674	1513	1156	0	1	0	4
경상남도	거제시	장평동	장평동제6투	4005	2991	1014	10	2981	1548	1429	0	0	4	0
경상남도	거제시	고현동	소계	28277	21113	7164	73	21040	11930	9051	11	6	23	19
경상남도	거제시	고현동	고현동제1투	2286	1595	691	5	1590	986	600	1	0	0	3
경상남도	거제시	고현동	고현동제2투	3903	2780	1123	13	2767	1797	963	1	0	5	1
경상남도	거제시	고현동	고현동제3투	2410	1808	602	6	1802	1089	705	0	1	4	3
경상남도	거제시	고현동	고현동제4투	1560	1106	454	5	1101	640	457	0	2	1	1
경상남도	거제시	고현동	고현동제5투	2888	2044	844	13	2031	1191	833	3	0	2	2
경상남도	거제시	고현동	고현동제6투	2345	1586	759	4	1582	1052	525	2	0	2	1
경상남도	거제시	고현동	고현동제7투	3463	2622	841	7	2615	1413	1200	0	1	0	1
경상남도	거제시	고현동	고현동제8투	3174	2583	591	3	2580	1327	1245	1	1	2	4
경상남도	거제시	고현동	고현동제9투	3164	2563	601	13	2550	1266	1278	2	0	2	2
경상남도	거제시	고현동	고현동제10투	3084	2426	658	4	2422	1169	1245	1	1	5	1
경상남도	거제시	상문동	소계	13928	10785	3143	35	10750	5396	5318	4	5	13	14
경상남도	거제시	상문동	상문동제1투	2685	1990	695	9	1981	1158	815	0	0	7	1
경상남도	거제시	상문동	상문동제2투	3569	2974	595	8	2966	1362	1596	1	2	1	4
경상남도	거제시	상문동	상문동제3투	2624	1954	670	7	1947	968	972	1	3	2	1
경상남도	거제시	상문동	상문동제4투	2146	1608	538	4	1604	756	845	1	0	1	1
경상남도	거제시	상문동	상문동제5투	2904	2259	645	7	2252	1152	1090	1	0	2	7
경상남도	거제시	수양동	소계	11266	8991	2275	31	8960	4582	4355	1	5	8	9
경상남도	거제시	수양동	수양동제1투	4837	3959	878	7	3952	1957	1984	1	3	3	4
경상남도	거제시	수양동	수양동제2투	2841	2056	785	15	2041	1153	881	0	2	3	2
경상남도	거제시	수양동	수양동제3투	3588	2976	612	9	2967	1472	1490	0	0	2	3
경상남도	거제시	잘못 투입·구분된 투표지	잘못 투입·구분된 투표지	0	0	0	0	0	0	0	0	0	0	0
경상남도	의령군	계	계	25763	19431	6332	376	19055	13848	4904	50	11	43	199
경상남도	의령군	재외투표	재외투표	415	275	140	1	274	190	82	1	0	0	1
경상남도	의령군	국내부재자투표	국내부재자투표	1093	998	95	23	975	502	466	1	1	2	3
경상남도	의령군	의령읍	소계	7118	5335	1783	51	5284	3545	1697	9	1	9	23
경상남도	의령군	의령읍	의령읍제1투	3165	2393	772	22	2371	1590	763	5	0	2	11
경상남도	의령군	의령읍	의령읍제2투	3953	2942	1011	29	2913	1955	934	4	1	7	12
경상남도	의령군	가례면	소계	1696	1214	482	56	1158	851	281	5	4	5	12
경상남도	의령군	가례면	가례면투표소	1696	1214	482	56	1158	851	281	5	4	5	12
경상남도	의령군	칠곡면	소계	1079	832	247	15	817	595	212	1	1	2	6
경상남도	의령군	칠곡면	칠곡면투표소	1079	832	247	15	817	595	212	1	1	2	6
경상남도	의령군	대의면	소계	1015	780	235	28	752	533	202	1	0	3	13
경상남도	의령군	대의면	대의면투표소	1015	780	235	28	752	533	202	1	0	3	13
경상남도	의령군	화정면	소계	1418	1105	313	19	1086	826	241	2	0	4	13
경상남도	의령군	화정면	화정면투표소	1418	1105	313	19	1086	826	241	2	0	4	13
경상남도	의령군	용덕면	소계	1542	1153	389	20	1133	876	235	6	1	3	12
경상남도	의령군	용덕면	용덕면제1투	771	591	180	9	582	480	92	3	1	1	5
경상남도	의령군	용덕면	용덕면제2투	771	562	209	11	551	396	143	3	0	2	7
경상남도	의령군	정곡면	소계	1452	1053	399	17	1036	781	227	7	0	4	17
경상남도	의령군	정곡면	정곡면투표소	1452	1053	399	17	1036	781	227	7	0	4	17
경상남도	의령군	지정면	소계	1821	1367	454	25	1342	1001	317	3	1	1	19
경상남도	의령군	지정면	지정면투표소	1821	1367	454	25	1342	1001	317	3	1	1	19
경상남도	의령군	낙서면	소계	831	588	243	23	565	463	94	0	0	2	6
경상남도	의령군	낙서면	낙서면투표소	831	588	243	23	565	463	94	0	0	2	6
경상남도	의령군	부림면	소계	2850	2138	712	36	2102	1652	425	5	1	3	16
경상남도	의령군	부림면	부림면투표소	2850	2138	712	36	2102	1652	425	5	1	3	16
경상남도	의령군	봉수면	소계	998	735	263	14	721	582	114	2	0	3	20
경상남도	의령군	봉수면	봉수면투표소	998	735	263	14	721	582	114	2	0	3	20
경상남도	의령군	궁류면	소계	1208	898	310	27	871	697	147	3	0	1	23
경상남도	의령군	궁류면	궁류면투표소	1208	898	310	27	871	697	147	3	0	1	23
경상남도	의령군	유곡면	소계	1227	960	267	21	939	754	164	4	1	1	15
경상남도	의령군	유곡면	유곡면제1투	624	499	125	7	492	399	80	4	1	0	8
경상남도	의령군	유곡면	유곡면제2투	603	461	142	14	447	355	84	0	0	1	7
경상남도	의령군	잘못 투입·구분된 투표지	잘못 투입·구분된 투표지	0	0	0	0	0	0	0	0	0	0	0
경상남도	함안군	계	계	55076	42208	12868	401	41807	28741	12748	56	27	68	167
경상남도	함안군	재외투표	재외투표	543	361	182	1	360	250	104	3	1	1	1
경상남도	함안군	국내부재자투표	국내부재자투표	1640	1518	122	18	1500	773	714	2	1	7	3
경상남도	함안군	가야읍	소계	13924	10592	3332	66	10526	6996	3476	8	4	17	25
경상남도	함안군	가야읍	가야읍제1투	3159	2376	783	13	2363	1564	789	2	0	2	6
경상남도	함안군	가야읍	가야읍제2투	3555	2701	854	21	2680	1758	909	2	2	4	5
경상남도	함안군	가야읍	가야읍제3투	3571	2748	823	12	2736	1796	932	1	1	6	0
경상남도	함안군	가야읍	가야읍제4투	3639	2767	872	20	2747	1878	846	3	1	5	14
경상남도	함안군	함안면	소계	2373	1828	545	25	1803	1330	457	1	3	1	11
경상남도	함안군	함안면	함안면투표소	2373	1828	545	25	1803	1330	457	1	3	1	11
경상남도	함안군	군북면	소계	5726	4209	1517	67	4142	3125	965	5	3	10	34
경상남도	함안군	군북면	군북면제1투	2927	2106	821	32	2074	1555	502	0	3	3	11
경상남도	함안군	군북면	군북면제2투	934	706	228	9	697	528	156	1	0	4	8
경상남도	함안군	군북면	군북면제3투	1097	794	303	11	783	594	181	2	0	0	6
경상남도	함안군	군북면	군북면제4투	768	603	165	15	588	448	126	2	0	3	9
경상남도	함안군	법수면	소계	2813	2062	751	39	2023	1487	514	7	0	6	9
경상남도	함안군	법수면	법수면투표소	2813	2062	751	39	2023	1487	514	7	0	6	9
경상남도	함안군	대산면	소계	3619	2632	987	47	2585	1890	664	9	1	3	18
경상남도	함안군	대산면	대산면투표소	3619	2632	987	47	2585	1890	664	9	1	3	18
경상남도	함안군	칠서면	소계	5062	3849	1213	36	3813	2726	1059	4	2	4	18
경상남도	함안군	칠서면	칠서면제1투	2733	2087	646	13	2074	1354	709	2	1	1	7
경상남도	함안군	칠서면	칠서면제2투	968	719	249	13	706	560	140	1	1	1	3
경상남도	함안군	칠서면	칠서면제3투	1361	1043	318	10	1033	812	210	1	0	2	8
경상남도	함안군	칠북면	소계	1971	1555	416	20	1535	1222	294	2	1	2	14
경상남도	함안군	칠북면	칠북면투표소	1971	1555	416	20	1535	1222	294	2	1	2	14
경상남도	함안군	칠원면	소계	14130	11088	3042	51	11037	7142	3850	10	5	13	17
경상남도	함안군	칠원면	칠원면제1투	4572	3436	1136	18	3418	2393	1004	4	2	5	10
경상남도	함안군	칠원면	칠원면제2투	1230	908	322	10	898	686	209	1	0	1	1
경상남도	함안군	칠원면	칠원면제3투	3592	3063	529	6	3057	1669	1379	2	1	4	2
경상남도	함안군	칠원면	칠원면제4투	2874	2167	707	10	2157	1463	688	2	1	1	2
경상남도	함안군	칠원면	칠원면제5투	1862	1514	348	7	1507	931	570	1	1	2	2
경상남도	함안군	산인면	소계	2511	1897	614	25	1872	1335	514	5	2	4	12
경상남도	함안군	산인면	산인면투표소	2511	1897	614	25	1872	1335	514	5	2	4	12
경상남도	함안군	여항면	소계	764	617	147	6	611	465	137	0	4	0	5
경상남도	함안군	여항면	여항면투표소	764	617	147	6	611	465	137	0	4	0	5
경상남도	함안군	잘못 투입·구분된 투표지	잘못 투입·구분된 투표지	0	0	0	0	0	0	0	0	0	0	0
경상남도	창녕군	계	계	53970	40692	13278	492	40200	29793	10046	50	19	54	238
경상남도	창녕군	재외투표	재외투표	391	272	119	2	270	171	96	1	0	0	2
경상남도	창녕군	국내부재자투표	국내부재자투표	1756	1630	126	34	1596	882	698	3	3	3	7
경상남도	창녕군	창녕읍	소계	13060	9768	3292	74	9694	7053	2589	4	2	12	34
경상남도	창녕군	창녕읍	창녕읍제1투	2740	2083	657	20	2063	1497	561	0	0	2	3
경상남도	창녕군	창녕읍	창녕읍제2투	3524	2540	984	13	2527	1776	739	2	1	1	8
경상남도	창녕군	창녕읍	창녕읍제3투	3333	2595	738	15	2580	1923	642	1	0	5	9
경상남도	창녕군	창녕읍	창녕읍제4투	3463	2550	913	26	2524	1857	647	1	1	4	14
경상남도	창녕군	남지읍	소계	9687	7140	2547	73	7067	5141	1880	4	3	11	28
경상남도	창녕군	남지읍	남지읍제1투	4191	3123	1068	22	3101	2173	909	1	3	7	8
경상남도	창녕군	남지읍	남지읍제2투	4437	3222	1215	32	3190	2339	839	2	0	3	7
경상남도	창녕군	남지읍	남지읍제3투	1059	795	264	19	776	629	132	1	0	1	13
경상남도	창녕군	고암면	소계	1805	1353	452	30	1323	1064	241	2	0	1	15
경상남도	창녕군	고암면	고암면투표소	1805	1353	452	30	1323	1064	241	2	0	1	15
경상남도	창녕군	성산면	소계	1406	1101	305	15	1086	891	177	4	0	2	12
경상남도	창녕군	성산면	성산면투표소	1406	1101	305	15	1086	891	177	4	0	2	12
경상남도	창녕군	대합면	소계	3509	2628	881	32	2596	2063	499	5	3	4	22
경상남도	창녕군	대합면	대합면투표소	3509	2628	881	32	2596	2063	499	5	3	4	22
경상남도	창녕군	이방면	소계	2360	1818	542	30	1788	1482	284	4	0	3	15
경상남도	창녕군	이방면	이방면투표소	2360	1818	542	30	1788	1482	284	4	0	3	15
경상남도	창녕군	유어면	소계	1763	1368	395	28	1340	1009	309	7	2	1	12
경상남도	창녕군	유어면	유어면투표소	1763	1368	395	28	1340	1009	309	7	2	1	12
경상남도	창녕군	대지면	소계	2094	1618	476	17	1601	1236	350	1	2	1	11
경상남도	창녕군	대지면	대지면투표소	2094	1618	476	17	1601	1236	350	1	2	1	11
경상남도	창녕군	계성면	소계	2243	1634	609	23	1611	1197	393	3	2	1	15
경상남도	창녕군	계성면	계성면투표소	2243	1634	609	23	1611	1197	393	3	2	1	15
경상남도	창녕군	영산면	소계	4993	3666	1327	38	3628	2666	935	6	0	2	19
경상남도	창녕군	영산면	영산면제1투	3980	2906	1074	26	2880	2119	740	6	0	2	13
경상남도	창녕군	영산면	영산면제2투	1013	760	253	12	748	547	195	0	0	0	6
경상남도	창녕군	장마면	소계	1726	1339	387	22	1317	1000	303	2	0	3	9
경상남도	창녕군	장마면	장마면투표소	1726	1339	387	22	1317	1000	303	2	0	3	9
경상남도	창녕군	도천면	소계	2446	1812	634	24	1788	1361	411	0	0	4	12
경상남도	창녕군	도천면	도천면투표소	2446	1812	634	24	1788	1361	411	0	0	4	12
경상남도	창녕군	길곡면	소계	1357	1043	314	17	1026	755	257	0	1	2	11
경상남도	창녕군	길곡면	길곡면투표소	1357	1043	314	17	1026	755	257	0	1	2	11
경상남도	창녕군	부곡면	소계	3374	2501	873	33	2468	1821	624	4	1	4	14
경상남도	창녕군	부곡면	부곡면투표소	3374	2501	873	33	2468	1821	624	4	1	4	14
경상남도	창녕군	잘못 투입·구분된 투표지	잘못 투입·구분된 투표지	0	1	-1	0	1	1	0	0	0	0	0
경상남도	양산시	계	계	207478	158887	48591	732	158155	93167	64467	91	61	170	199
경상남도	양산시	재외투표	재외투표	750	477	273	2	475	202	271	0	1	0	1
경상남도	양산시	국내부재자투표	국내부재자투표	5913	5452	461	108	5344	2562	2729	12	8	11	22
경상남도	양산시	물금읍	소계	33848	26482	7366	115	26367	14817	11461	15	16	38	20
경상남도	양산시	물금읍	물금읍제1투	2461	1743	718	10	1733	1238	487	2	0	4	2
경상남도	양산시	물금읍	물금읍제2투	2881	2184	697	11	2173	1365	803	0	1	1	3
경상남도	양산시	물금읍	물금읍제3투	4521	3513	1008	47	3466	2058	1385	6	4	6	7
경상남도	양산시	물금읍	물금읍제4투	3386	2486	900	13	2473	1499	969	1	1	2	1
경상남도	양산시	물금읍	물금읍제5투	4830	4046	784	9	4037	2092	1939	2	1	3	0
경상남도	양산시	물금읍	물금읍제6투	3056	2266	790	8	2258	1276	976	0	2	2	2
경상남도	양산시	물금읍	물금읍제7투	2333	1835	498	5	1830	1017	804	1	1	4	3
경상남도	양산시	물금읍	물금읍제8투	2565	2070	495	2	2068	1139	922	0	1	5	1
경상남도	양산시	물금읍	물금읍제9투	4355	3459	896	3	3456	1691	1755	1	5	4	0
경상남도	양산시	물금읍	물금읍제10투	3460	2880	580	7	2873	1442	1421	2	0	7	1
경상남도	양산시	동면	소계	11302	8736	2566	27	8709	5248	3443	4	1	6	7
경상남도	양산시	동면	동면제1투	3859	2896	963	9	2887	1762	1119	1	1	1	3
경상남도	양산시	동면	동면제2투	3138	2441	697	4	2437	1375	1057	1	0	3	1
경상남도	양산시	동면	동면제3투	3084	2419	665	8	2411	1400	1005	1	0	2	3
경상남도	양산시	동면	동면제4투	1221	980	241	6	974	711	262	1	0	0	0
경상남도	양산시	원동면	소계	3280	2452	828	34	2418	1802	602	3	0	3	8
경상남도	양산시	원동면	원동면제1투	1482	1094	388	18	1076	807	266	1	0	1	1
경상남도	양산시	원동면	원동면제2투	1176	930	246	10	920	677	236	2	0	2	3
경상남도	양산시	원동면	원동면제3투	622	428	194	6	422	318	100	0	0	0	4
경상남도	양산시	상북면	소계	13049	9896	3153	56	9840	6560	3247	6	5	9	13
경상남도	양산시	상북면	상북면제1투	1980	1502	478	5	1497	994	497	1	0	2	3
경상남도	양산시	상북면	상북면제2투	1917	1466	451	10	1456	993	459	1	1	0	2
경상남도	양산시	상북면	상북면제3투	2068	1642	426	10	1632	1106	522	1	1	0	2
경상남도	양산시	상북면	상북면제4투	3116	2342	774	11	2331	1514	810	1	0	4	2
경상남도	양산시	상북면	상북면제5투	2425	1821	604	10	1811	1137	668	1	2	1	2
경상남도	양산시	상북면	상북면제6투	1543	1123	420	10	1113	816	291	1	1	2	2
경상남도	양산시	하북면	소계	8009	5896	2113	33	5863	4068	1766	6	1	2	20
경상남도	양산시	하북면	하북면제1투	3118	2331	787	10	2321	1628	679	2	0	1	11
경상남도	양산시	하북면	하북면제2투	1131	862	269	0	862	588	270	0	0	1	3
경상남도	양산시	하북면	하북면제3투	1477	1092	385	9	1083	769	308	2	1	0	3
경상남도	양산시	하북면	하북면제4투	2283	1611	672	14	1597	1083	509	2	0	0	3
경상남도	양산시	중앙동	소계	10648	7520	3128	33	7487	4977	2489	4	0	6	11
경상남도	양산시	중앙동	중앙동제1투	2755	1935	820	9	1926	1239	682	2	0	1	2
경상남도	양산시	중앙동	중앙동제2투	3214	2222	992	13	2209	1511	690	0	0	3	5
경상남도	양산시	중앙동	중앙동제3투	2246	1619	627	3	1616	1052	562	0	0	1	1
경상남도	양산시	중앙동	중앙동제4투	2433	1744	689	8	1736	1175	555	2	0	1	3
경상남도	양산시	양주동	소계	26353	21598	4755	58	21540	11450	10036	5	5	33	11
경상남도	양산시	양주동	양주동제1투	2047	1426	621	8	1418	828	587	0	0	3	0
경상남도	양산시	양주동	양주동제2투	2770	2292	478	8	2284	1243	1035	1	1	2	2
경상남도	양산시	양주동	양주동제3투	2717	2287	430	4	2283	1230	1046	0	0	4	3
경상남도	양산시	양주동	양주동제4투	2081	1697	384	8	1689	948	738	1	1	0	1
경상남도	양산시	양주동	양주동제5투	2373	1923	450	5	1918	1024	892	1	0	1	0
경상남도	양산시	양주동	양주동제6투	3445	2877	568	3	2874	1463	1406	1	0	4	0
경상남도	양산시	양주동	양주동제7투	3429	2881	548	4	2877	1407	1461	0	1	6	2
경상남도	양산시	양주동	양주동제8투	3021	2534	487	5	2529	1316	1210	0	0	3	0
경상남도	양산시	양주동	양주동제9투	2243	1938	305	5	1933	949	974	1	2	6	1
경상남도	양산시	양주동	양주동제10투	2227	1743	484	8	1735	1042	687	0	0	4	2
경상남도	양산시	삼성동	소계	17973	13312	4661	44	13268	7778	5447	9	4	13	17
경상남도	양산시	삼성동	삼성동제1투	2774	1957	817	10	1947	1147	793	3	1	2	1
경상남도	양산시	삼성동	삼성동제2투	2684	2102	582	2	2100	1302	796	0	0	1	1
경상남도	양산시	삼성동	삼성동제3투	2973	2073	900	8	2065	1227	826	1	1	4	6
경상남도	양산시	삼성동	삼성동제4투	3083	2285	798	8	2277	1343	930	2	0	0	2
경상남도	양산시	삼성동	삼성동제5투	2974	2347	627	3	2344	1278	1060	1	1	0	4
경상남도	양산시	삼성동	삼성동제6투	3485	2548	937	13	2535	1481	1042	2	1	6	3
경상남도	양산시	강서동	소계	7676	5808	1868	21	5787	3292	2482	2	1	5	5
경상남도	양산시	강서동	강서동제1투	4292	3335	957	9	3326	1839	1479	1	0	4	3
경상남도	양산시	강서동	강서동제2투	3384	2473	911	12	2461	1453	1003	1	1	1	2
경상남도	양산시	서창동	소계	20295	14994	5301	58	14936	8761	6127	6	4	11	27
경상남도	양산시	서창동	서창동제1투	2749	2042	707	14	2028	1363	655	3	2	1	4
경상남도	양산시	서창동	서창동제2투	3467	2673	794	9	2664	1524	1131	1	0	5	3
경상남도	양산시	서창동	서창동제3투	5190	3381	1809	10	3371	2072	1285	0	2	2	10
경상남도	양산시	서창동	서창동제4투	5060	4069	991	13	4056	2131	1915	0	0	3	7
경상남도	양산시	서창동	서창동제5투	3829	2829	1000	12	2817	1671	1141	2	0	0	3
경상남도	양산시	소주동	소계	15146	11080	4066	59	11021	6684	4294	7	5	17	14
경상남도	양산시	소주동	소주동제1투	3280	2507	773	10	2497	1528	957	1	2	5	4
경상남도	양산시	소주동	소주동제2투	2889	2106	783	14	2092	1250	837	1	1	0	3
경상남도	양산시	소주동	소주동제3투	2567	1910	657	8	1902	1093	800	1	2	4	2
경상남도	양산시	소주동	소주동제4투	2032	1577	455	7	1570	938	627	1	0	2	2
경상남도	양산시	소주동	소주동제5투	4378	2980	1398	20	2960	1875	1073	3	0	6	3
경상남도	양산시	평산동	소계	24120	18321	5799	60	18261	10789	7432	5	9	12	14
경상남도	양산시	평산동	평산동제1투	2681	2036	645	8	2028	1096	926	0	1	3	2
경상남도	양산시	평산동	평산동제2투	3124	2403	721	16	2387	1362	1012	1	0	5	7
경상남도	양산시	평산동	평산동제3투	3181	2455	726	7	2448	1456	991	0	0	0	1
경상남도	양산시	평산동	평산동제4투	2141	1702	439	2	1700	1049	650	0	0	0	1
경상남도	양산시	평산동	평산동제5투	4263	2983	1280	10	2973	1850	1117	2	2	1	1
경상남도	양산시	평산동	평산동제6투	2535	1916	619	4	1912	1155	752	0	3	2	0
경상남도	양산시	평산동	평산동제7투	2773	2122	651	8	2114	1403	709	0	1	0	1
경상남도	양산시	평산동	평산동제8투	3422	2704	718	5	2699	1418	1275	2	2	1	1
경상남도	양산시	덕계동	소계	9116	6863	2253	24	6839	4177	2641	7	1	4	9
경상남도	양산시	덕계동	덕계동제1투	2772	2105	667	9	2096	1227	862	2	1	1	3
경상남도	양산시	덕계동	덕계동제2투	3079	2291	788	6	2285	1396	881	4	0	1	3
경상남도	양산시	덕계동	덕계동제3투	3265	2467	798	9	2458	1554	898	1	0	2	3
경상남도	양산시	잘못 투입·구분된 투표지	잘못 투입·구분된 투표지	0	0	0	0	0	0	0	0	0	0	0
경상남도	하동군	계	계	43515	34056	9459	591	33465	21848	11193	70	50	56	248
경상남도	하동군	재외투표	재외투표	259	181	78	2	179	99	78	2	0	0	0
경상남도	하동군	국내부재자투표	국내부재자투표	3478	2774	704	93	2681	1476	1186	7	3	5	4
경상남도	하동군	하동읍	소계	8165	6289	1876	59	6230	3931	2259	5	6	9	20
경상남도	하동군	하동읍	하동읍제1투	2352	1821	531	16	1805	1163	629	1	2	2	8
경상남도	하동군	하동읍	하동읍제2투	2329	1799	530	12	1787	1043	735	1	1	4	3
경상남도	하동군	하동읍	하동읍제3투	1089	840	249	10	830	580	244	0	1	0	5
경상남도	하동군	하동읍	하동읍제4투	2395	1829	566	21	1808	1145	651	3	2	3	4
경상남도	하동군	화개면	소계	2761	2117	644	31	2086	1284	779	3	2	3	15
경상남도	하동군	화개면	화개면제1투	1857	1412	445	24	1388	853	521	1	1	1	11
경상남도	하동군	화개면	화개면제2투	904	705	199	7	698	431	258	2	1	2	4
경상남도	하동군	악양면	소계	3149	2415	734	35	2380	1565	781	4	5	3	22
경상남도	하동군	악양면	악양면투표소	3149	2415	734	35	2380	1565	781	4	5	3	22
경상남도	하동군	적량면	소계	1821	1433	388	25	1408	919	460	6	2	5	16
경상남도	하동군	적량면	적량면투표소	1821	1433	388	25	1408	919	460	6	2	5	16
경상남도	하동군	횡천면	소계	1699	1397	302	27	1370	949	404	1	0	6	10
경상남도	하동군	횡천면	횡천면투표소	1699	1397	302	27	1370	949	404	1	0	6	10
경상남도	하동군	고전면	소계	2073	1689	384	38	1651	1100	522	4	2	2	21
경상남도	하동군	고전면	고전면제1투	1240	1001	239	24	977	654	307	3	1	1	11
경상남도	하동군	고전면	고전면제2투	833	688	145	14	674	446	215	1	1	1	10
경상남도	하동군	금남면	소계	3414	2599	815	41	2558	1743	772	4	1	3	35
경상남도	하동군	금남면	금남면제1투	2177	1667	510	26	1641	1105	505	4	0	2	25
경상남도	하동군	금남면	금남면제2투	1237	932	305	15	917	638	267	0	1	1	10
경상남도	하동군	금성면	소계	2848	2174	674	32	2142	1435	678	2	2	4	21
경상남도	하동군	금성면	금성면제1투	1764	1367	397	22	1345	868	455	2	1	1	18
경상남도	하동군	금성면	금성면제2투	1084	807	277	10	797	567	223	0	1	3	3
경상남도	하동군	진교면	소계	5446	4237	1209	60	4177	2759	1390	5	4	3	16
경상남도	하동군	진교면	진교면제1투	3167	2449	718	25	2424	1617	790	4	2	2	9
경상남도	하동군	진교면	진교면제2투	2279	1788	491	35	1753	1142	600	1	2	1	7
경상남도	하동군	양보면	소계	1692	1374	318	33	1341	958	354	13	3	1	12
경상남도	하동군	양보면	양보면투표소	1692	1374	318	33	1341	958	354	13	3	1	12
경상남도	하동군	북천면	소계	1628	1278	350	28	1250	925	290	2	6	5	22
경상남도	하동군	북천면	북천면투표소	1628	1278	350	28	1250	925	290	2	6	5	22
경상남도	하동군	청암면	소계	1288	1025	263	23	1002	654	325	6	1	4	12
경상남도	하동군	청암면	청암면제1투	780	649	131	16	633	469	149	4	1	2	8
경상남도	하동군	청암면	청암면제2투	508	376	132	7	369	185	176	2	0	2	4
경상남도	하동군	옥종면	소계	3794	3074	720	64	3010	2051	915	6	13	3	22
경상남도	하동군	옥종면	옥종면투표소	3794	3074	720	64	3010	2051	915	6	13	3	22
경상남도	하동군	잘못 투입·구분된 투표지	잘못 투입·구분된 투표지	0	0	0	0	0	0	0	0	0	0	0
경상남도	남해군	계	계	42153	32090	10063	454	31636	21551	9756	75	17	51	186
경상남도	남해군	재외투표	재외투표	312	222	90	0	222	128	93	0	0	0	1
경상남도	남해군	국내부재자투표	국내부재자투표	1750	1585	165	26	1559	750	802	3	1	1	2
경상남도	남해군	남해읍	소계	10411	7841	2570	58	7783	4916	2822	12	1	12	20
경상남도	남해군	남해읍	남해읍제1투	2424	1807	617	9	1798	1101	689	2	0	1	5
경상남도	남해군	남해읍	남해읍제2투	1563	1176	387	8	1168	829	330	1	0	5	3
경상남도	남해군	남해읍	남해읍제3투	3329	2554	775	14	2540	1531	995	3	0	3	8
경상남도	남해군	남해읍	남해읍제4투	3095	2304	791	27	2277	1455	808	6	1	3	4
경상남도	남해군	이동면	소계	3900	2979	921	25	2954	2201	724	7	1	4	17
경상남도	남해군	이동면	이동면제1투	1664	1289	375	9	1280	948	322	2	0	0	8
경상남도	남해군	이동면	이동면제2투	1112	867	245	10	857	621	228	3	1	0	4
경상남도	남해군	이동면	이동면제3투	1124	823	301	6	817	632	174	2	0	4	5
경상남도	남해군	상주면	소계	1592	1198	394	28	1170	836	316	4	0	2	12
경상남도	남해군	상주면	상주면투표소	1592	1198	394	28	1170	836	316	4	0	2	12
경상남도	남해군	삼동면	소계	3688	2789	899	32	2757	1869	849	11	0	6	22
경상남도	남해군	삼동면	삼동면제1투	1827	1418	409	18	1400	971	410	4	0	3	12
경상남도	남해군	삼동면	삼동면제2투	1861	1371	490	14	1357	898	439	7	0	3	10
경상남도	남해군	미조면	소계	2262	1660	602	21	1639	1176	446	1	0	5	11
경상남도	남해군	미조면	미조면투표소	2262	1660	602	21	1639	1176	446	1	0	5	11
경상남도	남해군	남면	소계	3593	2653	940	54	2599	1898	674	5	3	1	18
경상남도	남해군	남면	남면제1투	1991	1489	502	20	1469	1047	404	2	2	1	13
경상남도	남해군	남면	남면제2투	1602	1164	438	34	1130	851	270	3	1	0	5
경상남도	남해군	서면	소계	2787	2135	652	49	2086	1522	535	6	3	3	17
경상남도	남해군	서면	서면제1투	1917	1471	446	31	1440	1045	376	5	2	1	11
경상남도	남해군	서면	서면제2투	870	664	206	18	646	477	159	1	1	2	6
경상남도	남해군	고현면	소계	3733	2892	841	48	2844	1824	988	7	3	6	16
경상남도	남해군	고현면	고현면제1투	2192	1699	493	28	1671	1148	497	5	3	5	13
경상남도	남해군	고현면	고현면제2투	1541	1193	348	20	1173	676	491	2	0	1	3
경상남도	남해군	설천면	소계	2895	2226	669	47	2179	1428	724	10	1	3	13
경상남도	남해군	설천면	설천면제1투	2041	1543	498	32	1511	977	516	7	0	2	9
경상남도	남해군	설천면	설천면제2투	854	683	171	15	668	451	208	3	1	1	4
경상남도	남해군	창선면	소계	5230	3910	1320	66	3844	3003	783	9	4	8	37
경상남도	남해군	창선면	창선면제1투	2632	1977	655	22	1955	1480	444	3	2	7	19
경상남도	남해군	창선면	창선면제2투	1445	1060	385	19	1041	842	186	1	2	0	10
경상남도	남해군	창선면	창선면제3투	1153	873	280	25	848	681	153	5	0	1	8
경상남도	남해군	잘못 투입·구분된 투표지	잘못 투입·구분된 투표지	0	0	0	0	0	0	0	0	0	0	0
경상남도	함양군	계	계	34326	26500	7826	375	26125	18736	7014	40	26	59	250
경상남도	함양군	재외투표	재외투표	233	144	89	0	144	99	45	0	0	0	0
경상남도	함양군	국내부재자투표	국내부재자투표	1539	1430	109	65	1365	745	589	7	7	5	12
경상남도	함양군	함양읍	소계	13936	10644	3292	78	10566	7314	3162	9	5	22	54
경상남도	함양군	함양읍	함양읍제1투	1874	1350	524	18	1332	970	352	0	1	2	7
경상남도	함양군	함양읍	함양읍제2투	2463	1906	557	13	1893	1379	504	2	0	3	5
경상남도	함양군	함양읍	함양읍제3투	3222	2486	736	13	2473	1573	879	2	2	4	13
경상남도	함양군	함양읍	함양읍제4투	1036	782	254	13	769	576	176	1	2	1	13
경상남도	함양군	함양읍	함양읍제5투	2781	2273	508	7	2266	1438	817	0	0	8	3
경상남도	함양군	함양읍	함양읍제6투	1760	1240	520	10	1230	909	310	3	0	2	6
경상남도	함양군	함양읍	함양읍제7투	800	607	193	4	603	469	124	1	0	2	7
경상남도	함양군	마천면	소계	1984	1452	532	26	1426	971	423	2	0	6	24
경상남도	함양군	마천면	마천면투표소	1984	1452	532	26	1426	971	423	2	0	6	24
경상남도	함양군	휴천면	소계	1400	1061	339	15	1046	764	256	5	3	2	16
경상남도	함양군	휴천면	휴천면투표소	1400	1061	339	15	1046	764	256	5	3	2	16
경상남도	함양군	유림면	소계	1593	1227	366	14	1213	965	227	2	1	0	18
경상남도	함양군	유림면	유림면투표소	1593	1227	366	14	1213	965	227	2	1	0	18
경상남도	함양군	수동면	소계	2207	1715	492	19	1696	1325	354	3	1	6	7
경상남도	함양군	수동면	수동면투표소	2207	1715	492	19	1696	1325	354	3	1	6	7
경상남도	함양군	지곡면	소계	1853	1418	435	25	1393	1053	313	2	2	7	16
경상남도	함양군	지곡면	지곡면투표소	1853	1418	435	25	1393	1053	313	2	2	7	16
경상남도	함양군	안의면	소계	4197	3189	1008	52	3137	2439	653	6	2	3	34
경상남도	함양군	안의면	안의면제1투	2178	1672	506	19	1653	1280	357	1	0	1	14
경상남도	함양군	안의면	안의면제2투	2019	1517	502	33	1484	1159	296	5	2	2	20
경상남도	함양군	서하면	소계	1235	990	245	18	972	725	232	1	1	2	11
경상남도	함양군	서하면	서하면투표소	1235	990	245	18	972	725	232	1	1	2	11
경상남도	함양군	서상면	소계	1623	1250	373	23	1227	923	280	0	2	0	22
경상남도	함양군	서상면	서상면투표소	1623	1250	373	23	1227	923	280	0	2	0	22
경상남도	함양군	백전면	소계	1329	1027	302	20	1007	734	246	2	0	3	22
경상남도	함양군	백전면	백전면투표소	1329	1027	302	20	1007	734	246	2	0	3	22
경상남도	함양군	병곡면	소계	1197	953	244	20	933	679	234	1	2	3	14
경상남도	함양군	병곡면	병곡면투표소	1197	953	244	20	933	679	234	1	2	3	14
경상남도	함양군	잘못 투입·구분된 투표지	잘못 투입·구분된 투표지	0	0	0	0	0	0	0	0	0	0	0
경상남도	산청군	계	계	30993	23738	7255	402	23336	16979	5996	91	30	51	189
경상남도	산청군	재외투표	재외투표	251	154	97	5	149	102	46	0	0	0	1
경상남도	산청군	국내부재자투표	국내부재자투표	1010	929	81	18	911	503	402	1	0	3	2
경상남도	산청군	산청읍	소계	5263	4014	1249	51	3963	2851	1066	10	0	7	29
경상남도	산청군	산청읍	산청읍제1투	4175	3164	1011	31	3133	2262	835	7	0	6	23
경상남도	산청군	산청읍	산청읍제2투	1088	850	238	20	830	589	231	3	0	1	6
경상남도	산청군	차황면	소계	1361	1045	316	20	1025	808	203	3	1	4	6
경상남도	산청군	차황면	차황면투표소	1361	1045	316	20	1025	808	203	3	1	4	6
경상남도	산청군	오부면	소계	1000	794	206	27	767	559	167	9	13	4	15
경상남도	산청군	오부면	오부면투표소	1000	794	206	27	767	559	167	9	13	4	15
경상남도	산청군	생초면	소계	2077	1602	475	31	1571	1240	303	5	5	3	15
경상남도	산청군	생초면	생초면투표소	2077	1602	475	31	1571	1240	303	5	5	3	15
경상남도	산청군	금서면	소계	2389	1832	557	43	1789	1289	449	27	3	3	18
경상남도	산청군	금서면	금서면제1투	1593	1200	393	31	1169	853	278	24	1	1	12
경상남도	산청군	금서면	금서면제2투	796	632	164	12	620	436	171	3	2	2	6
경상남도	산청군	삼장면	소계	1595	1238	357	16	1222	964	245	2	1	2	8
경상남도	산청군	삼장면	삼장면투표소	1595	1238	357	16	1222	964	245	2	1	2	8
경상남도	산청군	시천면	소계	3494	2684	810	29	2655	1927	704	2	0	6	16
경상남도	산청군	시천면	시천면제1투	1919	1485	434	18	1467	1071	383	1	0	4	8
경상남도	산청군	시천면	시천면제2투	1575	1199	376	11	1188	856	321	1	0	2	8
경상남도	산청군	단성면	소계	4892	3553	1339	58	3495	2603	832	15	3	6	36
경상남도	산청군	단성면	단성면제1투	3957	2863	1094	49	2814	2091	675	14	3	3	28
경상남도	산청군	단성면	단성면제2투	935	690	245	9	681	512	157	1	0	3	8
경상남도	산청군	신안면	소계	4603	3515	1088	44	3471	2355	1085	8	2	6	15
경상남도	산청군	신안면	신안면제1투	3281	2525	756	23	2502	1644	839	4	2	5	8
경상남도	산청군	신안면	신안면제2투	1322	990	332	21	969	711	246	4	0	1	7
경상남도	산청군	생비량면	소계	1145	894	251	24	870	688	165	4	0	2	11
경상남도	산청군	생비량면	생비량면투표소	1145	894	251	24	870	688	165	4	0	2	11
경상남도	산청군	신등면	소계	1913	1484	429	36	1448	1090	329	5	2	5	17
경상남도	산청군	신등면	신등면투표소	1913	1484	429	36	1448	1090	329	5	2	5	17
경상남도	산청군	잘못 투입·구분된 투표지	잘못 투입·구분된 투표지	0	0	0	0	0	0	0	0	0	0	0
경상남도	거창군	계	계	51773	40103	11670	509	39594	28726	10466	61	22	75	244
경상남도	거창군	재외투표	재외투표	420	290	130	1	289	175	114	0	0	0	0
경상남도	거창군	국내부재자투표	국내부재자투표	1962	1764	198	29	1735	890	839	0	2	2	2
경상남도	거창군	거창읍	소계	29175	22204	6971	152	22052	15449	6484	17	11	34	57
경상남도	거창군	거창읍	거창읍제1투	3170	2466	704	17	2449	1582	849	4	3	3	8
경상남도	거창군	거창읍	거창읍제2투	3266	2450	816	17	2433	1774	651	1	1	3	3
경상남도	거창군	거창읍	거창읍제3투	3585	2766	819	11	2755	1903	836	1	0	6	9
경상남도	거창군	거창읍	거창읍제4투	4171	3173	998	18	3155	2130	1009	1	2	7	6
경상남도	거창군	거창읍	거창읍제5투	2665	1971	694	10	1961	1483	469	2	0	2	5
경상남도	거창군	거창읍	거창읍제6투	2944	2187	757	20	2167	1538	621	1	1	1	5
경상남도	거창군	거창읍	거창읍제7투	1648	1200	448	11	1189	868	304	3	2	0	12
경상남도	거창군	거창읍	거창읍제8투	1661	1305	356	27	1278	1002	264	1	1	4	6
경상남도	거창군	거창읍	거창읍제9투	2426	2046	380	8	2038	1289	739	3	1	5	1
경상남도	거창군	거창읍	거창읍제10투	3639	2640	999	13	2627	1880	742	0	0	3	2
경상남도	거창군	주상면	소계	1525	1205	320	12	1193	945	233	3	0	2	10
경상남도	거창군	주상면	주상면투표소	1525	1205	320	12	1193	945	233	3	0	2	10
경상남도	거창군	웅양면	소계	1826	1426	400	25	1401	1042	331	4	0	5	19
경상남도	거창군	웅양면	웅양면투표소	1826	1426	400	25	1401	1042	331	4	0	5	19
경상남도	거창군	고제면	소계	1297	988	309	21	967	714	229	9	1	3	11
경상남도	거창군	고제면	고제면투표소	1297	988	309	21	967	714	229	9	1	3	11
경상남도	거창군	북상면	소계	1412	1106	306	26	1080	819	239	2	0	2	18
경상남도	거창군	북상면	북상면투표소	1412	1106	306	26	1080	819	239	2	0	2	18
경상남도	거창군	위천면	소계	1969	1552	417	25	1527	1162	341	3	1	7	13
경상남도	거창군	위천면	위천면투표소	1969	1552	417	25	1527	1162	341	3	1	7	13
경상남도	거창군	마리면	소계	1961	1523	438	29	1494	1174	298	6	1	1	14
경상남도	거창군	마리면	마리면투표소	1961	1523	438	29	1494	1174	298	6	1	1	14
경상남도	거창군	남상면	소계	2354	1869	485	55	1814	1441	335	2	1	7	28
경상남도	거창군	남상면	남상면투표소	2354	1869	485	55	1814	1441	335	2	1	7	28
경상남도	거창군	남하면	소계	1518	1187	331	21	1166	927	222	4	1	1	11
경상남도	거창군	남하면	남하면투표소	1518	1187	331	21	1166	927	222	4	1	1	11
경상남도	거창군	신원면	소계	1537	1185	352	21	1164	924	208	4	0	3	25
경상남도	거창군	신원면	신원면투표소	1537	1185	352	21	1164	924	208	4	0	3	25
경상남도	거창군	가조면	소계	3541	2797	744	63	2734	2274	430	4	1	7	18
경상남도	거창군	가조면	가조면투표소	3541	2797	744	63	2734	2274	430	4	1	7	18
경상남도	거창군	가북면	소계	1276	1004	272	29	975	787	163	3	3	1	18
경상남도	거창군	가북면	가북면투표소	1276	1004	272	29	975	787	163	3	3	1	18
경상남도	거창군	잘못 투입·구분된 투표지	잘못 투입·구분된 투표지	0	3	-3	0	3	3	0	0	0	0	0
경상남도	합천군	계	계	43981	33586	10395	623	32963	25313	7114	70	20	64	382
경상남도	합천군	재외투표	재외투표	501	331	170	3	328	210	113	2	1	0	2
경상남도	합천군	국내부재자투표	국내부재자투표	1956	1799	157	58	1741	1057	665	5	3	6	5
경상남도	합천군	합천읍	소계	8752	6714	2038	38	6676	4943	1690	7	1	9	26
경상남도	합천군	합천읍	합천읍제1투	2598	2008	590	7	2001	1432	565	1	1	1	1
경상남도	합천군	합천읍	합천읍제2투	3561	2754	807	11	2743	2090	630	3	0	3	17
경상남도	합천군	합천읍	합천읍제3투	2593	1952	641	20	1932	1421	495	3	0	5	8
경상남도	합천군	봉산면	소계	1461	1040	421	27	1013	837	146	4	0	2	24
경상남도	합천군	봉산면	봉산면투표소	1461	1040	421	27	1013	837	146	4	0	2	24
경상남도	합천군	묘산면	소계	1666	1271	395	25	1246	1023	197	4	1	4	17
경상남도	합천군	묘산면	묘산면투표소	1666	1271	395	25	1246	1023	197	4	1	4	17
경상남도	합천군	가야면	소계	4327	3188	1139	34	3154	2389	734	3	1	1	26
경상남도	합천군	가야면	가야면제1투	1949	1468	481	12	1456	1115	332	0	0	0	9
경상남도	합천군	가야면	가야면제2투	1515	1161	354	15	1146	890	236	2	1	1	16
경상남도	합천군	가야면	가야면제3투	863	559	304	7	552	384	166	1	0	0	1
경상남도	합천군	야로면	소계	2439	1863	576	31	1832	1457	346	2	1	6	20
경상남도	합천군	야로면	야로면투표소	2439	1863	576	31	1832	1457	346	2	1	6	20
경상남도	합천군	율곡면	소계	2435	1843	592	32	1811	1461	318	2	2	0	28
경상남도	합천군	율곡면	율곡면제1투	1903	1432	471	27	1405	1122	257	1	1	0	24
경상남도	합천군	율곡면	율곡면제2투	532	411	121	5	406	339	61	1	1	0	4
경상남도	합천군	초계면	소계	2474	1847	627	29	1818	1452	346	3	0	2	15
경상남도	합천군	초계면	초계면투표소	2474	1847	627	29	1818	1452	346	3	0	2	15
경상남도	합천군	쌍책면	소계	1317	1052	265	29	1023	857	145	0	1	5	15
경상남도	합천군	쌍책면	쌍책면제1투	838	667	171	14	653	551	89	0	1	3	9
경상남도	합천군	쌍책면	쌍책면제2투	479	385	94	15	370	306	56	0	0	2	6
경상남도	합천군	덕곡면	소계	847	686	161	13	673	561	100	2	0	1	9
경상남도	합천군	덕곡면	덕곡면투표소	847	686	161	13	673	561	100	2	0	1	9
경상남도	합천군	청덕면	소계	1709	1261	448	43	1218	992	199	4	0	1	22
경상남도	합천군	청덕면	청덕면제1투	1156	852	304	32	820	650	148	3	0	1	18
경상남도	합천군	청덕면	청덕면제2투	553	409	144	11	398	342	51	1	0	0	4
경상남도	합천군	적중면	소계	1484	1141	343	23	1118	885	205	1	1	2	24
경상남도	합천군	적중면	적중면투표소	1484	1141	343	23	1118	885	205	1	1	2	24
경상남도	합천군	대양면	소계	1551	1150	401	37	1113	878	205	4	2	2	22
경상남도	합천군	대양면	대양면투표소	1551	1150	401	37	1113	878	205	4	2	2	22
경상남도	합천군	쌍백면	소계	1803	1372	431	44	1328	1061	226	6	1	3	31
경상남도	합천군	쌍백면	쌍백면투표소	1803	1372	431	44	1328	1061	226	6	1	3	31
경상남도	합천군	삼가면	소계	3346	2523	823	44	2479	1863	570	8	2	7	29
경상남도	합천군	삼가면	삼가면제1투	1830	1355	475	18	1337	1008	311	2	2	3	11
경상남도	합천군	삼가면	삼가면제2투	1516	1168	348	26	1142	855	259	6	0	4	18
경상남도	합천군	가회면	소계	1758	1339	419	37	1302	953	319	7	2	4	17
경상남도	합천군	가회면	가회면투표소	1758	1339	419	37	1302	953	319	7	2	4	17
경상남도	합천군	대병면	소계	1945	1454	491	31	1423	1103	278	4	1	5	32
경상남도	합천군	대병면	대병면투표소	1945	1454	491	31	1423	1103	278	4	1	5	32
경상남도	합천군	용주면	소계	2210	1712	498	45	1667	1331	312	2	0	4	18
경상남도	합천군	용주면	용주면투표소	2210	1712	498	45	1667	1331	312	2	0	4	18
경상남도	합천군	잘못 투입·구분된 투표지	잘못 투입·구분된 투표지	0	0	0	0	0	0	0	0	0	0	0
제주특별자치도	제주시	계	계	328450	241552	86898	1066	240486	119563	119622	94	164	473	570
제주특별자치도	제주시	재외투표	재외투표	3768	2675	1093	27	2648	1513	1114	7	3	5	6
제주특별자치도	제주시	국내부재자투표	국내부재자투표	10771	10050	721	168	9882	4197	5578	13	21	30	43
제주특별자치도	제주시	한림읍	소계	15252	10821	4431	51	10770	5924	4759	6	7	20	54
제주특별자치도	제주시	한림읍	한림읍제1투	1582	1165	417	10	1155	658	488	1	1	2	5
제주특별자치도	제주시	한림읍	한림읍제2투	1405	1021	384	5	1016	595	415	0	1	0	5
제주특별자치도	제주시	한림읍	한림읍제3투	2229	1469	760	3	1466	827	632	1	0	3	3
제주특별자치도	제주시	한림읍	한림읍제4투	865	652	213	2	650	260	381	0	0	3	6
제주특별자치도	제주시	한림읍	한림읍제5투	908	668	240	2	666	393	265	1	1	2	4
제주특별자치도	제주시	한림읍	한림읍제6투	1153	834	319	3	831	482	342	1	0	0	6
제주특별자치도	제주시	한림읍	한림읍제7투	1291	947	344	6	941	490	444	1	0	2	4
제주특별자치도	제주시	한림읍	한림읍제8투	1209	846	363	4	842	509	329	0	1	1	2
제주특별자치도	제주시	한림읍	한림읍제9투	1482	1032	450	4	1028	543	472	0	2	5	6
제주특별자치도	제주시	한림읍	한림읍제10투	1807	1191	616	2	1189	649	532	0	0	2	6
제주특별자치도	제주시	한림읍	한림읍제11투	135	98	37	0	98	80	17	0	0	0	1
제주특별자치도	제주시	한림읍	한림읍제12투	541	400	141	4	396	218	176	0	1	0	1
제주특별자치도	제주시	한림읍	한림읍제13투	645	498	147	6	492	220	266	1	0	0	5
제주특별자치도	제주시	애월읍	소계	22134	16307	5827	97	16210	8001	8087	9	7	39	67
제주특별자치도	제주시	애월읍	애월읍제1투	2412	1596	816	10	1586	938	638	0	0	3	7
제주특별자치도	제주시	애월읍	애월읍제2투	1221	912	309	5	907	431	467	1	3	0	5
제주특별자치도	제주시	애월읍	애월읍제3투	2331	1697	634	16	1681	921	749	0	0	3	8
제주특별자치도	제주시	애월읍	애월읍제4투	3054	2280	774	16	2264	1114	1138	1	0	8	3
제주특별자치도	제주시	애월읍	애월읍제5투	820	653	167	2	651	332	313	1	0	2	3
제주특별자치도	제주시	애월읍	애월읍제6투	2866	2093	773	7	2086	998	1082	0	1	2	3
제주특별자치도	제주시	애월읍	애월읍제7투	1010	758	252	9	749	361	381	0	0	3	4
제주특별자치도	제주시	애월읍	애월읍제8투	1310	987	323	6	981	432	534	1	0	4	10
제주특별자치도	제주시	애월읍	애월읍제9투	907	680	227	3	677	345	324	0	0	1	7
제주특별자치도	제주시	애월읍	애월읍제10투	878	704	174	6	698	352	339	1	1	0	5
제주특별자치도	제주시	애월읍	애월읍제11투	3193	2455	738	3	2452	1101	1341	1	2	5	2
제주특별자치도	제주시	애월읍	애월읍제12투	814	596	218	11	585	262	311	2	0	6	4
제주특별자치도	제주시	애월읍	애월읍제13투	1318	896	422	3	893	414	470	1	0	2	6
제주특별자치도	제주시	구좌읍	소계	11623	8302	3321	77	8225	4929	3211	6	10	17	52
제주특별자치도	제주시	구좌읍	구좌읍제1투	2303	1715	588	17	1698	1004	687	1	0	3	3
제주특별자치도	제주시	구좌읍	구좌읍제2투	1342	967	375	12	955	647	295	0	1	2	10
제주특별자치도	제주시	구좌읍	구좌읍제3투	1155	848	307	9	839	476	353	0	2	2	6
제주특별자치도	제주시	구좌읍	구좌읍제4투	987	717	270	10	707	349	347	2	2	1	6
제주특별자치도	제주시	구좌읍	구좌읍제5투	1883	1211	672	9	1202	731	457	2	2	3	7
제주특별자치도	제주시	구좌읍	구좌읍제6투	1490	1037	453	9	1028	633	384	0	2	2	7
제주특별자치도	제주시	구좌읍	구좌읍제7투	959	724	235	3	721	395	318	1	1	2	4
제주특별자치도	제주시	구좌읍	구좌읍제8투	469	344	125	4	340	227	110	0	0	0	3
제주특별자치도	제주시	구좌읍	구좌읍제9투	1035	739	296	4	735	467	260	0	0	2	6
제주특별자치도	제주시	조천읍	소계	15716	11385	4331	64	11321	6251	4984	4	10	25	47
제주특별자치도	제주시	조천읍	조천읍제1투	2908	2176	732	13	2163	1216	934	0	3	1	9
제주특별자치도	제주시	조천읍	조천읍제2투	2117	1442	675	7	1435	857	562	0	3	2	11
제주특별자치도	제주시	조천읍	조천읍제3투	1804	1322	482	9	1313	724	577	1	1	5	5
제주특별자치도	제주시	조천읍	조천읍제4투	916	688	228	2	686	353	329	0	1	2	1
제주특별자치도	제주시	조천읍	조천읍제5투	1133	813	320	4	809	412	394	0	0	1	2
제주특별자치도	제주시	조천읍	조천읍제6투	1812	1316	496	6	1310	717	580	1	1	6	5
제주특별자치도	제주시	조천읍	조천읍제7투	2227	1570	657	11	1559	860	689	1	1	4	4
제주특별자치도	제주시	조천읍	조천읍제8투	2799	2058	741	12	2046	1112	919	1	0	4	10
제주특별자치도	제주시	한경면	소계	6669	4841	1828	36	4805	2483	2259	4	7	20	32
제주특별자치도	제주시	한경면	한경면제1투	552	411	141	3	408	234	169	1	0	1	3
제주특별자치도	제주시	한경면	한경면제2투	857	633	224	2	631	302	318	0	0	5	6
제주특별자치도	제주시	한경면	한경면제3투	2152	1577	575	13	1564	793	754	1	6	3	7
제주특별자치도	제주시	한경면	한경면제4투	1524	1071	453	11	1060	636	411	0	0	1	12
제주특별자치도	제주시	한경면	한경면제5투	1584	1149	435	7	1142	518	607	2	1	10	4
제주특별자치도	제주시	추자면	소계	1939	1013	926	8	1005	565	420	0	1	7	12
제주특별자치도	제주시	추자면	추자면제1투	1252	627	625	3	624	347	268	0	0	2	7
제주특별자치도	제주시	추자면	추자면제2투	687	386	301	5	381	218	152	0	1	5	5
제주특별자치도	제주시	우도면	소계	1332	933	399	6	927	588	332	0	1	0	6
제주특별자치도	제주시	우도면	우도면투표소	1332	933	399	6	927	588	332	0	1	0	6
제주특별자치도	제주시	일도1동	소계	3113	2026	1087	9	2017	1125	884	0	1	2	5
제주특별자치도	제주시	일도1동	일도1동투표소	3113	2026	1087	9	2017	1125	884	0	1	2	5
제주특별자치도	제주시	일도2동	소계	26754	20319	6435	51	20268	10105	10093	5	7	32	26
제주특별자치도	제주시	일도2동	일도2동제1투	2556	1854	702	6	1848	943	894	1	2	5	3
제주특별자치도	제주시	일도2동	일도2동제2투	3232	2268	964	11	2257	1243	1005	1	0	3	5
제주특별자치도	제주시	일도2동	일도2동제3투	2805	2146	659	3	2143	1111	1029	0	0	3	0
제주특별자치도	제주시	일도2동	일도2동제4투	3052	2124	928	5	2119	1167	940	0	0	5	7
제주특별자치도	제주시	일도2동	일도2동제5투	2056	1569	487	5	1564	812	747	0	0	2	3
제주특별자치도	제주시	일도2동	일도2동제6투	3229	2501	728	4	2497	1258	1232	2	1	3	1
제주특별자치도	제주시	일도2동	일도2동제7투	3637	2885	752	6	2879	1299	1571	1	1	4	3
제주특별자치도	제주시	일도2동	일도2동제8투	3217	2575	642	5	2570	1122	1441	0	1	2	4
제주특별자치도	제주시	일도2동	일도2동제9투	2970	2397	573	6	2391	1150	1234	0	2	5	0
제주특별자치도	제주시	이도1동	소계	5999	4202	1797	11	4191	2232	1938	1	4	10	6
제주특별자치도	제주시	이도1동	이도1동제1투	2036	1353	683	5	1348	719	628	0	0	1	0
제주특별자치도	제주시	이도1동	이도1동제2투	2043	1478	565	4	1474	774	688	1	2	5	4
제주특별자치도	제주시	이도1동	이도1동제3투	1920	1371	549	2	1369	739	622	0	2	4	2
제주특별자치도	제주시	이도2동	소계	33699	25254	8445	60	25194	11893	13195	4	16	59	27
제주특별자치도	제주시	이도2동	이도2동제1투	3561	2610	951	12	2598	1300	1285	0	1	4	8
제주특별자치도	제주시	이도2동	이도2동제2투	4489	3468	1021	5	3463	1468	1981	1	0	10	3
제주특별자치도	제주시	이도2동	이도2동제3투	4047	2800	1247	5	2795	1391	1388	0	4	9	3
제주특별자치도	제주시	이도2동	이도2동제4투	5134	3897	1237	13	3884	1724	2147	1	3	8	1
제주특별자치도	제주시	이도2동	이도2동제5투	3331	2332	999	2	2330	1263	1060	0	2	3	2
제주특별자치도	제주시	이도2동	이도2동제6투	3794	2842	952	11	2831	1374	1442	1	2	8	4
제주특별자치도	제주시	이도2동	이도2동제7투	3040	2415	625	6	2409	1206	1195	0	1	5	2
제주특별자치도	제주시	이도2동	이도2동제8투	2967	2254	713	4	2250	967	1271	1	0	7	4
제주특별자치도	제주시	이도2동	이도2동제9투	3336	2636	700	2	2634	1200	1426	0	3	5	0
제주특별자치도	제주시	삼도1동	소계	10671	7830	2841	22	7808	4174	3607	1	2	12	12
제주특별자치도	제주시	삼도1동	삼도1동제1투	2690	2029	661	4	2025	1089	929	0	1	2	4
제주특별자치도	제주시	삼도1동	삼도1동제2투	1934	1428	506	6	1422	771	644	0	0	4	3
제주특별자치도	제주시	삼도1동	삼도1동제3투	3070	2209	861	8	2201	1154	1038	1	1	5	2
제주특별자치도	제주시	삼도1동	삼도1동제4투	2977	2164	813	4	2160	1160	996	0	0	1	3
제주특별자치도	제주시	삼도2동	소계	7468	5203	2265	14	5189	2752	2419	0	2	9	7
제주특별자치도	제주시	삼도2동	삼도2동제1투	2670	1863	807	5	1858	945	903	0	1	5	4
제주특별자치도	제주시	삼도2동	삼도2동제2투	2305	1529	776	3	1526	834	689	0	0	1	2
제주특별자치도	제주시	삼도2동	삼도2동제3투	2493	1811	682	6	1805	973	827	0	1	3	1
제주특별자치도	제주시	용담1동	소계	6586	4570	2016	18	4552	2415	2117	0	2	11	7
제주특별자치도	제주시	용담1동	용담1동제1투	2528	1687	841	8	1679	895	774	0	0	6	4
제주특별자치도	제주시	용담1동	용담1동제2투	2183	1476	707	7	1469	799	664	0	1	3	2
제주특별자치도	제주시	용담1동	용담1동제3투	1875	1407	468	3	1404	721	679	0	1	2	1
제주특별자치도	제주시	용담2동	소계	12956	9472	3484	32	9440	4850	4549	3	6	11	21
제주특별자치도	제주시	용담2동	용담2동제1투	2849	2050	799	7	2043	1069	967	0	2	2	3
제주특별자치도	제주시	용담2동	용담2동제2투	2842	1990	852	6	1984	1038	937	1	0	2	6
제주특별자치도	제주시	용담2동	용담2동제3투	2190	1638	552	3	1635	811	814	1	1	2	6
제주특별자치도	제주시	용담2동	용담2동제4투	2454	1831	623	9	1822	953	862	1	1	1	4
제주특별자치도	제주시	용담2동	용담2동제5투	2621	1963	658	7	1956	979	969	0	2	4	2
제주특별자치도	제주시	건입동	소계	8225	5953	2272	33	5920	3051	2844	0	1	9	15
제주특별자치도	제주시	건입동	건입동제1투	1030	603	427	5	598	343	255	0	0	0	0
제주특별자치도	제주시	건입동	건입동제2투	2398	1767	631	13	1754	913	830	0	1	3	7
제주특별자치도	제주시	건입동	건입동제3투	2487	1842	645	8	1834	928	902	0	0	3	1
제주특별자치도	제주시	건입동	건입동제4투	2310	1741	569	7	1734	867	857	0	0	3	7
제주특별자치도	제주시	화북동	소계	16094	12035	4059	50	11985	5580	6338	4	9	27	27
제주특별자치도	제주시	화북동	화북동제1투	2373	1765	608	8	1757	857	891	0	1	2	6
제주특별자치도	제주시	화북동	화북동제2투	1849	1316	533	19	1297	645	639	1	0	7	5
제주특별자치도	제주시	화북동	화북동제3투	1606	1171	435	4	1167	605	548	2	3	3	6
제주특별자치도	제주시	화북동	화북동제4투	2858	2040	818	5	2035	1018	1010	1	0	4	2
제주특별자치도	제주시	화북동	화북동제5투	2289	1885	404	6	1879	805	1067	0	2	3	2
제주특별자치도	제주시	화북동	화북동제6투	2743	2135	608	5	2130	874	1245	0	2	6	3
제주특별자치도	제주시	화북동	화북동제7투	2376	1723	653	3	1720	776	938	0	1	2	3
제주특별자치도	제주시	삼양동	소계	7932	5879	2053	21	5858	2909	2916	2	7	8	16
제주특별자치도	제주시	삼양동	삼양동제1투	2024	1529	495	6	1523	755	759	0	1	2	6
제주특별자치도	제주시	삼양동	삼양동제2투	3330	2464	866	8	2456	1248	1194	2	6	2	4
제주특별자치도	제주시	삼양동	삼양동제3투	1994	1465	529	3	1462	701	756	0	0	3	2
제주특별자치도	제주시	삼양동	삼양동제4투	584	421	163	4	417	205	207	0	0	1	4
제주특별자치도	제주시	봉개동	소계	2340	1678	662	12	1666	886	764	0	1	2	13
제주특별자치도	제주시	봉개동	봉개동제1투	1602	1147	455	5	1142	599	529	0	1	2	11
제주특별자치도	제주시	봉개동	봉개동제2투	426	295	131	5	290	153	137	0	0	0	0
제주특별자치도	제주시	봉개동	봉개동제3투	312	236	76	2	234	134	98	0	0	0	2
제주특별자치도	제주시	아라동	소계	11248	8261	2987	35	8226	3838	4335	8	6	19	20
제주특별자치도	제주시	아라동	아라동제1투	2881	2023	858	1	2022	892	1118	1	2	5	4
제주특별자치도	제주시	아라동	아라동제2투	2533	2005	528	6	1999	871	1120	1	0	5	2
제주특별자치도	제주시	아라동	아라동제3투	1943	1289	654	14	1275	636	632	1	1	1	4
제주특별자치도	제주시	아라동	아라동제4투	1303	980	323	5	975	422	549	1	1	1	1
제주특별자치도	제주시	아라동	아라동제5투	2588	1964	624	9	1955	1017	916	4	2	7	9
제주특별자치도	제주시	오라동	소계	5041	3707	1334	11	3696	1782	1900	0	2	8	4
제주특별자치도	제주시	오라동	오라동제1투	2717	2026	691	5	2021	1017	997	0	1	4	2
제주특별자치도	제주시	오라동	오라동제2투	2324	1681	643	6	1675	765	903	0	1	4	2
제주특별자치도	제주시	연동	소계	31002	21361	9641	42	21319	10258	11006	6	8	24	17
제주특별자치도	제주시	연동	연동제1투	3904	2552	1352	4	2548	1299	1244	1	0	2	2
제주특별자치도	제주시	연동	연동제2투	4362	3135	1227	10	3125	1512	1606	2	0	2	3
제주특별자치도	제주시	연동	연동제3투	3838	2609	1229	8	2601	1240	1348	0	2	7	4
제주특별자치도	제주시	연동	연동제4투	3568	2149	1419	5	2144	1128	1013	0	0	3	0
제주특별자치도	제주시	연동	연동제5투	3968	2936	1032	4	2932	1318	1605	0	2	4	3
제주특별자치도	제주시	연동	연동제6투	3451	2502	949	3	2499	1132	1361	1	2	2	1
제주특별자치도	제주시	연동	연동제7투	3381	2241	1140	2	2239	1134	1101	1	0	3	0
제주특별자치도	제주시	연동	연동제8투	4530	3237	1293	6	3231	1495	1728	1	2	1	4
제주특별자치도	제주시	노형동	소계	34333	25637	8696	65	25572	11699	13795	6	14	44	14
제주특별자치도	제주시	노형동	노형동제1투	2559	1954	605	3	1951	910	1032	0	1	3	5
제주특별자치도	제주시	노형동	노형동제2투	3239	2458	781	9	2449	1191	1250	0	1	4	3
제주특별자치도	제주시	노형동	노형동제3투	4194	2754	1440	9	2745	1289	1450	0	4	2	0
제주특별자치도	제주시	노형동	노형동제4투	4202	3375	827	3	3372	1514	1850	0	1	6	1
제주특별자치도	제주시	노형동	노형동제5투	4212	3040	1172	5	3035	1311	1716	0	4	3	1
제주특별자치도	제주시	노형동	노형동제6투	4532	3231	1301	6	3225	1522	1694	3	0	5	1
제주특별자치도	제주시	노형동	노형동제7투	923	694	229	5	689	289	396	2	0	2	0
제주특별자치도	제주시	노형동	노형동제8투	2402	1784	618	8	1776	903	864	0	2	6	1
제주특별자치도	제주시	노형동	노형동제9투	3949	3073	876	11	3062	1291	1765	0	0	5	1
제주특별자치도	제주시	노형동	노형동제10투	4121	3274	847	6	3268	1479	1778	1	1	8	1
제주특별자치도	제주시	외도동	소계	10717	8092	2625	30	8062	3606	4424	4	8	14	6
제주특별자치도	제주시	외도동	외도동제1투	3154	2265	889	10	2255	1129	1121	0	1	3	1
제주특별자치도	제주시	외도동	외도동제2투	993	735	258	7	728	365	359	0	1	1	2
제주특별자치도	제주시	외도동	외도동제3투	3062	2335	727	8	2327	1116	1199	4	2	6	0
제주특별자치도	제주시	외도동	외도동제4투	3508	2757	751	5	2752	996	1745	0	4	4	3
제주특별자치도	제주시	이호동	소계	2990	2210	780	8	2202	1174	1015	1	1	7	4
제주특별자치도	제주시	이호동	이호동제1투	1100	780	320	3	777	462	310	0	0	2	3
제주특별자치도	제주시	이호동	이호동제2투	1890	1430	460	5	1425	712	705	1	1	5	1
제주특별자치도	제주시	도두동	소계	2078	1536	542	8	1528	783	739	0	0	2	4
제주특별자치도	제주시	도두동	도두동제1투	1420	1031	389	8	1023	544	475	0	0	2	2
제주특별자치도	제주시	도두동	도두동제2투	658	505	153	0	505	239	264	0	0	0	2
제주특별자치도	서귀포시	계	계	123281	89415	33866	566	88849	46621	41613	54	76	194	291
제주특별자치도	서귀포시	재외투표	재외투표	1304	909	395	9	900	524	366	3	4	1	2
제주특별자치도	서귀포시	국내부재자투표	국내부재자투표	4059	3710	349	78	3632	1511	2078	9	9	11	14
제주특별자치도	서귀포시	대정읍	소계	13037	9486	3551	81	9405	5135	4212	4	5	13	36
제주특별자치도	서귀포시	대정읍	대정읍제1투	2724	2013	711	15	1998	1122	869	0	0	1	6
제주특별자치도	서귀포시	대정읍	대정읍제2투	2141	1529	612	13	1516	852	658	1	1	1	3
제주특별자치도	서귀포시	대정읍	대정읍제3투	1334	986	348	4	982	458	517	0	0	1	6
제주특별자치도	서귀포시	대정읍	대정읍제4투	575	429	146	3	426	244	180	0	0	1	1
제주특별자치도	서귀포시	대정읍	대정읍제5투	1188	884	304	8	876	520	350	1	0	1	4
제주특별자치도	서귀포시	대정읍	대정읍제6투	214	141	73	1	140	90	49	0	0	1	0
제주특별자치도	서귀포시	대정읍	대정읍제7투	696	547	149	14	533	270	258	0	0	1	4
제주특별자치도	서귀포시	대정읍	대정읍제8투	2465	1684	781	10	1674	924	739	0	3	4	4
제주특별자치도	서귀포시	대정읍	대정읍제9투	439	343	96	2	341	203	134	2	0	0	2
제주특별자치도	서귀포시	대정읍	대정읍제10투	517	388	129	2	386	179	204	0	1	0	2
제주특별자치도	서귀포시	대정읍	대정읍제11투	354	261	93	4	257	119	136	0	0	0	2
제주특별자치도	서귀포시	대정읍	대정읍제12투	390	281	109	5	276	154	118	0	0	2	2
제주특별자치도	서귀포시	남원읍	소계	14155	10304	3851	74	10230	5369	4786	3	4	23	45
제주특별자치도	서귀포시	남원읍	남원읍제1투	692	501	191	5	496	291	196	0	1	2	6
제주특별자치도	서귀포시	남원읍	남원읍제2투	1370	984	386	8	976	518	456	0	0	1	1
제주특별자치도	서귀포시	남원읍	남원읍제3투	862	654	208	4	650	365	282	1	0	1	1
제주특별자치도	서귀포시	남원읍	남원읍제4투	2677	1890	787	9	1881	958	912	1	0	4	6
제주특별자치도	서귀포시	남원읍	남원읍제5투	1333	969	364	10	959	541	410	1	1	3	3
제주특별자치도	서귀포시	남원읍	남원읍제6투	1562	1146	416	10	1136	590	538	0	1	2	5
제주특별자치도	서귀포시	남원읍	남원읍제7투	927	673	254	5	668	360	303	0	1	0	4
제주특별자치도	서귀포시	남원읍	남원읍제8투	2147	1561	586	5	1556	772	772	0	0	5	7
제주특별자치도	서귀포시	남원읍	남원읍제9투	420	292	128	3	289	147	138	0	0	1	3
제주특별자치도	서귀포시	남원읍	남원읍제10투	638	483	155	8	475	255	215	0	0	1	4
제주특별자치도	서귀포시	남원읍	남원읍제11투	299	229	70	3	226	119	104	0	0	1	2
제주특별자치도	서귀포시	남원읍	남원읍제12투	447	327	120	0	327	174	151	0	0	1	1
제주특별자치도	서귀포시	남원읍	남원읍제13투	439	344	95	2	342	159	182	0	0	0	1
제주특별자치도	서귀포시	남원읍	남원읍제14투	342	251	91	2	249	120	127	0	0	1	1
제주특별자치도	서귀포시	성산읍	소계	11202	7865	3337	58	7807	4717	3019	7	9	18	37
제주특별자치도	서귀포시	성산읍	성산읍제1투	1422	971	451	4	967	600	366	0	0	1	0
제주특별자치도	서귀포시	성산읍	성산읍제2투	873	637	236	5	632	392	234	0	2	0	4
제주특별자치도	서귀포시	성산읍	성산읍제3투	2526	1591	935	8	1583	875	701	0	1	4	2
제주특별자치도	서귀포시	성산읍	성산읍제4투	953	689	264	7	682	411	267	0	0	1	3
제주특별자치도	서귀포시	성산읍	성산읍제5투	1095	788	307	6	782	480	293	4	0	4	1
제주특별자치도	서귀포시	성산읍	성산읍제6투	931	684	247	6	678	395	277	1	1	0	4
제주특별자치도	서귀포시	성산읍	성산읍제7투	541	396	145	2	394	255	131	1	1	1	5
제주특별자치도	서귀포시	성산읍	성산읍제8투	365	280	85	3	277	180	93	0	0	0	4
제주특별자치도	서귀포시	성산읍	성산읍제9투	772	553	219	3	550	351	189	1	1	0	8
제주특별자치도	서귀포시	성산읍	성산읍제10투	480	360	120	6	354	200	152	0	0	1	1
제주특별자치도	서귀포시	성산읍	성산읍제11투	796	584	212	5	579	412	162	0	3	2	0
제주특별자치도	서귀포시	성산읍	성산읍제12투	448	332	116	3	329	166	154	0	0	4	5
제주특별자치도	서귀포시	안덕면	소계	7457	5521	1936	25	5496	2901	2540	2	10	16	27
제주특별자치도	서귀포시	안덕면	안덕면제1투	1857	1344	513	7	1337	728	594	2	2	5	6
제주특별자치도	서귀포시	안덕면	안덕면제2투	1679	1243	436	6	1237	698	529	0	2	4	4
제주특별자치도	서귀포시	안덕면	안덕면제3투	742	568	174	2	566	302	258	0	1	2	3
제주특별자치도	서귀포시	안덕면	안덕면제4투	943	672	271	3	669	337	326	0	2	0	4
제주특별자치도	서귀포시	안덕면	안덕면제5투	657	492	165	1	491	238	247	0	2	1	3
제주특별자치도	서귀포시	안덕면	안덕면제6투	429	306	123	3	303	169	131	0	0	0	3
제주특별자치도	서귀포시	안덕면	안덕면제7투	685	532	153	2	530	251	273	0	1	3	2
제주특별자치도	서귀포시	안덕면	안덕면제8투	465	364	101	1	363	178	182	0	0	1	2
제주특별자치도	서귀포시	표선면	소계	8418	6056	2362	28	6028	3343	2626	6	4	21	28
제주특별자치도	서귀포시	표선면	표선면제1투	3611	2487	1124	8	2479	1401	1062	2	1	4	9
제주특별자치도	서귀포시	표선면	표선면제2투	745	557	188	4	553	353	194	0	1	2	3
제주특별자치도	서귀포시	표선면	표선면제3투	995	755	240	5	750	491	250	1	1	3	4
제주특별자치도	서귀포시	표선면	표선면제4투	595	436	159	1	435	234	196	1	0	1	3
제주특별자치도	서귀포시	표선면	표선면제5투	935	695	240	3	692	294	391	1	0	3	3
제주특별자치도	서귀포시	표선면	표선면제6투	323	247	76	2	245	94	146	0	1	2	2
제주특별자치도	서귀포시	표선면	표선면제7투	524	385	139	3	382	237	141	1	0	3	0
제주특별자치도	서귀포시	표선면	표선면제8투	468	340	128	1	339	163	171	0	0	2	3
제주특별자치도	서귀포시	표선면	표선면제9투	222	154	68	1	153	76	75	0	0	1	1
제주특별자치도	서귀포시	송산동	소계	3915	2654	1261	15	2639	1547	1079	1	1	5	6
제주특별자치도	서귀포시	송산동	송산동제1투	2033	1300	733	7	1293	764	524	1	0	2	2
제주특별자치도	서귀포시	송산동	송산동제2투	1882	1354	528	8	1346	783	555	0	1	3	4
제주특별자치도	서귀포시	정방동	소계	2334	1426	908	2	1424	844	574	0	2	3	1
제주특별자치도	서귀포시	정방동	정방동투표소	2334	1426	908	2	1424	844	574	0	2	3	1
제주특별자치도	서귀포시	중앙동	소계	3536	2341	1195	8	2333	1341	986	1	0	1	4
제주특별자치도	서귀포시	중앙동	중앙동투표소	3536	2341	1195	8	2333	1341	986	1	0	1	4
제주특별자치도	서귀포시	천지동	소계	3185	2180	1005	10	2170	1275	887	0	2	4	2
제주특별자치도	서귀포시	천지동	천지동제1투	2930	1977	953	10	1967	1165	794	0	2	4	2
제주특별자치도	서귀포시	천지동	천지동제2투	255	203	52	0	203	110	93	0	0	0	0
제주특별자치도	서귀포시	효돈동	소계	3916	2974	942	18	2956	1601	1339	3	0	6	7
제주특별자치도	서귀포시	효돈동	효돈동제1투	1413	1080	333	6	1074	539	530	1	0	1	3
제주특별자치도	서귀포시	효돈동	효돈동제2투	2503	1894	609	12	1882	1062	809	2	0	5	4
제주특별자치도	서귀포시	영천동	소계	3837	2699	1138	15	2684	1369	1296	2	3	4	10
제주특별자치도	서귀포시	영천동	영천동제1투	2747	1898	849	9	1889	938	941	2	0	2	6
제주특별자치도	서귀포시	영천동	영천동제2투	585	439	146	1	438	231	199	0	3	2	3
제주특별자치도	서귀포시	영천동	영천동제3투	505	362	143	5	357	200	156	0	0	0	1
제주특별자치도	서귀포시	동홍동	소계	14746	10616	4130	42	10574	4972	5558	1	8	17	18
제주특별자치도	서귀포시	동홍동	동홍동제1투	3745	2649	1096	7	2642	1193	1440	1	2	3	3
제주특별자치도	서귀포시	동홍동	동홍동제2투	3799	2707	1092	12	2695	1273	1411	0	0	4	7
제주특별자치도	서귀포시	동홍동	동홍동제3투	4299	3159	1140	10	3149	1447	1691	0	2	6	3
제주특별자치도	서귀포시	동홍동	동홍동제4투	2903	2101	802	13	2088	1059	1016	0	4	4	5
제주특별자치도	서귀포시	서홍동	소계	6322	4484	1838	29	4455	2195	2238	1	8	8	5
제주특별자치도	서귀포시	서홍동	서홍동제1투	3876	2773	1103	24	2749	1304	1428	1	3	8	5
제주특별자치도	서귀포시	서홍동	서홍동제2투	2446	1711	735	5	1706	891	810	0	5	0	0
제주특별자치도	서귀포시	대륜동	소계	7070	5175	1895	15	5160	2759	2375	3	2	12	9
제주특별자치도	서귀포시	대륜동	대륜동제1투	1963	1407	556	5	1402	835	558	1	0	3	5
제주특별자치도	서귀포시	대륜동	대륜동제2투	1022	736	286	2	734	412	318	1	0	3	0
제주특별자치도	서귀포시	대륜동	대륜동제3투	1501	1073	428	3	1070	543	519	0	1	4	3
제주특별자치도	서귀포시	대륜동	대륜동제4투	2584	1959	625	5	1954	969	980	1	1	2	1
제주특별자치도	서귀포시	대천동	소계	5342	4018	1324	13	4005	1887	2098	3	1	9	7
제주특별자치도	서귀포시	대천동	대천동제1투	1438	1107	331	5	1102	450	644	1	1	3	3
제주특별자치도	서귀포시	대천동	대천동제2투	772	565	207	2	563	298	263	0	0	2	0
제주특별자치도	서귀포시	대천동	대천동제3투	758	556	202	3	553	315	236	0	0	2	0
제주특별자치도	서귀포시	대천동	대천동제4투	524	396	128	2	394	166	224	0	0	2	2
제주특별자치도	서귀포시	대천동	대천동제5투	1850	1394	456	1	1393	658	731	2	0	0	2
제주특별자치도	서귀포시	중문동	소계	6655	4915	1740	32	4883	2279	2556	3	3	15	27
제주특별자치도	서귀포시	중문동	중문동제1투	3739	2725	1014	15	2710	1296	1395	0	0	8	11
제주특별자치도	서귀포시	중문동	중문동제2투	1227	901	326	15	886	443	426	1	2	4	10
제주특별자치도	서귀포시	중문동	중문동제3투	1161	891	270	2	889	335	546	2	1	2	3
제주특별자치도	서귀포시	중문동	중문동제4투	528	398	130	0	398	205	189	0	0	1	3
제주특별자치도	서귀포시	예래동	소계	2791	2082	709	14	2068	1052	1000	2	1	7	6
제주특별자치도	서귀포시	예래동	예래동제1투	629	480	149	2	478	256	218	0	0	1	3
제주특별자치도	서귀포시	예래동	예래동제2투	1760	1302	458	11	1291	658	625	1	1	4	2
제주특별자치도	서귀포시	예래동	예래동제3투	402	300	102	1	299	138	157	1	0	2	1
