광역	시군구	읍면동	종류	선거인수	투표수	기권수	무효표	유효투표수	공화당	새누리당	새정치민주연합	통합진보당	정의당	국제녹색당	노동당	녹색당	새정치당	한나라당
서울특별시	종로구	관외사전투표		7058	7056	2	93	6963	0	2788	3396	207	344	9	73	86	12	48
서울특별시	종로구	거소우편투표		224	210	14	10	200	0	113	65	8	5	0	3	1	1	4
서울특별시	종로구	청운효자동	계	11003	6962	4041	113	6849	0	3114	2861	199	390	9	112	100	8	56
서울특별시	종로구	사직동	계	8044	4850	3194	86	4764	0	2642	1641	102	219	4	64	56	7	29
서울특별시	종로구	삼청동	계	2582	1489	1093	31	1458	0	780	520	43	63	4	8	25	1	14
서울특별시	종로구	부암동	계	8536	5133	3403	75	5058	0	2425	1948	164	304	8	63	81	8	57
서울특별시	종로구	평창동	계	15493	9327	6166	153	9174	0	5182	3146	197	401	11	68	106	9	54
서울특별시	종로구	무악동	계	6539	4181	2358	78	4103	0	1917	1768	101	197	6	44	30	6	34
서울특별시	종로구	교남동	계	4191	2119	2072	52	2067	0	855	984	54	84	2	33	16	6	33
서울특별시	종로구	가회동	계	4201	2535	1666	53	2482	0	1165	981	76	142	2	43	45	5	23
서울특별시	종로구	종로1·2·3·4가동	계	7025	3124	3901	61	3063	0	1606	1219	65	85	4	22	24	4	34
서울특별시	종로구	종로5·6가동	계	4988	2518	2470	62	2456	0	1140	1129	58	55	3	15	14	7	35
서울특별시	종로구	이화동	계	7516	4236	3280	104	4132	0	1526	2141	149	210	4	22	41	7	32
서울특별시	종로구	혜화동	계	14841	9228	5613	187	9041	0	3508	4346	296	607	21	82	102	13	66
서울특별시	종로구	창신제1동	계	5336	2627	2709	61	2566	0	1090	1291	74	47	6	12	8	7	31
서울특별시	종로구	창신제2동	계	8827	4508	4319	130	4378	0	1614	2429	125	102	21	19	17	15	36
서울특별시	종로구	창신제3동	계	6446	3822	2624	63	3759	0	1506	1918	123	137	1	13	15	19	27
서울특별시	종로구	숭인제1동	계	5841	3063	2778	59	3004	0	1246	1514	99	94	7	10	9	5	20
서울특별시	종로구	숭인제2동	계	8234	4091	4143	105	3986	0	1602	2054	115	120	7	18	25	16	29
서울특별시	중구	관외사전투표		5425	5424	1	81	5343	0	2171	2644	144	226	9	41	34	18	56
서울특별시	중구	거소우편투표		160	152	8	9	143	0	75	50	7	3	1	2	0	0	5
서울특별시	중구	소공동	계	1102	576	526	6	570	0	267	228	20	32	1	6	10	0	6
서울특별시	중구	회현동	계	5384	2504	2880	73	2431	0	1454	803	48	66	8	13	4	7	28
서울특별시	중구	명동	계	2771	1437	1334	27	1410	0	725	565	49	26	2	10	17	2	14
서울특별시	중구	필동	계	3841	2125	1716	46	2079	0	1018	879	63	74	4	10	16	1	14
서울특별시	중구	장충동	계	4594	2513	2081	42	2471	0	1042	1202	56	116	2	17	13	4	19
서울특별시	중구	광희동	계	4561	2340	2221	37	2303	0	1260	922	47	42	2	7	4	2	17
서울특별시	중구	을지로동	계	1639	755	884	14	741	0	453	251	7	12	1	1	1	3	12
서울특별시	중구	신당동	계	6550	3274	3276	83	3191	0	1484	1478	84	73	3	15	8	10	36
서울특별시	중구	다산동	계	13134	7166	5968	126	7040	0	3030	3417	192	210	17	47	41	17	69
서울특별시	중구	약수동	계	15486	9128	6358	196	8932	0	4195	3914	247	365	19	49	44	13	86
서울특별시	중구	청구동	계	12482	7603	4879	139	7464	0	3436	3373	195	298	12	39	37	16	58
서울특별시	중구	신당제5동	계	8439	4563	3876	90	4473	0	1932	2219	103	104	4	27	25	12	47
서울특별시	중구	동화동	계	9363	5744	3619	106	5638	0	2676	2528	130	208	7	26	15	9	39
서울특별시	중구	황학동	계	10414	5443	4971	99	5344	0	2323	2595	120	173	14	32	20	12	55
서울특별시	중구	중림동	계	7890	4620	3270	114	4506	0	2073	2055	113	153	9	25	32	3	43
서울특별시	용산구	관외사전투표		10337	10333	4	156	10177	0	4766	4387	288	428	28	80	71	18	111
서울특별시	용산구	거소우편투표		283	266	17	7	259	0	151	71	10	6	1	6	1	3	10
서울특별시	용산구	후암동	계	15469	8410	7059	148	8262	0	3601	3773	235	402	11	61	64	22	93
서울특별시	용산구	용산2가동	계	10228	5505	4723	122	5383	0	2481	2323	137	228	11	43	63	18	79
서울특별시	용산구	남영동	계	7008	3316	3692	71	3245	0	1499	1440	82	125	6	35	16	6	36
서울특별시	용산구	청파동	계	18297	9761	8536	200	9561	0	3890	4636	280	487	13	66	57	24	108
서울특별시	용산구	원효로제1동	계	10585	6255	4330	114	6141	0	2851	2616	163	353	12	37	41	16	52
서울특별시	용산구	원효로제2동	계	12162	7534	4628	156	7378	0	3530	2966	211	487	12	53	35	25	59
서울특별시	용산구	효창동	계	8839	5381	3458	79	5302	0	2468	2291	161	238	3	28	45	14	54
서울특별시	용산구	용문동	계	10176	6145	4031	109	6036	0	2736	2657	153	337	13	45	35	11	49
서울특별시	용산구	한강로동	계	12541	6692	5849	116	6576	0	3926	2179	106	234	9	23	29	16	54
서울특별시	용산구	이촌제1동	계	20561	12571	7990	158	12413	0	7742	3630	258	558	21	45	94	7	58
서울특별시	용산구	이촌제2동	계	7979	5198	2781	116	5082	0	2723	1916	122	205	9	38	18	8	43
서울특별시	용산구	이태원제1동	계	7051	3438	3613	84	3354	0	1871	1159	71	151	9	28	22	7	36
서울특별시	용산구	이태원제2동	계	9156	5019	4137	141	4878	0	2427	1884	125	253	9	46	33	14	87
서울특별시	용산구	한남동	계	19137	8850	10287	203	8647	0	4382	3354	226	431	25	71	58	16	84
서울특별시	용산구	서빙고동	계	10474	6254	4220	105	6149	0	4064	1685	74	204	10	22	18	13	59
서울특별시	용산구	보광동	계	14246	7229	7017	195	7034	0	3441	2874	152	347	15	46	40	14	105
서울특별시	성동구	관외사전투표		11668	11666	2	147	11519	0	4678	5655	442	438	19	87	70	16	114
서울특별시	성동구	거소우편투표		370	357	13	15	342	0	174	122	18	7	3	6	5	1	6
서울특별시	성동구	금호1가동	계	11371	6482	4889	136	6346	0	2880	2860	215	234	6	38	36	15	62
서울특별시	성동구	금호2·3가동	계	18519	10378	8141	234	10144	0	4547	4636	327	352	6	47	53	30	146
서울특별시	성동구	금호4가동	계	12013	6675	5338	134	6541	0	2963	2970	199	285	9	35	38	9	33
서울특별시	성동구	옥수동	계	18893	10957	7936	191	10766	0	5472	4280	317	492	6	50	77	14	58
서울특별시	성동구	응봉동	계	13138	7685	5453	117	7568	0	3713	3245	248	263	8	32	25	7	27
서울특별시	성동구	성수1가제1동	계	13598	7494	6104	111	7383	0	3468	3208	291	274	11	45	20	11	55
서울특별시	성동구	성수1가제2동	계	14733	8453	6280	119	8334	0	3654	3834	345	338	13	41	29	20	60
서울특별시	성동구	성수2가제1동	계	16471	8525	7946	167	8358	0	4073	3592	320	223	6	46	22	18	58
서울특별시	성동구	성수2가제3동	계	10002	5715	4287	105	5610	0	2746	2394	174	186	6	31	31	11	31
서울특별시	성동구	왕십리도선동	계	11817	6504	5313	126	6378	0	3004	2876	191	182	4	37	29	8	47
서울특별시	성동구	왕십리제2동	계	13374	7590	5784	148	7442	0	3120	3663	223	258	16	42	27	19	74
서울특별시	성동구	행당제1동	계	13992	7772	6220	140	7632	0	3534	3471	215	256	13	44	37	16	46
서울특별시	성동구	행당제2동	계	20006	12235	7771	211	12024	0	5218	5642	410	537	11	51	65	18	72
서울특별시	성동구	마장동	계	19935	11388	8547	216	11172	0	4909	5291	415	353	11	62	44	22	65
서울특별시	성동구	사근동	계	8809	4920	3889	119	4801	0	1786	2464	200	235	6	39	21	8	42
서울특별시	성동구	송정동	계	9814	4858	4956	107	4751	0	1936	2417	165	127	5	28	18	10	45
서울특별시	성동구	용답동	계	13785	7103	6682	149	6954	0	3015	3337	252	196	7	41	26	19	61
서울특별시	광진구	관외사전투표		13980	13975	5	188	13787	0	5337	7032	452	554	38	95	96	32	151
서울특별시	광진구	거소우편투표		430	415	15	11	404	0	195	158	10	10	2	5	2	9	13
서울특별시	광진구	중곡제1동	계	13652	7179	6473	146	7033	0	3026	3432	176	258	9	54	23	10	45
서울특별시	광진구	중곡제2동	계	18419	9875	8544	156	9719	0	4132	4736	243	362	24	100	32	21	69
서울특별시	광진구	중곡제3동	계	15039	7816	7223	132	7684	0	3403	3664	217	228	12	53	25	12	70
서울특별시	광진구	중곡제4동	계	25255	13790	11465	219	13571	0	6051	6394	356	448	31	127	38	32	94
서울특별시	광진구	능동	계	9485	5329	4156	101	5228	0	2028	2671	163	257	3	28	33	13	32
서울특별시	광진구	구의제1동	계	18689	9827	8862	184	9643	0	3785	4919	301	443	12	47	47	20	69
서울특별시	광진구	구의제2동	계	21643	11997	9646	270	11727	0	5144	5505	327	478	14	74	45	35	105
서울특별시	광진구	구의제3동	계	23168	14323	8845	214	14109	0	6707	6166	298	712	19	57	49	27	74
서울특별시	광진구	광장동	계	26076	16605	9471	221	16384	0	7850	7089	446	758	16	44	88	26	67
서울특별시	광진구	자양제1동	계	19404	9933	9471	216	9717	0	4039	4800	267	417	16	41	32	23	82
서울특별시	광진구	자양제2동	계	22151	12179	9972	172	12007	0	5355	5649	299	480	20	53	45	25	81
서울특별시	광진구	자양제3동	계	24158	15009	9149	222	14787	0	7000	6520	435	619	6	42	64	21	80
서울특별시	광진구	자양제4동	계	20920	10467	10453	205	10262	0	4479	4918	322	328	13	49	35	24	94
서울특별시	광진구	화양동	계	18967	9069	9898	146	8923	0	3233	4798	283	436	16	44	52	15	46
서울특별시	광진구	군자동	계	17833	9556	8277	168	9388	0	3875	4694	248	365	18	53	39	27	69
서울특별시	동대문구	관외사전투표		14625	14619	6	238	14381	0	5409	7421	487	618	22	142	110	30	142
서울특별시	동대문구	거소우편투표		450	428	22	6	422	0	224	149	18	11	2	5	3	3	7
서울특별시	동대문구	용신동	계	26510	13814	12696	464	13350	0	6122	6135	328	462	20	63	52	40	128
서울특별시	동대문구	제기동	계	22615	12156	10459	257	11899	0	5584	5267	291	445	20	67	54	40	131
서울특별시	동대문구	전농제1동	계	26580	14849	11731	352	14497	0	6635	6698	360	476	17	68	54	42	147
서울특별시	동대문구	전농제2동	계	16442	9910	6532	209	9701	0	4582	4380	268	278	12	38	28	24	91
서울특별시	동대문구	답십리제1동	계	15885	8661	7224	215	8446	0	3805	3985	228	262	12	36	23	14	81
서울특별시	동대문구	답십리제2동	계	24398	14419	9979	490	13929	0	6247	6502	436	434	27	63	40	35	145
서울특별시	동대문구	장안제1동	계	29975	16597	13378	398	16199	0	7501	7541	395	438	30	61	49	46	138
서울특별시	동대문구	장안제2동	계	25458	14488	10970	366	14122	0	6552	6479	376	408	24	52	47	43	141
서울특별시	동대문구	청량리동	계	20039	11302	8737	300	11002	0	5859	4297	248	292	17	47	51	32	159
서울특별시	동대문구	회기동	계	9383	5291	4092	95	5196	0	2128	2445	199	279	4	42	60	8	31
서울특별시	동대문구	휘경제1동	계	13531	7177	6354	222	6955	0	3126	3200	220	256	9	47	33	16	48
서울특별시	동대문구	휘경제2동	계	19988	11806	8182	300	11506	0	4898	5490	395	467	19	83	55	24	75
서울특별시	동대문구	이문제1동	계	24917	13413	11504	462	12951	0	5811	5840	405	566	18	121	71	26	93
서울특별시	동대문구	이문제2동	계	17522	10321	7201	246	10075	0	4409	4783	324	356	9	71	36	13	74
서울특별시	중랑구	관외사전투표		16277	16268	9	256	16012	0	6360	8043	616	508	31	121	99	41	193
서울특별시	중랑구	거소우편투표		708	668	40	41	627	0	332	195	23	18	12	14	10	3	20
서울특별시	중랑구	면목본동	계	30031	14158	15873	222	13936	0	6147	6651	476	327	24	109	50	35	117
서울특별시	중랑구	면목제2동	계	22303	10356	11947	167	10189	0	4485	4822	386	267	13	66	43	17	90
서울특별시	중랑구	면목제3·8동	계	23093	11363	11730	172	11191	0	5065	5284	318	286	14	57	40	36	91
서울특별시	중랑구	면목제4동	계	17582	8989	8593	163	8826	0	3877	4282	237	269	7	43	28	17	66
서울특별시	중랑구	면목제5동	계	11045	5292	5753	103	5189	0	2274	2493	172	137	1	34	9	17	52
서울특별시	중랑구	면목제7동	계	20399	10436	9963	185	10251	0	4738	4739	326	264	6	40	34	23	81
서울특별시	중랑구	상봉제1동	계	19681	11006	8675	148	10858	0	4902	5058	354	304	12	75	49	17	87
서울특별시	중랑구	상봉제2동	계	15464	7138	8326	132	7006	0	3206	3243	239	193	7	37	26	11	44
서울특별시	중랑구	중화제1동	계	16883	9296	7587	154	9142	0	4131	4302	261	252	8	68	29	23	68
서울특별시	중랑구	중화제2동	계	24856	11514	13342	196	11318	0	5245	5276	307	268	8	71	28	22	93
서울특별시	중랑구	묵제1동	계	27809	15484	12325	229	15255	0	6853	7058	478	560	14	96	59	27	110
서울특별시	중랑구	묵제2동	계	16039	8318	7721	131	8187	0	3741	3784	247	247	8	46	26	13	75
서울특별시	중랑구	망우본동	계	27619	13958	13661	213	13745	0	7086	5791	322	329	8	53	46	21	89
서울특별시	중랑구	망우제3동	계	15293	7198	8095	128	7070	0	3451	3139	202	139	11	41	19	19	49
서울특별시	중랑구	신내제1동	계	27900	16511	11389	203	16308	0	7515	7530	504	480	11	90	50	26	102
서울특별시	중랑구	신내제2동	계	18983	11410	7573	177	11233	0	4877	5323	423	395	14	61	43	20	77
서울특별시	성북구	관외사전투표		19179	19165	14	287	18878	0	7331	9472	736	780	35	152	151	32	189
서울특별시	성북구	거소우편투표		597	578	19	14	564	0	270	214	21	25	1	15	3	4	11
서울특별시	성북구	성북동	계	15114	8630	6484	147	8483	0	3854	3610	301	441	13	83	107	14	60
서울특별시	성북구	삼선동	계	22457	12292	10165	212	12080	0	4987	5813	427	539	15	120	69	17	93
서울특별시	성북구	동선동	계	13457	7327	6130	176	7151	0	2871	3496	275	341	9	67	43	15	34
서울특별시	성북구	돈암제1동	계	12703	7664	5039	120	7544	0	3322	3458	310	315	7	34	32	10	56
서울특별시	성북구	돈암제2동	계	17294	10818	6476	207	10611	0	4851	4652	391	500	18	66	66	17	50
서울특별시	성북구	안암동	계	13823	7441	6382	160	7281	0	2965	3420	259	411	18	79	64	18	47
서울특별시	성북구	보문동	계	12139	6308	5831	145	6163	0	2596	2956	208	240	8	49	30	14	62
서울특별시	성북구	정릉제1동	계	15366	9108	6258	152	8956	0	3875	4243	326	333	9	38	53	18	61
서울특별시	성북구	정릉제2동	계	18498	10180	8318	191	9989	0	4530	4491	378	368	12	50	54	19	87
서울특별시	성북구	정릉제3동	계	13723	7194	6529	152	7042	0	3391	2965	271	246	17	22	48	17	65
서울특별시	성북구	정릉제4동	계	21627	12149	9478	201	11948	0	5110	5615	492	472	28	51	84	22	74
서울특별시	성북구	길음제1동	계	27405	17762	9643	267	17495	0	6979	8752	683	814	21	64	70	27	85
서울특별시	성북구	길음제2동	계	16465	8581	7884	166	8415	0	3694	3931	319	303	10	37	39	31	51
서울특별시	성북구	종암동	계	33335	19603	13732	319	19284	0	8058	9331	666	867	24	99	93	27	119
서울특별시	성북구	월곡제1동	계	22262	12715	9547	217	12498	0	4807	6544	490	436	16	47	45	23	90
서울특별시	성북구	월곡제2동	계	17033	9723	7310	154	9569	0	4173	4500	342	357	6	43	49	26	73
서울특별시	성북구	장위제1동	계	19925	9614	10311	146	9468	0	4283	4475	276	238	7	56	35	19	79
서울특별시	성북구	장위제2동	계	17627	8777	8850	162	8615	0	4261	3737	232	212	8	45	29	13	78
서울특별시	성북구	장위제3동	계	14547	7616	6931	175	7441	0	3591	3275	203	232	9	30	19	19	63
서울특별시	성북구	석관동	계	29717	15722	13995	252	15470	0	6986	7206	463	489	22	86	68	37	113
서울특별시	강북구	관외사전투표		12340	12317	23	215	12102	0	4586	6140	524	437	30	121	87	28	149
서울특별시	강북구	거소우편투표		440	422	18	15	407	0	209	149	18	13	1	8	1	2	6
서울특별시	강북구	삼양동	계	24069	11742	12327	334	11408	0	4679	5668	450	371	15	72	47	25	81
서울특별시	강북구	미아동	계	19500	10023	9477	337	9686	0	4200	4634	339	298	18	53	40	23	81
서울특별시	강북구	송중동	계	26348	13331	13017	279	13052	0	5518	6405	439	399	16	62	83	17	113
서울특별시	강북구	송천동	계	25558	12985	12573	352	12633	0	5306	6279	447	330	13	78	50	34	96
서울특별시	강북구	삼각산동	계	24979	15124	9855	269	14855	0	5721	7510	652	692	18	96	64	28	74
서울특별시	강북구	번제1동	계	16864	8311	8553	161	8150	0	3658	3758	292	226	9	51	32	19	105
서울특별시	강북구	번제2동	계	15480	8388	7092	181	8207	0	3557	3868	272	254	31	55	34	30	106
서울특별시	강북구	번제3동	계	16579	9442	7137	279	9163	0	4034	4281	308	301	15	56	31	38	99
서울특별시	강북구	수유제1동	계	18784	9466	9318	332	9134	0	4002	4332	324	246	8	55	43	14	110
서울특별시	강북구	수유제2동	계	18612	10479	8133	170	10309	0	5070	4380	342	287	22	66	39	17	86
서울특별시	강북구	수유제3동	계	20138	10213	9925	204	10009	0	4611	4608	312	254	20	66	43	13	82
서울특별시	강북구	우이동	계	17396	9131	8265	345	8786	0	4391	3533	326	304	18	56	70	20	68
서울특별시	강북구	인수동	계	26961	13900	13061	603	13297	0	6268	5750	503	401	28	99	126	27	95
서울특별시	도봉구	관외사전투표		13167	13161	6	215	12946	0	5301	6294	533	433	29	101	84	29	142
서울특별시	도봉구	거소우편투표		528	491	37	37	454	0	231	164	17	13	5	7	3	1	13
서울특별시	도봉구	쌍문1동	계	17913	9795	8118	181	9614	0	4508	4188	333	390	17	36	46	15	81
서울특별시	도봉구	쌍문2동	계	17066	9002	8064	155	8847	0	4075	3984	318	300	13	39	35	14	69
서울특별시	도봉구	쌍문3동	계	14752	7966	6786	137	7829	0	3557	3520	314	273	9	41	30	23	62
서울특별시	도봉구	쌍문4동	계	16127	9575	6552	161	9414	0	4433	4119	357	352	9	39	40	11	54
서울특별시	도봉구	방학1동	계	25235	13497	11738	294	13203	0	6260	5823	416	411	16	74	44	33	126
서울특별시	도봉구	방학2동	계	18557	9209	9348	214	8995	0	4264	4062	279	199	5	57	32	24	73
서울특별시	도봉구	방학3동	계	24134	14583	9551	225	14358	0	6546	6354	654	537	14	66	99	13	75
서울특별시	도봉구	창1동	계	21981	13106	8875	206	12900	0	5596	6003	550	531	20	44	54	18	84
서울특별시	도봉구	창2동	계	24706	13383	11323	244	13139	0	5709	6236	393	528	15	54	41	34	129
서울특별시	도봉구	창3동	계	12698	6510	6188	133	6377	0	2879	2968	214	158	11	35	28	22	62
서울특별시	도봉구	창4동	계	23060	14508	8552	207	14301	0	6190	6743	527	626	17	55	52	20	71
서울특별시	도봉구	창5동	계	21825	13341	8484	257	13084	0	6198	5803	427	428	9	48	51	20	100
서울특별시	도봉구	도봉1동	계	19916	10542	9374	229	10313	0	5203	4299	336	245	17	60	32	18	103
서울특별시	도봉구	도봉2동	계	24370	14445	9925	264	14181	0	6553	6380	447	480	25	86	60	30	120
서울특별시	노원구	관외사전투표		23687	23676	11	342	23334	0	9411	11399	964	921	48	159	149	59	224
서울특별시	노원구	거소우편투표		1053	1016	37	61	955	0	535	316	35	23	8	11	6	4	17
서울특별시	노원구	월계1동	계	18248	10556	7692	179	10377	0	4666	4715	436	356	8	60	33	23	80
서울특별시	노원구	월계2동	계	23662	13122	10540	268	12854	0	5840	5802	532	402	12	81	40	33	112
서울특별시	노원구	월계3동	계	27434	17061	10373	304	16757	0	7114	7921	751	662	13	92	58	40	106
서울특별시	노원구	공릉1동	계	32366	18057	14309	310	17747	0	7520	8488	695	679	17	115	64	33	136
서울특별시	노원구	공릉2동	계	33930	20436	13494	329	20107	0	8824	9251	800	827	32	123	105	33	112
서울특별시	노원구	하계1동	계	22903	13533	9370	304	13229	0	6128	5849	501	503	24	70	44	17	93
서울특별시	노원구	하계2동	계	18717	11433	7284	166	11267	0	4837	5275	516	441	5	71	43	15	64
서울특별시	노원구	중계본동	계	20547	12064	8483	215	11849	0	5208	5526	474	436	17	49	64	13	62
서울특별시	노원구	중계1동	계	20351	12655	7696	265	12390	0	5033	6118	489	543	11	59	71	12	54
서울특별시	노원구	중계2·3동	계	31908	18574	13334	431	18143	0	7688	8612	750	664	28	122	96	36	147
서울특별시	노원구	중계4동	계	16935	9884	7051	197	9687	0	4270	4569	367	305	13	37	41	17	68
서울특별시	노원구	상계1동	계	33863	19128	14735	305	18823	0	8431	8587	606	852	33	106	65	41	102
서울특별시	노원구	상계2동	계	17452	9254	8198	178	9076	0	4254	4072	275	318	6	50	26	19	56
서울특별시	노원구	상계3·4동	계	30299	15335	14964	345	14990	0	7076	6568	517	481	28	71	56	54	139
서울특별시	노원구	상계5동	계	18825	9998	8827	207	9791	0	4542	4337	338	372	9	52	36	26	79
서울특별시	노원구	상계6·7동	계	27627	16691	10936	296	16395	0	6745	7879	719	770	16	90	83	16	77
서울특별시	노원구	상계8동	계	18444	11529	6915	181	11348	0	4001	5880	473	788	12	81	40	16	57
서울특별시	노원구	상계9동	계	18040	10899	7141	184	10715	0	4429	5029	404	642	9	76	49	27	50
서울특별시	노원구	상계10동	계	15513	9325	6188	164	9161	0	3866	4321	366	465	7	37	45	6	48
서울특별시	은평구	관외사전투표		20079	20060	19	285	19775	0	7571	9798	725	918	55	204	226	55	223
서울특별시	은평구	거소우편투표		853	788	65	65	723	0	346	223	30	27	15	15	16	15	36
서울특별시	은평구	녹번동	계	25730	13274	12456	199	13075	0	5597	6137	412	524	20	156	96	24	109
서울특별시	은평구	응암제1동	계	25192	13489	11703	189	13300	0	5625	6421	429	485	15	102	66	23	134
서울특별시	은평구	응암제2동	계	19219	10036	9183	141	9895	0	4089	4840	348	351	17	99	57	26	68
서울특별시	은평구	응암제3동	계	22555	11091	11464	174	10917	0	4699	5196	316	379	14	120	58	22	113
서울특별시	은평구	증산동	계	16283	9023	7260	128	8895	0	3898	4114	279	363	10	107	48	16	60
서울특별시	은평구	수색동	계	15431	8685	6746	131	8554	0	3964	3782	249	333	14	63	46	25	78
서울특별시	은평구	신사제1동	계	22440	12251	10189	175	12076	0	4765	6067	379	491	12	172	83	29	78
서울특별시	은평구	신사제2동	계	17295	9296	7999	138	9158	0	3867	4337	307	338	14	116	76	24	79
서울특별시	은평구	갈현제2동	계	22798	11947	10851	203	11744	0	5146	5277	389	409	38	87	281	18	99
서울특별시	은평구	구산동	계	26278	13581	12697	223	13358	0	5957	5839	414	522	51	101	337	20	117
서울특별시	은평구	갈현제1동	계	20724	10753	9971	202	10551	0	4680	4824	358	394	11	95	69	23	97
서울특별시	은평구	진관동	계	37277	23967	13310	330	23637	0	9630	11053	1000	1372	29	210	184	34	125
서울특별시	은평구	불광제1동	계	33735	19420	14315	307	19113	0	8320	8725	694	911	24	154	114	38	133
서울특별시	은평구	불광제2동	계	24196	12410	11786	214	12196	0	5661	5411	383	420	13	88	64	27	129
서울특별시	은평구	대조동	계	26008	13320	12688	233	13087	0	5445	6200	487	589	19	113	96	23	115
서울특별시	은평구	역촌동	계	38827	20321	18506	411	19910	0	8191	9435	713	928	61	213	174	39	156
서울특별시	서대문구	관외사전투표		14411	14390	21	200	14190	0	5524	7064	469	628	26	124	198	30	127
서울특별시	서대문구	거소우편투표		434	405	29	16	389	0	224	137	4	10	1	5	3	1	4
서울특별시	서대문구	충현동	계	15858	8668	7190	166	8502	0	3864	3776	228	273	39	50	157	23	92
서울특별시	서대문구	천연동	계	15865	9923	5942	184	9739	0	4227	4403	295	393	16	61	268	22	54
서울특별시	서대문구	북아현동	계	8592	4837	3755	103	4734	0	1984	2239	133	181	11	41	92	15	38
서울특별시	서대문구	신촌동	계	15843	8132	7711	154	7978	0	3040	3735	230	464	24	77	349	14	45
서울특별시	서대문구	연희동	계	33083	18825	14258	256	18569	0	8300	8153	573	942	25	183	241	34	118
서울특별시	서대문구	홍제제1동	계	20949	12598	8351	204	12394	0	5279	5891	373	558	24	85	82	24	78
서울특별시	서대문구	홍제제2동	계	12448	7902	4546	132	7770	0	3528	3575	203	317	5	42	44	13	43
서울특별시	서대문구	홍제제3동	계	15924	9304	6620	167	9137	0	3917	4341	310	322	13	70	60	27	77
서울특별시	서대문구	홍은제1동	계	20574	12359	8215	275	12084	0	5410	5506	420	436	16	86	68	20	122
서울특별시	서대문구	홍은제2동	계	23532	13112	10420	248	12864	0	5884	5720	405	532	13	90	98	35	87
서울특별시	서대문구	남가좌제1동	계	3011	1533	1478	28	1505	0	725	637	50	64	2	0	8	4	15
서울특별시	서대문구	남가좌제2동	계	23828	13450	10378	261	13189	0	5860	5977	445	611	17	88	64	22	105
서울특별시	서대문구	북가좌제1동	계	15352	9506	5846	158	9348	0	4003	4352	344	445	7	60	69	18	50
서울특별시	서대문구	북가좌제2동	계	26738	14808	11930	358	14450	0	5963	7007	516	659	23	82	71	22	107
서울특별시	마포구	관외사전투표		16003	16003	0	215	15788	0	5763	8041	554	842	35	158	229	34	132
서울특별시	마포구	거소우편투표		425	408	17	11	397	0	241	109	9	13	3	7	6	0	9
서울특별시	마포구	공덕동	계	29632	16535	13097	425	16110	0	6997	7600	385	692	27	64	185	26	134
서울특별시	마포구	아현동	계	15081	8617	6464	129	8488	0	3975	3645	246	378	18	38	109	17	62
서울특별시	마포구	도화동	계	18796	11771	7025	194	11577	0	5596	4897	336	483	18	40	132	14	61
서울특별시	마포구	용강동	계	14476	9126	5350	135	8991	0	4098	4012	280	412	15	63	54	14	43
서울특별시	마포구	대흥동	계	12932	6844	6088	153	6691	0	2642	3220	206	361	17	96	61	21	67
서울특별시	마포구	염리동	계	12585	7046	5539	222	6824	0	2874	3161	241	279	18	73	81	16	81
서울특별시	마포구	신수동	계	16943	10208	6735	151	10057	0	4496	4529	320	455	26	75	72	12	72
서울특별시	마포구	서강동	계	19708	12061	7647	177	11884	0	4881	5388	452	790	19	140	134	19	61
서울특별시	마포구	서교동	계	24621	13411	11210	192	13219	0	4962	6240	549	938	23	172	249	24	62
서울특별시	마포구	합정동	계	16175	9385	6790	143	9242	0	3714	4285	333	546	15	129	136	14	70
서울특별시	마포구	망원1동	계	19314	11020	8294	183	10837	0	4155	5283	450	566	17	133	121	29	83
서울특별시	마포구	망원2동	계	16342	9700	6642	195	9505	0	3739	4659	340	491	19	59	113	19	66
서울특별시	마포구	연남동	계	16478	9492	6986	160	9332	0	3615	4389	353	664	8	97	151	14	41
서울특별시	마포구	성산1동	계	16890	9349	7541	163	9186	0	3518	4288	420	563	14	91	213	15	64
서울특별시	마포구	성산2동	계	30665	18917	11748	328	18589	0	7245	8807	774	1270	57	101	136	49	150
서울특별시	마포구	상암동	계	23761	15204	8557	238	14966	0	5823	7215	557	1076	25	79	88	25	78
서울특별시	양천구	관외사전투표		20581	20576	5	289	20287	0	8414	9951	611	753	35	138	123	46	216
서울특별시	양천구	거소우편투표		696	669	27	18	651	0	345	233	22	12	2	10	9	3	15
서울특별시	양천구	목1동	계	23258	14742	8516	225	14517	0	6828	6405	430	626	20	55	68	26	59
서울특별시	양천구	목2동	계	24773	14211	10562	230	13981	0	6016	6629	460	583	20	52	115	28	78
서울특별시	양천구	목3동	계	18287	10148	8139	162	9986	0	4514	4651	301	349	11	39	42	26	53
서울특별시	양천구	목4동	계	20661	11739	8922	196	11543	0	4875	5599	402	426	15	51	76	19	80
서울특별시	양천구	목5동	계	31576	20884	10692	305	20579	0	10513	8161	580	1015	21	71	137	13	68
서울특별시	양천구	신월1동	계	19536	9398	10138	154	9244	0	4106	4536	214	218	7	39	23	20	81
서울특별시	양천구	신월2동	계	17494	9806	7688	152	9654	0	4285	4617	281	254	8	68	34	21	86
서울특별시	양천구	신월3동	계	14098	6648	7450	140	6508	0	2835	3154	156	199	7	33	18	27	79
서울특별시	양천구	신월4동	계	15052	8664	6388	153	8511	0	3597	4270	216	250	7	51	22	21	77
서울특별시	양천구	신월5동	계	12851	6882	5969	96	6786	0	2981	3286	190	193	11	22	27	15	61
서울특별시	양천구	신월6동	계	9865	5261	4604	77	5184	0	2398	2397	119	136	7	50	16	14	47
서울특별시	양천구	신월7동	계	19409	10644	8765	160	10484	0	4626	5077	268	272	18	55	54	21	93
서울특별시	양천구	신정1동	계	13594	8748	4846	131	8617	0	4193	3650	238	397	6	32	54	12	35
서울특별시	양천구	신정2동	계	16348	9953	6395	128	9825	0	4251	4705	297	392	17	31	51	26	55
서울특별시	양천구	신정3동	계	41348	23561	17787	324	23237	0	9534	11584	776	796	31	228	98	51	139
서울특별시	양천구	신정4동	계	29570	16155	13415	238	15917	0	6603	7964	498	491	20	114	74	25	128
서울특별시	양천구	신정6동	계	18806	12698	6108	149	12549	0	5936	5424	421	564	17	31	92	16	48
서울특별시	양천구	신정7동	계	24582	15131	9451	228	14903	0	6962	6650	401	577	20	73	84	29	107
서울특별시	강서구	관외사전투표		22682	22635	47	309	22326	0	9068	11091	676	817	49	184	127	59	255
서울특별시	강서구	거소우편투표		774	739	35	33	706	0	394	243	12	13	4	11	4	4	21
서울특별시	강서구	염창동	계	30989	20035	10954	320	19715	0	8220	9617	615	906	19	110	91	36	101
서울특별시	강서구	등촌제1동	계	18434	10660	7774	132	10528	0	4367	5207	331	405	5	72	47	21	73
서울특별시	강서구	등촌제2동	계	17315	10447	6868	170	10277	0	4925	4493	275	370	11	54	61	18	70
서울특별시	강서구	등촌제3동	계	28991	17188	11803	349	16839	0	7573	7785	471	625	11	105	69	38	162
서울특별시	강서구	화곡본동	계	28656	14194	14462	182	14012	0	5353	7295	436	571	19	122	69	30	117
서울특별시	강서구	화곡제1동	계	42710	21024	21686	382	20642	0	8422	10422	660	712	23	142	73	42	146
서울특별시	강서구	화곡제2동	계	15685	7914	7771	126	7788	0	3101	4041	233	257	7	45	25	19	60
서울특별시	강서구	화곡제3동	계	19415	11536	7879	172	11364	0	5526	4924	312	380	11	66	46	24	75
서울특별시	강서구	화곡제4동	계	18677	9236	9441	152	9084	0	3863	4484	231	292	13	72	32	24	73
서울특별시	강서구	화곡제6동	계	20696	11517	9179	232	11285	0	5474	4904	289	389	8	50	58	21	92
서울특별시	강서구	화곡제8동	계	22259	11762	10497	163	11599	0	4546	6073	327	403	9	90	57	26	68
서울특별시	강서구	우장산동	계	28994	17055	11939	297	16758	0	7603	7642	520	689	17	103	73	22	89
서울특별시	강서구	가양제1동	계	17093	10567	6526	130	10437	0	4744	4732	313	434	11	73	46	26	58
서울특별시	강서구	가양제2동	계	15065	8627	6438	240	8387	0	4029	3667	193	271	13	61	44	21	88
서울특별시	강서구	가양제3동	계	15184	8986	6198	202	8784	0	3801	4128	263	361	14	67	37	27	86
서울특별시	강서구	발산제1동	계	23493	13897	9596	245	13652	0	5562	6809	472	523	10	95	61	22	98
서울특별시	강서구	공항동	계	17256	8385	8871	130	8255	0	3933	3703	198	242	13	46	35	21	64
서울특별시	강서구	방화제1동	계	23575	13258	10317	179	13079	0	6199	5825	354	434	20	79	45	30	93
서울특별시	강서구	방화제2동	계	20654	10872	9782	162	10710	0	5412	4478	266	313	19	64	43	25	90
서울특별시	강서구	방화제3동	계	21814	13149	8665	214	12935	0	6006	5824	359	441	11	95	64	28	107
서울특별시	구로구	관외사전투표		16165	16155	10	200	15955	0	6104	8216	485	672	25	146	100	35	172
서울특별시	구로구	거소우편투표		593	559	34	33	526	0	287	181	19	11	2	8	3	2	13
서울특별시	구로구	신도림동	계	28535	18919	9616	227	18692	0	8328	8641	597	797	27	106	79	30	87
서울특별시	구로구	구로제1동	계	17142	11101	6041	156	10945	0	4235	5618	459	447	9	52	46	23	56
서울특별시	구로구	구로제2동	계	26286	13061	13225	326	12735	0	5651	6011	372	353	21	84	52	42	149
서울특별시	구로구	구로제3동	계	22846	13058	9788	170	12888	0	4044	7421	436	684	17	103	49	33	101
서울특별시	구로구	구로제4동	계	21315	11126	10189	176	10950	0	4249	5728	308	378	12	91	47	43	94
서울특별시	구로구	구로제5동	계	26143	15403	10740	231	15172	0	6169	7522	547	651	18	87	54	23	101
서울특별시	구로구	가리봉동	계	11014	4592	6422	78	4514	0	2111	2093	99	98	3	31	17	8	54
서울특별시	구로구	고척제1동	계	19920	11579	8341	158	11421	0	5435	5028	277	483	13	56	34	18	77
서울특별시	구로구	고척제2동	계	23666	13509	10157	230	13279	0	5944	6118	322	590	23	91	58	31	102
서울특별시	구로구	개봉제1동	계	26124	14583	11541	215	14368	0	6769	6430	349	532	15	92	46	30	105
서울특별시	구로구	개봉제2동	계	27401	17131	10270	224	16907	0	7643	7911	414	610	22	113	51	31	112
서울특별시	구로구	개봉제3동	계	17470	9711	7759	143	9568	0	4203	4657	274	264	11	43	33	22	61
서울특별시	구로구	오류제1동	계	17185	9804	7381	152	9652	0	4637	4152	241	345	18	125	35	18	81
서울특별시	구로구	오류제2동	계	33499	20350	13149	263	20087	0	8799	9312	562	820	23	327	80	30	134
서울특별시	구로구	수궁동	계	20106	11964	8142	192	11772	0	5916	4812	272	421	14	178	33	29	97
서울특별시	금천구	관외사전투표		9400	9397	3	154	9243	0	3404	4897	309	340	13	72	58	34	116
서울특별시	금천구	거소우편투표		343	325	18	12	313	0	164	121	5	6	1	6	1	1	8
서울특별시	금천구	가산동	계	16954	8756	8198	123	8633	0	3197	4639	242	376	14	39	33	32	61
서울특별시	금천구	독산제1동	계	25724	13771	11953	171	13600	0	5582	6791	379	531	16	79	46	27	149
서울특별시	금천구	독산제2동	계	17880	8731	9149	200	8531	0	3644	4149	249	274	12	57	24	24	98
서울특별시	금천구	독산제3동	계	23062	11336	11726	329	11007	0	4718	5362	312	336	39	56	31	23	130
서울특별시	금천구	독산제4동	계	15164	7613	7551	292	7321	0	3125	3600	199	216	19	48	19	21	74
서울특별시	금천구	시흥제1동	계	29163	15465	13698	442	15023	0	6724	7080	391	471	21	112	50	44	130
서울특별시	금천구	시흥제2동	계	18954	11985	6969	193	11792	0	5121	5566	366	445	17	77	64	26	110
서울특별시	금천구	시흥제3동	계	10353	6044	4309	101	5943	0	2730	2747	152	163	5	50	15	9	72
서울특별시	금천구	시흥제4동	계	18898	10089	8809	246	9843	0	4335	4693	253	291	16	52	61	27	115
서울특별시	금천구	시흥제5동	계	18540	10112	8428	242	9870	0	4467	4599	235	279	15	91	28	24	132
서울특별시	영등포구	관외사전투표		15618	15585	33	217	15368	0	6053	7730	552	651	28	105	90	33	126
서울특별시	영등포구	거소우편투표		475	461	14	10	451	0	261	144	19	9	1	5	2	2	8
서울특별시	영등포구	영등포본동	계	19844	11276	8568	200	11076	0	4912	5155	362	435	7	52	40	22	91
서울특별시	영등포구	영등포동	계	16264	7733	8531	134	7599	0	3515	3509	171	258	8	46	27	11	54
서울특별시	영등포구	여의동	계	26822	16320	10502	219	16101	0	10260	4668	373	580	19	45	95	14	47
서울특별시	영등포구	당산제1동	계	16895	9830	7065	174	9656	0	4349	4377	262	472	12	60	49	12	63
서울특별시	영등포구	당산제2동	계	28100	17582	10518	211	17371	0	7699	7930	548	801	22	151	119	16	85
서울특별시	영등포구	도림동	계	16392	8678	7714	158	8520	0	3544	4212	259	337	13	37	29	17	72
서울특별시	영등포구	문래동	계	24896	16066	8830	191	15875	0	7087	7234	510	789	13	63	97	22	60
서울특별시	영등포구	양평제1동	계	13531	8148	5383	135	8013	0	3273	3849	272	416	12	65	39	31	56
서울특별시	영등포구	양평제2동	계	17059	10747	6312	155	10592	0	4173	5234	344	634	17	87	41	14	48
서울특별시	영등포구	신길제1동	계	17209	8951	8258	161	8790	0	3921	4048	280	301	34	46	39	30	91
서울특별시	영등포구	신길제3동	계	13069	7087	5982	140	6947	0	3294	3103	186	202	7	18	26	24	87
서울특별시	영등포구	신길제4동	계	10202	5378	4824	97	5281	0	2479	2349	188	158	6	22	20	16	43
서울특별시	영등포구	신길제5동	계	12859	6645	6214	125	6520	0	3011	3005	176	172	14	31	26	16	69
서울특별시	영등포구	신길제6동	계	18241	10217	8024	182	10035	0	4401	4609	390	430	18	54	33	17	83
서울특별시	영등포구	신길제7동	계	11400	6761	4639	108	6653	0	3444	2709	207	207	9	16	24	4	33
서울특별시	영등포구	대림제1동	계	13553	6975	6578	155	6820	0	2996	3233	230	198	13	35	21	19	75
서울특별시	영등포구	대림제2동	계	14320	6802	7518	155	6647	0	2871	3164	192	243	10	31	27	25	84
서울특별시	영등포구	대림제3동	계	22517	12704	9813	243	12461	0	5221	6080	373	552	24	48	43	30	90
서울특별시	동작구	관외사전투표		18467	18459	8	263	18196	0	6937	9402	571	832	23	149	108	37	137
서울특별시	동작구	거소우편투표		531	502	29	20	482	0	261	182	8	13	1	5	4	2	6
서울특별시	동작구	노량진제1동	계	26802	16470	10332	292	16178	0	7223	7375	432	788	17	140	70	31	102
서울특별시	동작구	노량진제2동	계	12681	6709	5972	125	6584	0	2869	3123	188	240	7	57	23	23	54
서울특별시	동작구	상도제1동	계	37495	22916	14579	350	22566	0	9692	10731	593	1151	22	121	125	25	106
서울특별시	동작구	상도제2동	계	20445	12068	8377	190	11878	0	5303	5509	321	485	16	95	61	15	73
서울특별시	동작구	상도제3동	계	20202	11674	8528	224	11450	0	4615	5895	319	389	17	52	72	17	74
서울특별시	동작구	상도제4동	계	23196	12473	10723	190	12283	0	5146	6103	289	452	20	126	62	17	68
서울특별시	동작구	흑석동	계	30332	17945	12387	354	17591	0	8418	7527	465	757	33	173	101	19	98
서울특별시	동작구	사당제1동	계	19801	11172	8629	172	11000	0	4063	5854	328	503	17	92	68	20	55
서울특별시	동작구	사당제2동	계	25466	15783	9683	253	15530	0	6998	7152	378	678	24	119	70	33	78
서울특별시	동작구	사당제3동	계	21173	13196	7977	202	12994	0	5754	6120	346	534	10	58	71	27	74
서울특별시	동작구	사당제4동	계	12323	7386	4937	111	7275	0	2840	3814	197	280	9	35	37	14	49
서울특별시	동작구	사당제5동	계	12103	7285	4818	118	7167	0	2760	3708	229	326	10	39	40	13	42
서울특별시	동작구	대방동	계	30331	18296	12035	251	18045	0	7936	8465	475	819	21	86	96	25	122
서울특별시	동작구	신대방제1동	계	19877	12137	7740	168	11969	0	5410	5470	397	485	15	51	62	18	61
서울특별시	동작구	신대방제2동	계	16281	9588	6693	121	9467	0	4170	4433	286	398	18	31	52	28	51
서울특별시	관악구	관외사전투표		21886	21883	3	319	21564	0	6856	11706	902	1400	60	221	199	49	171
서울특별시	관악구	거소우편투표		580	536	44	21	515	0	263	197	14	10	1	10	5	3	12
서울특별시	관악구	보라매동	계	21370	11763	9607	188	11575	0	4821	5626	370	503	11	86	54	26	78
서울특별시	관악구	은천동	계	28547	16591	11956	293	16298	0	6136	8248	591	975	19	92	76	36	125
서울특별시	관악구	성현동	계	26456	16342	10114	308	16034	0	6500	7806	677	756	15	94	63	28	95
서울특별시	관악구	중앙동	계	12595	6675	5920	100	6575	0	2278	3637	227	272	7	66	39	9	40
서울특별시	관악구	청림동	계	12949	8339	4610	147	8192	0	3201	3995	335	510	12	42	51	10	36
서울특별시	관악구	행운동	계	24572	13922	10650	268	13654	0	4749	7189	577	778	19	116	108	29	89
서울특별시	관악구	청룡동	계	27878	15355	12523	252	15103	0	5029	8351	541	814	20	139	94	25	90
서울특별시	관악구	낙성대동	계	14746	8526	6220	134	8392	0	2670	4433	323	729	7	79	96	20	35
서울특별시	관악구	인헌동	계	22931	13080	9851	220	12860	0	4472	6530	550	996	16	100	113	19	64
서울특별시	관악구	남현동	계	14970	8891	6079	152	8739	0	3694	4150	270	468	9	55	45	12	36
서울특별시	관악구	신림동	계	17526	8356	9170	130	8226	0	2505	4685	330	515	10	73	39	17	52
서울특별시	관악구	신사동	계	20521	10303	10218	221	10082	0	3908	5139	408	434	9	62	40	20	62
서울특별시	관악구	조원동	계	15517	8062	7455	139	7923	0	3205	3947	317	280	6	51	27	21	69
서울특별시	관악구	미성동	계	26994	15313	11681	377	14936	0	6632	6841	608	522	22	96	60	41	114
서울특별시	관악구	난곡동	계	24643	12616	12027	228	12388	0	5305	5910	493	405	15	94	50	27	89
서울특별시	관악구	난향동	계	13322	7793	5529	141	7652	0	3070	3689	337	403	6	57	35	10	45
서울특별시	관악구	서원동	계	20057	10487	9570	209	10278	0	3723	5304	407	534	17	172	56	15	50
서울특별시	관악구	신원동	계	16094	8437	7657	229	8208	0	3280	4026	304	360	9	125	38	13	53
서울특별시	관악구	서림동	계	20287	11216	9071	253	10963	0	4097	5268	407	827	18	170	88	22	66
서울특별시	관악구	삼성동	계	23359	13664	9695	290	13374	0	5606	6098	504	858	24	91	54	34	105
서울특별시	관악구	대학동	계	19928	11313	8615	156	11157	0	3710	5332	474	1301	9	139	121	15	56
서울특별시	서초구	관외사전투표		18672	18666	6	241	18425	0	9351	7569	422	667	21	120	121	22	132
서울특별시	서초구	거소우편투표		437	418	19	21	397	0	253	102	10	16	1	7	2	0	6
서울특별시	서초구	서초1동	계	16844	9876	6968	202	9674	0	5527	3433	221	338	9	43	60	14	29
서울특별시	서초구	서초2동	계	17493	10626	6867	138	10488	0	6217	3542	236	307	15	53	64	7	47
서울특별시	서초구	서초3동	계	24259	14161	10098	230	13931	0	8162	4803	265	482	19	67	61	14	58
서울특별시	서초구	서초4동	계	20716	12550	8166	168	12382	0	8044	3617	210	348	8	39	82	6	28
서울특별시	서초구	잠원동	계	26260	15329	10931	309	15020	0	8775	5085	354	551	21	61	84	21	68
서울특별시	서초구	반포본동	계	9554	6224	3330	102	6122	0	3898	1756	128	245	8	27	37	1	22
서울특별시	서초구	반포1동	계	26297	13771	12526	222	13549	0	7680	4927	309	437	22	53	68	8	45
서울특별시	서초구	반포2동	계	14198	9039	5159	146	8893	0	5660	2709	145	255	8	33	43	10	30
서울특별시	서초구	반포3동	계	17776	11033	6743	215	10818	0	6536	3470	273	355	13	50	58	8	55
서울특별시	서초구	반포4동	계	15476	9198	6278	218	8980	0	5219	3043	225	341	12	44	51	14	31
서울특별시	서초구	방배본동	계	16701	9988	6713	150	9838	0	5713	3476	189	286	11	59	51	9	44
서울특별시	서초구	방배1동	계	13851	8202	5649	129	8073	0	4207	3175	223	303	14	48	53	15	35
서울특별시	서초구	방배2동	계	22564	13635	8929	245	13390	0	6499	5761	388	446	19	82	95	19	81
서울특별시	서초구	방배3동	계	20004	12308	7696	230	12078	0	6961	4140	306	409	15	77	90	16	64
서울특별시	서초구	방배4동	계	19785	11857	7928	187	11670	0	6218	4553	265	423	16	54	56	12	73
서울특별시	서초구	양재1동	계	34607	20831	13776	272	20559	0	9559	9074	556	987	23	123	119	26	92
서울특별시	서초구	양재2동	계	18197	9959	8238	118	9841	0	4215	4739	276	442	10	49	38	15	57
서울특별시	서초구	내곡동	계	4885	2644	2241	44	2600	0	1614	796	51	72	6	17	5	5	34
서울특별시	강남구	관외사전투표		24513	24502	11	312	24190	0	12560	9749	545	795	38	137	118	41	207
서울특별시	강남구	거소우편투표		632	605	27	26	579	0	373	163	9	11	0	5	5	1	12
서울특별시	강남구	신사동	계	15645	8519	7126	112	8407	0	5522	2416	122	216	6	31	45	7	42
서울특별시	강남구	논현1동	계	22442	9226	13216	104	9122	0	4617	3789	215	314	10	67	36	18	56
서울특별시	강남구	논현2동	계	18522	8739	9783	113	8626	0	4969	3028	155	302	13	41	57	11	50
서울특별시	강남구	압구정동	계	22427	13023	9404	160	12863	0	9849	2472	127	265	19	33	42	10	46
서울특별시	강남구	청담동	계	24785	13325	11460	162	13163	0	8605	3827	184	330	9	48	64	20	76
서울특별시	강남구	삼성1동	계	12128	6847	5281	71	6776	0	4315	2032	123	201	7	27	34	4	33
서울특별시	강남구	삼성2동	계	24500	13005	11495	159	12846	0	7282	4608	246	490	12	74	63	13	58
서울특별시	강남구	대치1동	계	13893	8642	5251	109	8533	0	5822	2216	126	252	5	27	52	5	28
서울특별시	강남구	대치2동	계	31549	19491	12058	254	19237	0	12151	5853	344	609	26	76	103	17	58
서울특별시	강남구	대치4동	계	17466	8203	9263	106	8097	0	4035	3431	191	288	10	51	35	17	39
서울특별시	강남구	역삼1동	계	30611	12426	18185	181	12245	0	5909	5361	269	496	19	69	55	13	54
서울특별시	강남구	역삼2동	계	26519	14068	12451	163	13905	0	7779	5151	273	477	13	61	60	20	71
서울특별시	강남구	도곡1동	계	17662	10783	6879	147	10636	0	6212	3708	179	378	13	50	49	9	38
서울특별시	강남구	도곡2동	계	26320	15791	10529	213	15578	0	11050	3743	198	368	17	55	68	10	69
서울특별시	강남구	개포1동	계	17958	11058	6900	160	10898	0	6315	3824	237	312	14	68	48	17	63
서울특별시	강남구	개포2동	계	24964	15255	9709	213	15042	0	7896	5914	394	601	15	69	65	18	70
서울특별시	강남구	개포4동	계	18253	9893	8360	127	9766	0	4753	4216	259	354	6	49	46	16	67
서울특별시	강남구	일원본동	계	16636	10799	5837	173	10626	0	5714	4050	228	448	17	58	59	13	39
서울특별시	강남구	일원1동	계	14598	8349	6249	162	8187	0	3963	3531	212	260	11	62	31	30	87
서울특별시	강남구	일원2동	계	14507	9235	5272	179	9056	0	4583	3724	208	345	11	60	36	15	74
서울특별시	강남구	수서동	계	13944	8077	5867	215	7862	0	4095	3165	147	255	22	48	34	21	75
서울특별시	강남구	세곡동	계	17060	10056	7004	183	9873	0	4647	4379	285	357	11	68	32	20	74
서울특별시	송파구	관외사전투표		26223	26217	6	394	25823	0	11570	12032	674	859	56	155	139	102	236
서울특별시	송파구	거소우편투표		703	680	23	23	657	0	374	204	17	31	3	5	2	2	19
서울특별시	송파구	풍납1동	계	15112	8041	7071	203	7838	0	3617	3552	216	290	15	29	29	22	68
서울특별시	송파구	풍납2동	계	21797	13088	8709	400	12688	0	5655	5857	393	603	17	31	54	22	56
서울특별시	송파구	거여1동	계	11843	6677	5166	93	6584	0	3367	2787	154	159	8	18	27	20	44
서울특별시	송파구	거여2동	계	21181	11863	9318	282	11581	0	5364	5280	333	365	14	44	49	26	106
서울특별시	송파구	마천1동	계	18082	9503	8579	184	9319	0	4349	4281	268	227	12	35	33	33	81
서울특별시	송파구	마천2동	계	17437	9071	8366	160	8911	0	4046	4247	205	214	12	40	21	29	97
서울특별시	송파구	방이1동	계	12799	7851	4948	100	7751	0	3943	3244	186	242	4	45	34	13	40
서울특별시	송파구	방이2동	계	21040	11044	9996	168	10876	0	4640	5296	300	381	11	84	60	43	61
서울특별시	송파구	오륜동	계	14801	9944	4857	129	9815	0	6019	3138	206	304	7	36	55	15	35
서울특별시	송파구	오금동	계	29715	17246	12469	279	16967	0	8624	7029	468	550	13	57	73	51	102
서울특별시	송파구	송파1동	계	21992	12335	9657	200	12135	0	5285	5901	313	423	11	65	43	28	66
서울특별시	송파구	송파2동	계	17270	10867	6403	165	10702	0	5592	4380	238	309	7	62	48	19	47
서울특별시	송파구	석촌동	계	28313	14709	13604	207	14502	0	6012	7283	382	536	14	81	53	37	104
서울특별시	송파구	삼전동	계	28101	14530	13571	261	14269	0	5758	7311	494	473	10	47	57	41	78
서울특별시	송파구	가락본동	계	22780	12858	9922	178	12680	0	6151	5581	319	447	20	47	42	24	49
서울특별시	송파구	가락1동	계	1142	467	675	15	452	0	188	221	17	18	0	1	1	1	5
서울특별시	송파구	가락2동	계	26511	16350	10161	190	16160	0	7883	7108	447	471	19	49	58	40	85
서울특별시	송파구	문정1동	계	17698	10279	7419	122	10157	0	5267	4156	256	319	9	29	38	24	59
서울특별시	송파구	문정2동	계	14953	9588	5365	137	9451	0	5946	2974	159	238	11	33	46	11	33
서울특별시	송파구	장지동	계	33300	19568	13732	271	19297	0	7798	9859	589	735	23	67	67	55	104
서울특별시	송파구	잠실본동	계	25070	12610	12460	229	12381	0	5347	5990	377	460	10	27	49	38	83
서울특별시	송파구	잠실2동	계	25623	15933	9690	287	15646	0	7947	6502	445	570	13	37	65	19	48
서울특별시	송파구	잠실3동	계	27870	17962	9908	264	17698	0	10680	5807	381	594	13	53	73	29	68
서울특별시	송파구	잠실4동	계	23502	15567	7935	303	15264	0	8319	5690	355	698	16	43	65	25	53
서울특별시	송파구	잠실6동	계	13935	8926	5009	167	8759	0	5158	2954	189	330	10	29	51	9	29
서울특별시	송파구	잠실7동	계	8308	5612	2696	88	5524	0	3773	1425	85	155	8	17	26	8	27
서울특별시	강동구	관외사전투표		19011	19002	9	241	18761	0	7878	9160	530	700	36	101	109	48	199
서울특별시	강동구	거소우편투표		695	673	22	59	614	0	321	222	15	15	9	14	3	2	13
서울특별시	강동구	강일동	계	23923	14714	9209	233	14481	0	6083	7019	504	619	19	77	45	28	87
서울특별시	강동구	상일동	계	21118	12880	8238	228	12652	0	6474	5206	336	405	10	62	67	17	75
서울특별시	강동구	명일제1동	계	21246	13178	8068	226	12952	0	6716	5331	247	418	20	55	59	17	89
서울특별시	강동구	명일제2동	계	14131	9378	4753	135	9243	0	5130	3511	186	280	12	38	40	12	34
서울특별시	강동구	고덕제1동	계	12344	7512	4832	160	7352	0	3564	3206	212	264	5	22	24	11	44
서울특별시	강동구	고덕제2동	계	13876	7590	6286	198	7392	0	3661	3119	229	235	4	41	28	15	60
서울특별시	강동구	암사제1동	계	30423	15926	14497	276	15650	0	7226	7216	376	496	20	95	42	38	141
서울특별시	강동구	암사제2동	계	12523	7670	4853	100	7570	0	3214	3663	213	333	9	49	32	14	43
서울특별시	강동구	암사제3동	계	14082	9227	4855	138	9089	0	4539	3850	207	355	6	30	37	11	54
서울특별시	강동구	천호제1동	계	24774	12975	11799	206	12769	0	6135	5753	270	333	10	61	42	30	135
서울특별시	강동구	천호제2동	계	30464	15463	15001	287	15176	0	7062	6991	356	439	11	95	47	39	136
서울특별시	강동구	천호제3동	계	21577	10867	10710	186	10681	0	5041	4867	245	306	10	61	35	33	83
서울특별시	강동구	성내제1동	계	15036	8973	6063	148	8825	0	4033	4058	246	319	5	55	27	24	58
서울특별시	강동구	성내제2동	계	21799	11272	10527	215	11057	0	4961	5208	287	357	8	58	45	21	112
서울특별시	강동구	성내제3동	계	20295	11199	9096	160	11039	0	4903	5232	305	392	9	70	33	15	80
서울특별시	강동구	길동	계	40984	22395	18589	551	21844	0	10284	9945	513	694	15	123	66	53	151
서울특별시	강동구	둔촌제1동	계	15004	9813	5191	144	9669	0	5115	3762	259	355	13	59	44	8	54
서울특별시	강동구	둔촌제2동	계	23019	13484	9535	228	13256	0	6426	5795	335	428	16	89	52	28	87
부산광역시	중구	관외사전투표		1889	1887	2	45	1842	0	1001	633	92	65	0	23	28	0	0
부산광역시	중구	거소우편투표		76	74	2	12	62	0	43	12	3	1	0	1	2	0	0
부산광역시	중구	중앙동	계	1590	797	793	20	777	0	535	184	20	22	0	6	10	0	0
부산광역시	중구	동광동	계	3196	1640	1556	65	1575	0	1009	399	68	52	0	23	24	0	0
부산광역시	중구	대청동	계	6355	3435	2920	132	3303	0	2072	901	147	117	0	34	32	0	0
부산광역시	중구	보수동	계	9747	5423	4324	199	5224	0	3398	1350	195	150	0	79	52	0	0
부산광역시	중구	부평동	계	4617	2450	2167	70	2380	0	1703	523	62	59	0	14	19	0	0
부산광역시	중구	광복동	계	1243	658	585	19	639	0	450	146	15	19	0	2	7	0	0
부산광역시	중구	남포동	계	1217	591	626	17	574	0	413	117	15	22	0	3	4	0	0
부산광역시	중구	영주제1동	계	4445	2242	2203	77	2165	0	1355	577	110	68	0	31	24	0	0
부산광역시	중구	영주제2동	계	7493	4204	3289	115	4089	0	2604	1097	193	111	0	47	37	0	0
부산광역시	서구	관외사전투표		4125	4125	0	98	4027	0	1968	1535	230	170	0	65	59	0	0
부산광역시	서구	거소우편투표		430	407	23	41	366	0	209	69	22	27	0	25	14	0	0
부산광역시	서구	동대신제1동	계	4847	2693	2154	74	2619	0	1797	609	80	79	0	29	25	0	0
부산광역시	서구	동대신제2동	계	7625	4110	3515	118	3992	0	2660	964	155	142	0	43	28	0	0
부산광역시	서구	동대신제3동	계	6666	3627	3039	79	3548	0	2278	954	135	108	0	39	34	0	0
부산광역시	서구	서대신제1동	계	10152	5611	4541	165	5446	0	3502	1423	201	194	0	70	56	0	0
부산광역시	서구	서대신제3동	계	5576	3089	2487	76	3013	0	1943	755	146	100	0	38	31	0	0
부산광역시	서구	서대신제4동	계	6142	3694	2448	90	3604	0	2218	1027	152	123	0	42	42	0	0
부산광역시	서구	부민동	계	6338	3368	2970	84	3284	0	1963	1002	158	106	0	31	24	0	0
부산광역시	서구	아미동	계	8357	4004	4353	138	3866	0	2621	889	131	121	0	61	43	0	0
부산광역시	서구	초장동	계	5188	2428	2760	70	2358	0	1623	528	70	72	0	39	26	0	0
부산광역시	서구	충무동	계	7099	3598	3501	80	3518	0	2399	820	135	92	0	42	30	0	0
부산광역시	서구	남부민제1동	계	5207	2629	2578	70	2559	0	1698	660	83	74	0	26	18	0	0
부산광역시	서구	남부민제2동	계	10201	5140	5061	274	4866	0	3239	1188	164	151	0	71	53	0	0
부산광역시	서구	암남동	계	14741	7221	7520	335	6886	0	4509	1744	242	198	0	107	86	0	0
부산광역시	동구	관외사전투표		3459	3457	2	87	3370	0	1623	1359	175	118	0	53	42	0	0
부산광역시	동구	거소우편투표		209	197	12	18	179	0	125	34	5	5	0	3	7	0	0
부산광역시	동구	초량제1동	계	4760	2394	2366	74	2320	0	1457	622	89	96	0	35	21	0	0
부산광역시	동구	초량제2동	계	5764	2950	2814	84	2866	0	1964	675	101	77	0	29	20	0	0
부산광역시	동구	초량제3동	계	5384	2820	2564	83	2737	0	1684	791	107	82	0	36	37	0	0
부산광역시	동구	초량제6동	계	6667	3626	3041	132	3494	0	2357	781	121	137	0	54	44	0	0
부산광역시	동구	수정제1동	계	4497	2599	1898	108	2491	0	1576	687	87	90	0	26	25	0	0
부산광역시	동구	수정제2동	계	8401	4867	3534	208	4659	0	3020	1186	175	168	0	58	52	0	0
부산광역시	동구	수정제4동	계	4392	2452	1940	103	2349	0	1614	525	61	84	0	32	33	0	0
부산광역시	동구	수정제5동	계	5714	3256	2458	122	3134	0	2066	794	93	104	0	29	48	0	0
부산광역시	동구	좌천제1동	계	6800	3881	2919	131	3750	0	2382	1072	107	116	0	42	31	0	0
부산광역시	동구	좌천제4동	계	3573	2044	1529	60	1984	0	1243	570	76	50	0	25	20	0	0
부산광역시	동구	범일제1동	계	4018	2262	1756	59	2203	0	1335	671	73	70	0	34	20	0	0
부산광역시	동구	범일제2동	계	7373	3931	3442	114	3817	0	2409	1109	121	107	0	50	21	0	0
부산광역시	동구	범일제4동	계	8202	4569	3633	169	4400	0	2861	1149	132	143	0	69	46	0	0
부산광역시	동구	범일제5동	계	4137	2396	1741	96	2300	0	1481	609	85	65	0	33	27	0	0
부산광역시	영도구	관외사전투표		4784	4782	2	80	4702	0	2250	1892	284	156	0	62	58	0	0
부산광역시	영도구	거소우편투표		324	299	25	18	281	0	144	100	17	6	0	10	4	0	0
부산광역시	영도구	남항동	계	9548	4772	4776	125	4647	0	3044	1286	176	75	0	39	27	0	0
부산광역시	영도구	영선제1동	계	3810	1947	1863	46	1901	0	1070	670	101	33	0	18	9	0	0
부산광역시	영도구	영선제2동	계	8760	4685	4075	102	4583	0	2863	1372	197	84	0	42	25	0	0
부산광역시	영도구	신선동	계	10756	4857	5899	164	4693	0	2931	1372	205	91	0	54	40	0	0
부산광역시	영도구	봉래제1동	계	6345	3378	2967	79	3299	0	2000	986	191	66	0	34	22	0	0
부산광역시	영도구	봉래제2동	계	7443	3527	3916	127	3400	0	2172	886	196	86	0	32	28	0	0
부산광역시	영도구	청학제1동	계	6880	3288	3592	65	3223	0	1923	970	185	82	0	29	34	0	0
부산광역시	영도구	청학제2동	계	17280	8464	8816	241	8223	0	4738	2817	298	225	0	96	49	0	0
부산광역시	영도구	동삼제1동	계	25719	13041	12678	288	12753	0	7335	4422	482	293	0	133	88	0	0
부산광역시	영도구	동삼제2동	계	3435	1787	1648	47	1740	0	1103	534	50	34	0	14	5	0	0
부산광역시	영도구	동삼제3동	계	10860	5474	5386	184	5290	0	3178	1654	243	127	0	50	38	0	0
부산광역시	부산진구	관외사전투표		12865	12850	15	269	12581	0	5663	5481	639	468	0	183	147	0	0
부산광역시	부산진구	거소우편투표		673	639	34	38	601	0	354	164	28	27	0	12	16	0	0
부산광역시	부산진구	부전제1동	계	6156	2499	3657	61	2438	0	1589	706	57	50	0	18	18	0	0
부산광역시	부산진구	부전제2동	계	8497	3758	4739	91	3667	0	2141	1236	131	95	0	39	25	0	0
부산광역시	부산진구	범전동	계	5693	2901	2792	89	2812	0	1841	755	73	74	0	34	35	0	0
부산광역시	부산진구	연지동	계	19065	10961	8104	253	10708	0	6255	3628	347	315	0	92	71	0	0
부산광역시	부산진구	초읍동	계	20131	11070	9061	514	10556	0	6916	2868	328	264	0	97	83	0	0
부산광역시	부산진구	양정제1동	계	18190	10518	7672	326	10192	0	5846	3467	404	290	0	99	86	0	0
부산광역시	부산진구	양정제2동	계	13391	6579	6812	361	6218	0	3687	1973	241	210	0	63	44	0	0
부산광역시	부산진구	전포제1동	계	7971	3864	4107	127	3737	0	2370	1051	141	101	0	40	34	0	0
부산광역시	부산진구	전포제2동	계	18006	9547	8459	248	9299	0	5503	3006	336	263	0	134	57	0	0
부산광역시	부산진구	전포제3동	계	8564	4016	4548	126	3890	0	2385	1226	136	73	0	45	25	0	0
부산광역시	부산진구	부암제1동	계	16962	8591	8371	222	8369	0	4882	2863	288	212	0	66	58	0	0
부산광역시	부산진구	부암제3동	계	18928	10502	8426	269	10233	0	5369	4005	422	285	0	93	59	0	0
부산광역시	부산진구	당감제1동	계	22419	12228	10191	326	11902	0	6672	4235	437	332	0	130	96	0	0
부산광역시	부산진구	당감제2동	계	8601	5018	3583	162	4856	0	2811	1619	208	140	0	50	28	0	0
부산광역시	부산진구	당감제4동	계	10940	5599	5341	151	5448	0	2854	2097	268	161	0	49	19	0	0
부산광역시	부산진구	가야제1동	계	20369	9686	10683	550	9136	0	5282	2965	369	301	0	139	80	0	0
부산광역시	부산진구	가야제2동	계	14904	8413	6491	205	8208	0	4854	2646	276	289	0	86	57	0	0
부산광역시	부산진구	개금제1동	계	12337	6004	6333	131	5873	0	3297	2059	228	173	0	71	45	0	0
부산광역시	부산진구	개금제2동	계	10769	5820	4949	156	5664	0	3324	1811	207	205	0	74	43	0	0
부산광역시	부산진구	개금제3동	계	26452	15281	11171	385	14896	0	8231	5301	597	514	0	163	90	0	0
부산광역시	부산진구	범천제1동	계	8164	3885	4279	187	3698	0	2357	1086	87	109	0	38	21	0	0
부산광역시	부산진구	범천제2동	계	10856	5566	5290	429	5137	0	3069	1603	188	161	0	76	40	0	0
부산광역시	부산진구	범천제4동	계	8119	4237	3882	234	4003	0	2438	1214	126	124	0	73	28	0	0
부산광역시	동래구	관외사전투표		9875	9873	2	202	9671	0	4480	4083	469	356	0	152	131	0	0
부산광역시	동래구	거소우편투표		619	589	30	30	559	0	335	158	29	11	0	11	15	0	0
부산광역시	동래구	수민동	계	26164	14656	11508	358	14298	0	8224	4774	584	396	0	207	113	0	0
부산광역시	동래구	복산동	계	10846	5991	4855	166	5825	0	3849	1542	186	137	0	56	55	0	0
부산광역시	동래구	명륜동	계	14403	8178	6225	177	8001	0	4523	2713	311	284	0	105	65	0	0
부산광역시	동래구	온천제1동	계	16921	7985	8936	239	7746	0	4977	2177	265	213	0	67	47	0	0
부산광역시	동래구	온천제2동	계	17742	9932	7810	298	9634	0	6273	2575	373	233	0	92	88	0	0
부산광역시	동래구	온천제3동	계	28452	14972	13480	315	14657	0	8607	4775	640	376	0	153	106	0	0
부산광역시	동래구	사직제1동	계	7863	4239	3624	141	4098	0	2533	1214	146	116	0	54	35	0	0
부산광역시	동래구	사직제2동	계	20216	12333	7883	274	12059	0	6380	4540	491	404	0	156	88	0	0
부산광역시	동래구	사직제3동	계	11998	6337	5661	177	6160	0	3840	1823	195	177	0	73	52	0	0
부산광역시	동래구	안락제1동	계	13809	7377	6432	224	7153	0	4476	2095	229	201	0	105	47	0	0
부산광역시	동래구	안락제2동	계	24479	13945	10534	364	13581	0	7934	4442	526	373	0	214	92	0	0
부산광역시	동래구	명장제1동	계	13306	7014	6292	192	6822	0	4396	1889	212	145	0	140	40	0	0
부산광역시	동래구	명장제2동	계	12998	6994	6004	193	6801	0	4193	2084	237	134	0	84	69	0	0
부산광역시	남구	관외사전투표		9989	9984	5	192	9792	0	4471	4210	516	356	0	113	126	0	0
부산광역시	남구	거소우편투표		660	633	27	26	607	0	371	175	22	11	0	16	12	0	0
부산광역시	남구	대연제1동	계	18035	9289	8746	184	9105	0	5394	2965	347	208	0	121	70	0	0
부산광역시	남구	대연제3동	계	26841	14414	12427	321	14093	0	7325	5325	666	513	0	157	107	0	0
부산광역시	남구	대연제4동	계	10643	5895	4748	153	5742	0	3524	1772	224	120	0	65	37	0	0
부산광역시	남구	대연제5동	계	11852	6650	5202	126	6524	0	3802	2132	261	198	0	73	58	0	0
부산광역시	남구	대연제6동	계	7049	3931	3118	88	3843	0	2299	1234	139	99	0	40	32	0	0
부산광역시	남구	용호제1동	계	33677	19500	14177	461	19039	0	11101	6451	548	515	0	279	145	0	0
부산광역시	남구	용호제2동	계	15976	8843	7133	196	8647	0	5130	2900	258	213	0	78	68	0	0
부산광역시	남구	용호제3동	계	11946	6727	5219	170	6557	0	4056	2037	179	133	0	91	61	0	0
부산광역시	남구	용호제4동	계	7900	4291	3609	97	4194	0	2409	1440	142	125	0	47	31	0	0
부산광역시	남구	용당동	계	7353	3957	3396	103	3854	0	2182	1317	158	112	0	40	45	0	0
부산광역시	남구	감만제1동	계	13757	7435	6322	200	7235	0	4318	2326	295	157	0	87	52	0	0
부산광역시	남구	감만제2동	계	6597	3589	3008	132	3457	0	2172	1003	129	81	0	40	32	0	0
부산광역시	남구	문현제1동	계	13338	7024	6314	192	6832	0	4103	2183	220	199	0	76	51	0	0
부산광역시	남구	문현제2동	계	7520	3795	3725	105	3690	0	2427	976	106	107	0	45	29	0	0
부산광역시	남구	문현제3동	계	11943	6722	5221	164	6558	0	3870	2158	210	187	0	57	76	0	0
부산광역시	남구	문현제4동	계	9904	5292	4612	140	5152	0	3198	1552	160	132	0	55	55	0	0
부산광역시	남구	우암동	계	16197	9241	6956	260	8981	0	5585	2669	333	208	0	106	80	0	0
부산광역시	북구	관외사전투표		10089	10076	13	209	9867	0	4374	4278	601	314	0	165	135	0	0
부산광역시	북구	거소우편투표		625	597	28	29	568	0	322	168	24	18	0	20	16	0	0
부산광역시	북구	구포제1동	계	11156	5235	5921	136	5099	0	3238	1535	164	75	0	57	30	0	0
부산광역시	북구	구포제2동	계	23942	11908	12034	218	11690	0	6593	4237	454	200	0	130	76	0	0
부산광역시	북구	구포제3동	계	20347	9030	11317	162	8868	0	4981	3169	404	164	0	100	50	0	0
부산광역시	북구	금곡동	계	32666	18072	14594	470	17602	0	9892	6011	769	435	0	367	128	0	0
부산광역시	북구	화명제1동	계	31856	18618	13238	376	18242	0	9182	7370	909	472	0	184	125	0	0
부산광역시	북구	화명제2동	계	15101	8074	7027	150	7924	0	4212	2828	393	223	0	197	71	0	0
부산광역시	북구	화명제3동	계	23636	14574	9062	272	14302	0	7245	5690	653	451	0	157	106	0	0
부산광역시	북구	덕천제1동	계	14239	7400	6839	201	7199	0	4334	2292	260	149	0	101	63	0	0
부산광역시	북구	덕천제2동	계	12245	5843	6402	163	5680	0	3368	1831	232	126	0	81	42	0	0
부산광역시	북구	덕천제3동	계	11004	5591	5413	174	5417	0	3272	1687	193	122	0	93	50	0	0
부산광역시	북구	만덕제1동	계	9254	5175	4079	154	5021	0	2843	1779	199	100	0	66	34	0	0
부산광역시	북구	만덕제2동	계	17943	9554	8389	219	9335	0	5327	3310	328	223	0	96	51	0	0
부산광역시	북구	만덕제3동	계	17657	9985	7672	252	9733	0	5354	3590	387	212	0	120	70	0	0
부산광역시	해운대구	관외사전투표		15204	15182	22	358	14824	0	7023	6154	705	499	0	245	198	0	0
부산광역시	해운대구	거소우편투표		769	715	54	38	677	0	437	177	24	9	0	15	15	0	0
부산광역시	해운대구	우제1동	계	38301	19808	18493	632	19176	0	12043	5650	545	625	0	172	141	0	0
부산광역시	해운대구	우제2동	계	23033	12702	10331	296	12406	0	7137	4189	445	440	0	99	96	0	0
부산광역시	해운대구	중제1동	계	17366	8591	8775	268	8323	0	4978	2666	281	247	0	82	69	0	0
부산광역시	해운대구	중제2동	계	8975	3795	5180	78	3717	0	2279	1073	144	110	0	84	27	0	0
부산광역시	해운대구	좌제1동	계	14134	7754	6380	128	7626	0	3931	2897	327	227	0	164	80	0	0
부산광역시	해운대구	좌제2동	계	25798	14401	11397	332	14069	0	7466	5102	590	445	0	337	129	0	0
부산광역시	해운대구	좌제3동	계	13944	8262	5682	185	8077	0	4462	2832	313	228	0	172	70	0	0
부산광역시	해운대구	좌제4동	계	18886	11276	7610	227	11049	0	5808	4160	407	351	0	236	87	0	0
부산광역시	해운대구	송정동	계	8006	3684	4322	122	3562	0	2266	999	116	81	0	70	30	0	0
부산광역시	해운대구	반여제1동	계	32454	18930	13524	391	18539	0	9788	6992	852	569	0	208	130	0	0
부산광역시	해운대구	반여제2동	계	13429	6397	7032	307	6090	0	3779	1738	231	179	0	122	41	0	0
부산광역시	해운대구	반여제3동	계	9718	4761	4957	207	4554	0	2897	1257	155	123	0	78	44	0	0
부산광역시	해운대구	반여제4동	계	12843	7206	5637	155	7051	0	3810	2603	325	180	0	94	39	0	0
부산광역시	해운대구	반송제1동	계	8785	4131	4654	158	3973	0	2565	1082	196	52	0	53	25	0	0
부산광역시	해운대구	반송제2동	계	24703	12708	11995	363	12345	0	7715	3428	715	232	0	174	81	0	0
부산광역시	해운대구	반송제3동	계	7207	3387	3820	102	3285	0	2106	892	160	59	0	35	33	0	0
부산광역시	해운대구	재송제1동	계	23865	12595	11270	246	12349	0	6715	4516	524	400	0	95	99	0	0
부산광역시	해운대구	재송제2동	계	24660	11797	12863	322	11475	0	6596	3920	464	292	0	135	68	0	0
부산광역시	기장군	관외사전투표		4515	4514	1	95	4419	0	2170	1721	217	160	0	86	65	0	0
부산광역시	기장군	거소우편투표		350	325	25	17	308	0	207	55	14	12	0	11	9	0	0
부산광역시	기장군	기장읍	계	41567	23742	17825	881	22861	0	14559	6064	874	555	0	591	218	0	0
부산광역시	기장군	장안읍	계	7698	4569	3129	197	4372	0	2980	1053	129	100	0	74	36	0	0
부산광역시	기장군	일광면	계	7658	4502	3156	181	4321	0	3077	889	115	123	0	72	45	0	0
부산광역시	기장군	철마면	계	6241	3663	2578	127	3536	0	2288	842	144	108	0	108	46	0	0
부산광역시	기장군	정관면	계	39331	21414	17917	533	20881	0	9626	8747	992	1070	0	309	137	0	0
부산광역시	사하구	관외사전투표		10559	10559	0	232	10327	0	4818	4364	519	369	0	130	127	0	0
부산광역시	사하구	거소우편투표		873	808	65	62	746	0	393	235	38	35	0	23	22	0	0
부산광역시	사하구	괴정제1동	계	16827	9082	7745	174	8908	0	5613	2627	290	260	0	75	43	0	0
부산광역시	사하구	괴정제2동	계	13251	6838	6413	174	6664	0	4050	2086	225	196	0	66	41	0	0
부산광역시	사하구	괴정제3동	계	11836	5952	5884	170	5782	0	3634	1698	187	150	0	69	44	0	0
부산광역시	사하구	괴정제4동	계	12936	6674	6262	158	6516	0	4076	1935	183	189	0	86	47	0	0
부산광역시	사하구	당리동	계	24896	13387	11509	292	13095	0	7372	4666	517	339	0	126	75	0	0
부산광역시	사하구	하단제1동	계	18930	9873	9057	233	9640	0	5382	3448	422	231	0	98	59	0	0
부산광역시	사하구	하단제2동	계	21911	11186	10725	222	10964	0	5908	4129	432	310	0	116	69	0	0
부산광역시	사하구	신평제1동	계	15655	7235	8420	192	7043	0	4271	2248	238	161	0	83	42	0	0
부산광역시	사하구	신평제2동	계	12682	6603	6079	107	6496	0	3630	2277	262	220	0	60	47	0	0
부산광역시	사하구	구평동	계	5955	3183	2772	76	3107	0	1827	993	95	137	0	37	18	0	0
부산광역시	사하구	감천제1동	계	19464	10204	9260	225	9979	0	5937	3202	386	288	0	106	60	0	0
부산광역시	사하구	감천제2동	계	7782	3834	3948	130	3704	0	2427	1031	97	59	0	59	31	0	0
부산광역시	사하구	장림제1동	계	11203	5377	5826	133	5244	0	3000	1858	168	125	0	68	25	0	0
부산광역시	사하구	장림제2동	계	23417	11329	12088	219	11110	0	6294	3991	364	269	0	126	66	0	0
부산광역시	사하구	다대제1동	계	34654	17939	16715	395	17544	0	9697	6543	539	466	0	192	107	0	0
부산광역시	사하구	다대제2동	계	22488	12060	10428	264	11796	0	6935	4041	348	276	0	138	58	0	0
부산광역시	금정구	관외사전투표		9036	9033	3	165	8868	0	4200	3554	540	320	0	133	121	0	0
부산광역시	금정구	거소우편투표		447	432	15	16	416	0	267	107	14	7	0	10	11	0	0
부산광역시	금정구	서제1동	계	7466	3549	3917	179	3370	0	2244	850	134	70	0	42	30	0	0
부산광역시	금정구	서제2동	계	10780	5428	5352	165	5263	0	3371	1442	238	112	0	66	34	0	0
부산광역시	금정구	서제3동	계	11260	5788	5472	175	5613	0	3599	1550	226	124	0	75	39	0	0
부산광역시	금정구	금사동	계	8338	4139	4199	140	3999	0	2626	1047	163	88	0	51	24	0	0
부산광역시	금정구	부곡제1동	계	8946	4644	4302	153	4491	0	2941	1156	208	93	0	52	41	0	0
부산광역시	금정구	부곡제2동	계	14565	8264	6301	209	8055	0	4644	2644	384	223	0	92	68	0	0
부산광역시	금정구	부곡제3동	계	14228	8399	5829	225	8174	0	4773	2599	384	243	0	92	83	0	0
부산광역시	금정구	부곡제4동	계	12667	6738	5929	268	6470	0	3981	1889	324	147	0	72	57	0	0
부산광역시	금정구	장전제1동	계	14198	7494	6704	183	7311	0	3743	2602	461	288	0	129	88	0	0
부산광역시	금정구	장전제2동	계	11984	6935	5049	151	6784	0	3684	2397	349	228	0	58	68	0	0
부산광역시	금정구	장전제3동	계	6004	2871	3133	85	2786	0	1759	757	136	64	0	34	36	0	0
부산광역시	금정구	선두구동	계	2308	1282	1026	75	1207	0	914	223	36	20	0	6	8	0	0
부산광역시	금정구	청룡노포동	계	8701	4836	3865	169	4667	0	3006	1218	194	135	0	57	57	0	0
부산광역시	금정구	남산동	계	27063	14401	12662	365	14036	0	8622	3977	736	367	0	200	134	0	0
부산광역시	금정구	구서제1동	계	14843	8235	6608	206	8029	0	4630	2567	417	279	0	76	60	0	0
부산광역시	금정구	구서제2동	계	28317	16936	11381	458	16478	0	9680	5106	849	513	0	175	155	0	0
부산광역시	금정구	금성동	계	987	679	308	32	647	0	421	142	44	14	0	14	12	0	0
부산광역시	강서구	관외사전투표		2699	2699	0	64	2635	0	1304	1043	127	83	0	43	35	0	0
부산광역시	강서구	거소우편투표		137	129	8	10	119	0	73	29	8	3	0	1	5	0	0
부산광역시	강서구	대저1동	계	7683	4130	3553	172	3958	0	2541	1049	127	97	0	92	52	0	0
부산광역시	강서구	대저2동	계	7217	4284	2933	141	4143	0	2542	1217	178	93	0	61	52	0	0
부산광역시	강서구	강동동	계	6002	3432	2570	148	3284	0	2083	873	126	112	0	48	42	0	0
부산광역시	강서구	명지동	계	20280	11927	8353	271	11656	0	6143	4419	484	369	0	136	105	0	0
부산광역시	강서구	가락동	계	2404	1372	1032	48	1324	0	840	359	39	44	0	29	13	0	0
부산광역시	강서구	녹산동	계	10741	5433	5308	234	5199	0	3128	1614	176	165	0	65	51	0	0
부산광역시	강서구	천가동	계	2595	1596	999	119	1477	0	1026	307	37	58	0	34	15	0	0
부산광역시	연제구	관외사전투표		7358	7350	8	174	7176	0	3310	2917	447	273	0	128	101	0	0
부산광역시	연제구	거소우편투표		365	346	19	12	334	0	213	80	21	8	0	8	4	0	0
부산광역시	연제구	거제제1동	계	22253	13750	8503	305	13445	0	7246	4746	657	522	0	151	123	0	0
부산광역시	연제구	거제제2동	계	13381	7593	5788	158	7435	0	4365	2348	298	270	0	82	72	0	0
부산광역시	연제구	거제제3동	계	9317	5498	3819	137	5361	0	3404	1499	192	178	0	53	35	0	0
부산광역시	연제구	거제제4동	계	8913	4863	4050	124	4739	0	2807	1480	210	122	0	67	53	0	0
부산광역시	연제구	연산제1동	계	13331	7499	5832	218	7281	0	4296	2146	375	302	0	94	68	0	0
부산광역시	연제구	연산제2동	계	12613	6911	5702	219	6692	0	4217	1852	267	209	0	91	56	0	0
부산광역시	연제구	연산제3동	계	9310	4886	4424	155	4731	0	2969	1229	203	180	0	73	77	0	0
부산광역시	연제구	연산제4동	계	14579	7838	6741	223	7615	0	4808	2099	304	255	0	97	52	0	0
부산광역시	연제구	연산제5동	계	10537	4962	5575	126	4836	0	2882	1463	234	139	0	61	57	0	0
부산광역시	연제구	연산제6동	계	14136	7470	6666	251	7219	0	4559	1917	285	266	0	87	105	0	0
부산광역시	연제구	연산제8동	계	8802	4534	4268	114	4420	0	2785	1139	270	133	0	55	38	0	0
부산광역시	연제구	연산제9동	계	29512	16249	13263	328	15921	0	9271	4628	1114	568	0	202	138	0	0
부산광역시	수영구	관외사전투표		6157	6152	5	148	6004	0	2852	2446	302	209	0	88	107	0	0
부산광역시	수영구	거소우편투표		374	355	19	13	342	0	228	78	12	12	0	5	7	0	0
부산광역시	수영구	남천제1동	계	11987	6593	5394	139	6454	0	3991	1915	205	194	0	76	73	0	0
부산광역시	수영구	남천제2동	계	11288	6324	4964	160	6164	0	3759	1914	192	190	0	48	61	0	0
부산광역시	수영구	수영동	계	13922	7799	6123	203	7596	0	4898	2098	250	195	0	89	66	0	0
부산광역시	수영구	망미제1동	계	23944	12872	11072	295	12577	0	8015	3501	462	365	0	131	103	0	0
부산광역시	수영구	망미제2동	계	10824	5617	5207	136	5481	0	3221	1726	260	172	0	61	41	0	0
부산광역시	수영구	광안제1동	계	20125	10805	9320	336	10469	0	6204	3329	417	300	0	128	91	0	0
부산광역시	수영구	광안제2동	계	13187	6743	6444	159	6584	0	4011	1993	231	213	0	79	57	0	0
부산광역시	수영구	광안제3동	계	9126	4478	4648	146	4332	0	2701	1267	154	116	0	55	39	0	0
부산광역시	수영구	광안제4동	계	11760	6339	5421	233	6106	0	3629	1927	208	180	0	84	78	0	0
부산광역시	수영구	민락동	계	17281	8847	8434	205	8642	0	5456	2457	296	268	0	91	74	0	0
부산광역시	사상구	관외사전투표		7462	7458	4	140	7318	0	3317	3256	333	208	0	120	84	0	0
부산광역시	사상구	거소우편투표		499	471	28	27	444	0	260	129	21	10	0	16	8	0	0
부산광역시	사상구	삼락동	계	6458	3035	3423	124	2911	0	1710	1006	78	51	0	47	19	0	0
부산광역시	사상구	모라제1동	계	25823	14019	11804	349	13670	0	7788	4863	487	287	0	164	81	0	0
부산광역시	사상구	모라제3동	계	12104	6603	5501	248	6355	0	3938	1999	180	121	0	68	49	0	0
부산광역시	사상구	덕포제1동	계	10552	5423	5129	162	5261	0	2988	1903	161	95	0	79	35	0	0
부산광역시	사상구	덕포제2동	계	12380	6585	5795	154	6431	0	3550	2388	195	146	0	95	57	0	0
부산광역시	사상구	괘법동	계	18403	8954	9449	232	8722	0	4934	3198	251	169	0	107	63	0	0
부산광역시	사상구	감전동	계	12416	6208	6208	169	6039	0	3807	1863	167	102	0	59	41	0	0
부산광역시	사상구	주례제1동	계	13640	7265	6375	156	7109	0	4161	2403	220	192	0	87	46	0	0
부산광역시	사상구	주례제2동	계	21008	11149	9859	225	10924	0	5996	4065	379	302	0	122	60	0	0
부산광역시	사상구	주례제3동	계	12663	7137	5526	145	6992	0	3859	2552	265	178	0	89	49	0	0
부산광역시	사상구	학장동	계	26573	14680	11893	318	14362	0	8044	5264	476	329	0	162	87	0	0
부산광역시	사상구	엄궁동	계	25655	13557	12098	233	13324	0	7167	5093	498	325	0	165	76	0	0
대구광역시	중구	관외사전투표		2475	2472	3	61	2411	0	1472	743	78	83	0	0	35	0	0
대구광역시	중구	거소우편투표		114	109	5	8	101	0	86	11	1	1	0	0	2	0	0
대구광역시	중구	동인동	계	8829	4492	4337	214	4278	0	3181	857	85	102	0	0	53	0	0
대구광역시	중구	삼덕동	계	5473	2647	2826	56	2591	0	1683	714	67	88	0	0	39	0	0
대구광역시	중구	성내1동	계	3985	1921	2064	39	1882	0	1348	431	31	50	0	0	22	0	0
대구광역시	중구	성내2동	계	4511	2175	2336	33	2142	0	1652	391	34	43	0	0	22	0	0
대구광역시	중구	성내3동	계	3376	1702	1674	32	1670	0	1337	244	30	38	0	0	21	0	0
대구광역시	중구	대신동	계	4086	2134	1952	40	2094	0	1648	346	39	38	0	0	23	0	0
대구광역시	중구	남산1동	계	3539	1772	1767	41	1731	0	1311	331	26	45	0	0	18	0	0
대구광역시	중구	남산2동	계	4150	2153	1997	45	2108	0	1632	380	33	40	0	0	23	0	0
대구광역시	중구	남산3동	계	4617	2360	2257	53	2307	0	1689	459	37	52	0	0	70	0	0
대구광역시	중구	남산4동	계	11197	6398	4799	122	6276	0	4596	1328	121	153	0	0	78	0	0
대구광역시	중구	대봉1동	계	6195	3506	2689	131	3375	0	2459	758	55	78	0	0	25	0	0
대구광역시	중구	대봉2동	계	3449	1861	1588	45	1816	0	1332	389	30	40	0	0	25	0	0
대구광역시	동구	관외사전투표		10801	10791	10	199	10592	0	6151	3437	466	372	0	0	166	0	0
대구광역시	동구	거소우편투표		885	853	32	56	797	0	509	120	76	43	0	0	49	0	0
대구광역시	동구	신암1동	계	10750	5645	5105	135	5510	0	4180	1056	104	114	0	0	56	0	0
대구광역시	동구	신암2동	계	10030	5481	4549	119	5362	0	3653	1384	185	96	0	0	44	0	0
대구광역시	동구	신암3동	계	8136	4193	3943	119	4074	0	3071	775	122	68	0	0	38	0	0
대구광역시	동구	신암4동	계	15465	7134	8331	196	6938	0	5172	1402	188	111	0	0	65	0	0
대구광역시	동구	신암5동	계	7180	3699	3481	83	3616	0	2730	696	86	76	0	0	28	0	0
대구광역시	동구	신천1·2동	계	11879	6493	5386	148	6345	0	4396	1572	196	132	0	0	49	0	0
대구광역시	동구	신천3동	계	10387	5352	5035	123	5229	0	3714	1228	143	92	0	0	52	0	0
대구광역시	동구	신천4동	계	7845	3763	4082	82	3681	0	2817	659	100	76	0	0	29	0	0
대구광역시	동구	효목1동	계	13338	6684	6654	132	6552	0	4947	1232	192	126	0	0	55	0	0
대구광역시	동구	효목2동	계	13888	7031	6857	127	6904	0	5067	1465	184	134	0	0	54	0	0
대구광역시	동구	도평동	계	4173	2261	1912	42	2219	0	1689	388	67	53	0	0	22	0	0
대구광역시	동구	불로·봉무동	계	17038	9264	7774	199	9065	0	6380	2124	287	195	0	0	79	0	0
대구광역시	동구	지저동	계	9467	4563	4904	118	4445	0	3392	804	123	88	0	0	38	0	0
대구광역시	동구	동촌동	계	11656	5567	6089	137	5430	0	4179	934	157	118	0	0	42	0	0
대구광역시	동구	방촌동	계	16769	9190	7579	235	8955	0	6449	1950	278	188	0	0	90	0	0
대구광역시	동구	해안동	계	14692	7039	7653	253	6786	0	5167	1280	157	126	0	0	56	0	0
대구광역시	동구	안심1동	계	35077	17007	18070	491	16516	0	11271	3995	608	462	0	0	180	0	0
대구광역시	동구	안심2동	계	8588	3973	4615	114	3859	0	2853	780	97	85	0	0	44	0	0
대구광역시	동구	안심3·4동	계	36153	18346	17807	443	17903	0	11335	5131	695	507	0	0	235	0	0
대구광역시	동구	공산동	계	12550	6956	5594	190	6766	0	5053	1341	187	130	0	0	55	0	0
대구광역시	서구	관외사전투표		5653	5649	4	94	5555	0	3572	1516	205	167	0	0	95	0	0
대구광역시	서구	거소우편투표		306	280	26	7	273	0	205	48	11	3	0	0	6	0	0
대구광역시	서구	내당1동	계	10077	4668	5409	95	4573	0	3504	853	80	91	0	0	45	0	0
대구광역시	서구	내당2·3동	계	10223	4936	5287	108	4828	0	3792	771	101	107	0	0	57	0	0
대구광역시	서구	내당4동	계	15822	7688	8134	149	7539	0	5630	1550	141	154	0	0	64	0	0
대구광역시	서구	비산1동	계	10329	4883	5446	138	4745	0	3722	728	89	110	0	0	96	0	0
대구광역시	서구	비산2·3동	계	10381	5040	5341	156	4884	0	3907	675	112	125	0	0	65	0	0
대구광역시	서구	비산4동	계	9809	4717	5092	88	4629	0	3576	794	99	116	0	0	44	0	0
대구광역시	서구	비산5동	계	6499	3094	3405	78	3016	0	2462	422	44	52	0	0	36	0	0
대구광역시	서구	비산6동	계	7866	3897	3969	93	3804	0	2977	623	68	88	0	0	48	0	0
대구광역시	서구	비산7동	계	11334	5291	6043	128	5163	0	4207	718	80	103	0	0	55	0	0
대구광역시	서구	평리1동	계	7629	3647	3982	102	3545	0	2812	540	64	71	0	0	58	0	0
대구광역시	서구	평리2동	계	7576	3747	3829	63	3684	0	2710	794	66	78	0	0	36	0	0
대구광역시	서구	평리3동	계	11916	5611	6305	146	5465	0	4304	876	118	104	0	0	63	0	0
대구광역시	서구	평리4동	계	16318	7865	8453	186	7679	0	5667	1627	135	171	0	0	79	0	0
대구광역시	서구	평리5동	계	6455	3201	3254	72	3129	0	2460	525	47	67	0	0	30	0	0
대구광역시	서구	평리6동	계	7713	3599	4114	88	3511	0	2783	585	42	69	0	0	32	0	0
대구광역시	서구	상중이동	계	18241	9130	9111	164	8966	0	6685	1833	168	191	0	0	89	0	0
대구광역시	서구	원대동	계	8969	4250	4719	93	4157	0	3335	596	78	100	0	0	48	0	0
대구광역시	남구	관외사전투표		4911	4903	8	85	4818	0	2901	1482	162	189	0	0	84	0	0
대구광역시	남구	거소우편투표		246	232	14	7	225	0	161	48	10	1	0	0	5	0	0
대구광역시	남구	이천동	계	12030	6230	5800	146	6084	0	4463	1304	125	121	0	0	71	0	0
대구광역시	남구	봉덕1동	계	8548	3924	4624	105	3819	0	2912	717	60	87	0	0	43	0	0
대구광역시	남구	봉덕2동	계	10519	5565	4954	169	5396	0	4160	995	79	111	0	0	51	0	0
대구광역시	남구	봉덕3동	계	15021	6733	8288	217	6516	0	4901	1256	142	141	0	0	76	0	0
대구광역시	남구	대명1동	계	10157	4780	5377	149	4631	0	3417	950	98	118	0	0	48	0	0
대구광역시	남구	대명2동	계	11142	5322	5820	187	5135	0	3759	1049	115	142	0	0	70	0	0
대구광역시	남구	대명3동	계	12444	5552	6892	175	5377	0	4114	973	121	118	0	0	51	0	0
대구광역시	남구	대명4동	계	10567	4929	5638	142	4787	0	3796	763	88	97	0	0	43	0	0
대구광역시	남구	대명5동	계	7596	3530	4066	109	3421	0	2530	703	82	67	0	0	39	0	0
대구광역시	남구	대명6동	계	8569	4222	4347	117	4105	0	3040	820	101	108	0	0	36	0	0
대구광역시	남구	대명9동	계	13641	6123	7518	185	5938	0	4293	1284	162	151	0	0	48	0	0
대구광역시	남구	대명10동	계	8685	4052	4633	102	3950	0	2996	774	56	79	0	0	45	0	0
대구광역시	남구	대명11동	계	8269	3956	4313	109	3847	0	2994	665	73	86	0	0	29	0	0
대구광역시	북구	관외사전투표		13213	13204	9	280	12924	0	7609	4165	427	489	0	0	234	0	0
대구광역시	북구	거소우편투표		881	834	47	46	788	0	515	145	64	32	0	0	32	0	0
대구광역시	북구	고성동	계	5691	2848	2843	122	2726	0	2089	504	48	57	0	0	28	0	0
대구광역시	북구	칠성동	계	15895	8277	7618	196	8081	0	5657	2040	142	160	0	0	82	0	0
대구광역시	북구	침산1동	계	4606	2233	2373	47	2186	0	1739	339	46	38	0	0	24	0	0
대구광역시	북구	침산2동	계	12409	6788	5621	147	6641	0	4470	1836	144	143	0	0	48	0	0
대구광역시	북구	침산3동	계	16459	8834	7625	193	8641	0	6049	2144	172	201	0	0	75	0	0
대구광역시	북구	노원동	계	10146	4969	5177	122	4847	0	3936	727	66	87	0	0	31	0	0
대구광역시	북구	산격1동	계	10207	5096	5111	209	4887	0	3889	753	96	90	0	0	59	0	0
대구광역시	북구	산격2동	계	10100	5429	4671	113	5316	0	3846	1219	89	110	0	0	52	0	0
대구광역시	북구	산격3동	계	8102	3780	4322	100	3680	0	2648	829	81	83	0	0	39	0	0
대구광역시	북구	산격4동	계	8407	4266	4141	123	4143	0	3159	764	101	82	0	0	37	0	0
대구광역시	북구	복현1동	계	6298	2813	3485	75	2738	0	1787	737	71	101	0	0	42	0	0
대구광역시	북구	복현2동	계	23416	11854	11562	317	11537	0	7616	3222	295	291	0	0	113	0	0
대구광역시	북구	대현동	계	14826	7613	7213	210	7403	0	5261	1718	155	174	0	0	95	0	0
대구광역시	북구	검단동	계	6958	3540	3418	121	3419	0	2599	655	80	60	0	0	25	0	0
대구광역시	북구	무태조야동	계	22682	11052	11630	354	10698	0	7052	3010	283	241	0	0	112	0	0
대구광역시	북구	관문동	계	13551	6965	6586	176	6789	0	4825	1556	143	191	0	0	74	0	0
대구광역시	북구	태전1동	계	18377	8793	9584	184	8609	0	6086	1908	225	317	0	0	73	0	0
대구광역시	북구	태전2동	계	19649	9106	10543	215	8891	0	6325	1984	234	271	0	0	77	0	0
대구광역시	북구	구암동	계	28893	13808	15085	306	13502	0	8596	3751	455	571	0	0	129	0	0
대구광역시	북구	관음동	계	16138	7419	8719	180	7239	0	5269	1526	168	210	0	0	66	0	0
대구광역시	북구	읍내동	계	22134	10307	11827	190	10117	0	7007	2439	249	332	0	0	90	0	0
대구광역시	북구	동천동	계	21445	10696	10749	216	10480	0	6499	3058	342	463	0	0	118	0	0
대구광역시	북구	국우동	계	18400	8645	9755	198	8447	0	5171	2482	298	416	0	0	80	0	0
대구광역시	수성구	관외사전투표		17148	17136	12	331	16805	0	9831	5487	448	751	0	0	288	0	0
대구광역시	수성구	거소우편투표		741	686	55	38	648	0	486	105	20	22	0	0	15	0	0
대구광역시	수성구	범어1동	계	13743	7760	5983	206	7554	0	5028	2006	151	290	0	0	79	0	0
대구광역시	수성구	범어2동	계	11637	6023	5614	247	5776	0	4027	1370	104	212	0	0	63	0	0
대구광역시	수성구	범어3동	계	9026	4982	4044	157	4825	0	3092	1355	123	203	0	0	52	0	0
대구광역시	수성구	범어4동	계	13159	7402	5757	193	7209	0	4644	2023	154	293	0	0	95	0	0
대구광역시	수성구	만촌1동	계	19028	10756	8272	274	10482	0	7176	2617	191	374	0	0	124	0	0
대구광역시	수성구	만촌2동	계	10045	5309	4736	123	5186	0	3660	1206	88	173	0	0	59	0	0
대구광역시	수성구	만촌3동	계	14500	8099	6401	163	7936	0	5318	2065	155	304	0	0	94	0	0
대구광역시	수성구	수성1가동	계	13681	7536	6145	149	7387	0	5183	1731	135	259	0	0	79	0	0
대구광역시	수성구	수성2·3가동	계	9795	5368	4427	113	5255	0	3624	1324	101	157	0	0	49	0	0
대구광역시	수성구	수성4가동	계	13331	7413	5918	171	7242	0	4990	1767	148	278	0	0	59	0	0
대구광역시	수성구	황금1동	계	17583	10151	7432	293	9858	0	6207	2980	188	378	0	0	105	0	0
대구광역시	수성구	황금2동	계	10272	4516	5756	118	4398	0	3237	935	72	125	0	0	29	0	0
대구광역시	수성구	중동	계	11121	5173	5948	97	5076	0	3894	911	78	157	0	0	36	0	0
대구광역시	수성구	상동	계	14570	7059	7511	169	6890	0	5008	1525	110	182	0	0	65	0	0
대구광역시	수성구	파동	계	12230	6387	5843	163	6224	0	4634	1211	109	218	0	0	52	0	0
대구광역시	수성구	두산동	계	11524	5077	6447	113	4964	0	3467	1197	83	175	0	0	42	0	0
대구광역시	수성구	지산1동	계	20073	9731	10342	244	9487	0	6866	2069	184	279	0	0	89	0	0
대구광역시	수성구	지산2동	계	17444	9000	8444	185	8815	0	6176	2066	162	325	0	0	86	0	0
대구광역시	수성구	범물1동	계	11681	6101	5580	178	5923	0	4408	1164	123	164	0	0	64	0	0
대구광역시	수성구	범물2동	계	13778	7485	6293	167	7318	0	4947	1842	156	308	0	0	65	0	0
대구광역시	수성구	고산1동	계	25087	14598	10489	360	14238	0	8763	4114	315	910	0	0	136	0	0
대구광역시	수성구	고산2동	계	21249	12171	9078	285	11886	0	7581	3157	276	722	0	0	150	0	0
대구광역시	수성구	고산3동	계	26570	15194	11376	350	14844	0	9302	4125	345	921	0	0	151	0	0
대구광역시	달서구	관외사전투표		18988	18965	23	369	18596	0	11048	6073	579	591	0	0	305	0	0
대구광역시	달서구	거소우편투표		954	913	41	40	873	0	641	163	19	28	0	0	22	0	0
대구광역시	달서구	성당동	계	21187	9929	11258	277	9652	0	6901	2296	174	213	0	0	68	0	0
대구광역시	달서구	두류1·2동	계	15413	6919	8494	212	6707	0	5196	1223	101	119	0	0	68	0	0
대구광역시	달서구	두류3동	계	8822	4620	4202	133	4487	0	3282	1015	64	91	0	0	35	0	0
대구광역시	달서구	본리동	계	18573	9029	9544	185	8844	0	5791	2580	167	228	0	0	78	0	0
대구광역시	달서구	감삼동	계	23055	11419	11636	297	11122	0	7876	2735	179	235	0	0	97	0	0
대구광역시	달서구	죽전동	계	13695	6111	7584	166	5945	0	4415	1267	104	119	0	0	40	0	0
대구광역시	달서구	장기동	계	14091	6901	7190	158	6743	0	4639	1755	140	157	0	0	52	0	0
대구광역시	달서구	용산1동	계	25853	13405	12448	314	13091	0	8859	3570	226	323	0	0	113	0	0
대구광역시	달서구	용산2동	계	25097	12668	12429	236	12432	0	8366	3410	230	318	0	0	108	0	0
대구광역시	달서구	이곡1동	계	19974	9699	10275	149	9550	0	6442	2627	188	207	0	0	86	0	0
대구광역시	달서구	이곡2동	계	14994	7673	7321	139	7534	0	5317	1860	158	133	0	0	66	0	0
대구광역시	달서구	신당동	계	29279	13387	15892	295	13092	0	9046	3347	240	310	0	0	149	0	0
대구광역시	달서구	월성1동	계	26101	14225	11876	323	13902	0	8308	4426	457	612	0	0	99	0	0
대구광역시	달서구	월성2동	계	16490	8232	8258	369	7863	0	5877	1540	159	199	0	0	88	0	0
대구광역시	달서구	진천동	계	44892	22469	22423	422	22047	0	14557	6210	556	537	0	0	187	0	0
대구광역시	달서구	상인1동	계	32162	18217	13945	439	17778	0	11715	5094	351	448	0	0	170	0	0
대구광역시	달서구	상인2동	계	19380	9205	10175	323	8882	0	6349	2114	153	181	0	0	85	0	0
대구광역시	달서구	상인3동	계	12204	5873	6331	229	5644	0	4312	1075	85	101	0	0	71	0	0
대구광역시	달서구	도원동	계	30582	16906	13676	450	16456	0	11066	4442	343	440	0	0	165	0	0
대구광역시	달서구	송현1동	계	18841	8237	10604	186	8051	0	5933	1754	137	154	0	0	73	0	0
대구광역시	달서구	송현2동	계	18500	8800	9700	287	8513	0	6292	1832	147	172	0	0	70	0	0
대구광역시	달서구	본동	계	12348	5717	6631	157	5560	0	4019	1281	108	109	0	0	43	0	0
대구광역시	달성군	관외사전투표		5412	5409	3	82	5327	0	3307	1527	190	190	0	0	113	0	0
대구광역시	달성군	거소우편투표		868	803	65	53	750	0	495	127	41	67	0	0	20	0	0
대구광역시	달성군	화원읍	계	40656	20221	20435	652	19569	0	14109	4304	486	447	0	0	223	0	0
대구광역시	달성군	논공읍	계	16997	7350	9647	166	7184	0	5333	1266	336	166	0	0	83	0	0
대구광역시	달성군	다사읍	계	45346	22093	23253	548	21545	0	14509	5673	560	576	0	0	227	0	0
대구광역시	달성군	가창면	계	6909	3605	3304	150	3455	0	2672	611	48	76	0	0	48	0	0
대구광역시	달성군	하빈면	계	3743	1849	1894	90	1759	0	1378	286	26	32	0	0	37	0	0
대구광역시	달성군	옥포면	계	8295	4197	4098	118	4079	0	3181	624	85	134	0	0	55	0	0
대구광역시	달성군	현풍면	계	8569	4218	4351	123	4095	0	3176	605	143	98	0	0	73	0	0
대구광역시	달성군	유가면	계	2205	1199	1006	51	1148	0	986	108	18	17	0	0	19	0	0
대구광역시	달성군	구지면	계	6001	2730	3271	60	2670	0	1995	479	74	67	0	0	55	0	0
인천광역시	중구	관외사전투표		4772	4768	4	74	4694	0	2418	1892	133	162	0	49	40	0	0
인천광역시	중구	거소우편투표		164	160	4	8	152	0	79	59	5	6	0	2	1	0	0
인천광역시	중구	신포동	계	5193	2654	2539	83	2571	0	1533	879	56	68	0	19	16	0	0
인천광역시	중구	연안동	계	6558	3195	3363	106	3089	0	1874	1064	46	68	0	19	18	0	0
인천광역시	중구	신흥동	계	12109	6296	5813	155	6141	0	3481	2231	140	196	0	45	48	0	0
인천광역시	중구	도원동	계	4058	2082	1976	81	2001	0	1241	632	40	61	0	16	11	0	0
인천광역시	중구	율목동	계	3707	1847	1860	57	1790	0	1116	549	41	51	0	18	15	0	0
인천광역시	중구	동인천동	계	5610	2819	2791	71	2748	0	1706	854	62	81	0	18	27	0	0
인천광역시	중구	북성동	계	3430	1894	1536	69	1825	0	1101	624	35	32	0	22	11	0	0
인천광역시	중구	송월동	계	4733	2536	2197	86	2450	0	1397	854	61	67	0	55	16	0	0
인천광역시	중구	영종동	계	20281	10278	10003	175	10103	0	5279	3988	257	409	0	124	46	0	0
인천광역시	중구	운서동	계	15115	7929	7186	92	7837	0	2949	3949	279	414	0	204	42	0	0
인천광역시	중구	용유동	계	4037	2097	1940	76	2021	0	1511	433	22	22	0	19	14	0	0
인천광역시	동구	관외사전투표		2546	2543	3	45	2498	0	1145	1012	92	184	0	30	35	0	0
인천광역시	동구	거소우편투표		117	109	8	3	106	0	67	28	3	6	0	1	1	0	0
인천광역시	동구	만석동	계	5974	3271	2703	106	3165	0	1667	1094	92	243	0	42	27	0	0
인천광역시	동구	화수1·화평동	계	6112	3510	2602	101	3409	0	1961	1086	88	204	0	41	29	0	0
인천광역시	동구	화수2동	계	7467	4346	3121	130	4216	0	2370	1387	98	276	0	52	33	0	0
인천광역시	동구	송현1·2동	계	9414	5681	3733	98	5583	0	2886	2071	142	373	0	73	38	0	0
인천광역시	동구	송현3동	계	3793	2136	1657	67	2069	0	1203	640	57	128	0	27	14	0	0
인천광역시	동구	송림1동	계	2494	1439	1055	55	1384	0	846	416	39	63	0	9	11	0	0
인천광역시	동구	송림2동	계	3158	1841	1317	74	1767	0	1113	480	46	95	0	20	13	0	0
인천광역시	동구	송림3·5동	계	7558	4213	3345	97	4116	0	2145	1487	132	276	0	52	24	0	0
인천광역시	동구	송림4동	계	4173	2368	1805	50	2318	0	1219	821	70	171	0	22	15	0	0
인천광역시	동구	송림6동	계	5773	3293	2480	65	3228	0	1682	1163	91	230	0	39	23	0	0
인천광역시	동구	금창동	계	3114	1766	1348	54	1712	0	1092	446	45	100	0	14	15	0	0
인천광역시	남구	관외사전투표		14440	14431	9	193	14238	0	6774	6141	460	550	0	159	154	0	0
인천광역시	남구	거소우편투표		728	694	34	22	672	0	365	215	21	32	0	20	19	0	0
인천광역시	남구	숭의1·3동	계	9115	4507	4608	119	4388	0	2627	1462	112	137	0	22	28	0	0
인천광역시	남구	숭의2동	계	9308	4449	4859	75	4374	0	2634	1466	121	91	0	31	31	0	0
인천광역시	남구	숭의4동	계	12978	6366	6612	129	6237	0	3680	2176	150	149	0	39	43	0	0
인천광역시	남구	용현1·4동	계	16262	7877	8385	180	7697	0	4469	2695	177	252	0	48	56	0	0
인천광역시	남구	용현2동	계	11308	5886	5422	111	5775	0	3170	2219	161	166	0	30	29	0	0
인천광역시	남구	용현3동	계	7564	3485	4079	98	3387	0	2058	1114	73	88	0	25	29	0	0
인천광역시	남구	용현5동	계	28109	13975	14134	224	13751	0	7497	5216	351	499	0	105	83	0	0
인천광역시	남구	학익1동	계	27058	14860	12198	195	14665	0	7771	5686	385	626	0	105	92	0	0
인천광역시	남구	학익2동	계	16764	9060	7704	150	8910	0	4936	3260	214	374	0	63	63	0	0
인천광역시	남구	도화1동	계	16726	7566	9160	139	7427	0	4208	2653	143	292	0	86	45	0	0
인천광역시	남구	도화2·3동	계	16518	7726	8792	149	7577	0	4274	2720	154	293	0	92	44	0	0
인천광역시	남구	주안1동	계	12051	4351	7700	99	4252	0	2060	1824	97	190	0	58	23	0	0
인천광역시	남구	주안2동	계	19866	9328	10538	177	9151	0	5438	3139	198	234	0	87	55	0	0
인천광역시	남구	주안3동	계	9850	4503	5347	86	4417	0	2570	1584	98	100	0	42	23	0	0
인천광역시	남구	주안4동	계	18343	8874	9469	160	8714	0	5299	2823	201	269	0	73	49	0	0
인천광역시	남구	주안5동	계	18510	9117	9393	178	8939	0	4556	3676	228	300	0	129	50	0	0
인천광역시	남구	주안6동	계	17513	8769	8744	135	8634	0	4335	3532	217	408	0	90	52	0	0
인천광역시	남구	주안7동	계	12623	6268	6355	125	6143	0	3360	2379	143	159	0	60	42	0	0
인천광역시	남구	주안8동	계	18342	9266	9076	162	9104	0	4756	3667	222	306	0	97	56	0	0
인천광역시	남구	관교동	계	14308	8092	6216	114	7978	0	4369	2987	193	327	0	51	51	0	0
인천광역시	남구	문학동	계	12143	4648	7495	84	4564	0	2344	1888	101	157	0	37	37	0	0
인천광역시	연수구	관외사전투표		11645	11629	16	172	11457	0	5626	4709	344	503	0	112	163	0	0
인천광역시	연수구	거소우편투표		630	611	19	26	585	0	353	177	20	16	0	8	11	0	0
인천광역시	연수구	옥련1동	계	16660	8490	8170	138	8352	0	4627	3056	226	336	0	51	56	0	0
인천광역시	연수구	옥련2동	계	17737	9790	7947	165	9625	0	5140	3719	252	394	0	65	55	0	0
인천광역시	연수구	선학동	계	16786	8544	8242	150	8394	0	4579	3132	211	355	0	58	59	0	0
인천광역시	연수구	연수1동	계	20984	8912	12072	166	8746	0	4571	3447	257	361	0	56	54	0	0
인천광역시	연수구	연수2동	계	19563	10499	9064	184	10315	0	5145	4181	284	539	0	85	81	0	0
인천광역시	연수구	연수3동	계	15664	8562	7102	134	8428	0	4082	3552	265	410	0	54	65	0	0
인천광역시	연수구	청학동	계	24302	11903	12399	176	11727	0	6475	4295	283	502	0	87	85	0	0
인천광역시	연수구	동춘1동	계	12331	7150	5181	114	7036	0	3631	2668	189	436	0	72	40	0	0
인천광역시	연수구	동춘2동	계	15624	9048	6576	134	8914	0	4140	3912	219	541	0	44	58	0	0
인천광역시	연수구	동춘3동	계	14417	9207	5210	141	9066	0	4694	3528	216	520	0	44	64	0	0
인천광역시	연수구	송도1동	계	34094	21435	12659	218	21217	0	11261	7900	670	1142	0	93	151	0	0
인천광역시	연수구	송도2동	계	18016	10789	7227	114	10675	0	5930	3790	302	560	0	37	56	0	0
인천광역시	남동구	관외사전투표		17595	17586	9	293	17293	0	7697	7556	698	776	0	214	352	0	0
인천광역시	남동구	거소우편투표		1054	1013	41	46	967	0	565	300	31	24	0	15	32	0	0
인천광역시	남동구	구월1동	계	22926	10033	12893	141	9892	0	4773	4226	354	256	0	136	147	0	0
인천광역시	남동구	구월2동	계	30087	16946	13141	195	16751	0	8055	7051	552	809	0	98	186	0	0
인천광역시	남동구	구월3동	계	11144	5143	6001	74	5069	0	2701	1917	146	181	0	47	77	0	0
인천광역시	남동구	구월4동	계	15406	6495	8911	120	6375	0	3395	2461	198	190	0	74	57	0	0
인천광역시	남동구	간석1동	계	20704	10621	10083	121	10500	0	5470	4065	332	410	0	92	131	0	0
인천광역시	남동구	간석2동	계	15375	9054	6321	128	8926	0	4724	3346	311	372	0	67	106	0	0
인천광역시	남동구	간석3동	계	22958	10251	12707	210	10041	0	5104	3965	370	389	0	90	123	0	0
인천광역시	남동구	간석4동	계	22949	11160	11789	133	11027	0	5695	4347	364	396	0	92	133	0	0
인천광역시	남동구	만수1동	계	15379	7111	8268	120	6991	0	3733	2566	231	303	0	70	88	0	0
인천광역시	남동구	만수2동	계	23771	12584	11187	181	12403	0	5891	5215	503	579	0	86	129	0	0
인천광역시	남동구	만수3동	계	15446	8010	7436	149	7861	0	3904	3113	342	351	0	65	86	0	0
인천광역시	남동구	만수4동	계	16206	9018	7188	128	8890	0	4389	3643	296	370	0	61	131	0	0
인천광역시	남동구	만수5동	계	15288	7210	8078	111	7099	0	3783	2643	263	273	0	70	67	0	0
인천광역시	남동구	만수6동	계	22138	12002	10136	140	11862	0	6039	4669	439	509	0	73	133	0	0
인천광역시	남동구	장수서창동	계	22704	12631	10073	137	12494	0	6031	5178	494	574	0	77	140	0	0
인천광역시	남동구	남촌도림동	계	19023	9090	9933	123	8967	0	4781	3438	280	219	0	129	120	0	0
인천광역시	남동구	논현1동	계	24258	12161	12097	137	12024	0	5501	5376	512	420	0	95	120	0	0
인천광역시	남동구	논현2동	계	25728	12955	12773	237	12718	0	6155	5428	473	425	0	102	135	0	0
인천광역시	남동구	논현고잔동	계	25265	14056	11209	169	13887	0	6662	6025	602	378	0	80	140	0	0
인천광역시	부평구	관외사전투표		20022	20006	16	348	19658	0	8385	9287	729	773	0	230	254	0	0
인천광역시	부평구	거소우편투표		817	779	38	32	747	0	421	246	29	21	0	19	11	0	0
인천광역시	부평구	부평1동	계	27528	14936	12592	232	14704	0	7144	6355	475	528	0	95	107	0	0
인천광역시	부평구	부평2동	계	17306	7785	9521	129	7656	0	3687	3391	234	211	0	62	71	0	0
인천광역시	부평구	부평3동	계	12213	5715	6498	93	5622	0	2888	2260	147	231	0	53	43	0	0
인천광역시	부평구	부평4동	계	23045	9356	13689	210	9146	0	4303	4131	284	282	0	74	72	0	0
인천광역시	부평구	부평5동	계	22242	8857	13385	164	8693	0	4041	3958	313	252	0	59	70	0	0
인천광역시	부평구	부평6동	계	13317	6138	7179	106	6032	0	2802	2769	197	162	0	47	55	0	0
인천광역시	부평구	산곡1동	계	15616	7688	7928	166	7522	0	3925	2983	200	297	0	63	54	0	0
인천광역시	부평구	산곡2동	계	25758	14654	11104	194	14460	0	6741	6405	514	566	0	105	129	0	0
인천광역시	부평구	산곡3동	계	20134	11695	8439	159	11536	0	6231	4442	280	435	0	61	87	0	0
인천광역시	부평구	산곡4동	계	15065	8808	6257	143	8665	0	4276	3611	333	330	0	52	63	0	0
인천광역시	부평구	청천1동	계	12723	5559	7164	136	5423	0	2909	2112	161	145	0	56	40	0	0
인천광역시	부평구	청천2동	계	27674	14295	13379	207	14088	0	6555	6240	529	504	0	151	109	0	0
인천광역시	부평구	갈산1동	계	14530	6993	7537	101	6892	0	3190	3103	230	233	0	72	64	0	0
인천광역시	부평구	갈산2동	계	18204	9838	8366	112	9726	0	4758	4154	278	390	0	70	76	0	0
인천광역시	부평구	삼산1동	계	30032	15284	14748	212	15072	0	6442	7277	537	591	0	131	94	0	0
인천광역시	부평구	삼산2동	계	22289	13008	9281	111	12897	0	5235	6391	469	641	0	74	87	0	0
인천광역시	부평구	부개1동	계	15944	7387	8557	134	7253	0	3738	3071	185	166	0	52	41	0	0
인천광역시	부평구	부개2동	계	19263	9616	9647	115	9501	0	4364	4455	291	273	0	59	59	0	0
인천광역시	부평구	부개3동	계	27607	14970	12637	165	14805	0	6181	7222	545	651	0	108	98	0	0
인천광역시	부평구	일신동	계	11192	6010	5182	66	5944	0	2835	2683	199	139	0	39	49	0	0
인천광역시	부평구	십정1동	계	16820	8060	8760	162	7898	0	4070	3277	212	230	0	60	49	0	0
인천광역시	부평구	십정2동	계	22630	10109	12521	160	9949	0	5091	4141	298	275	0	69	75	0	0
인천광역시	계양구	관외사전투표		12995	12990	5	189	12801	0	5297	6268	428	496	0	136	176	0	0
인천광역시	계양구	거소우편투표		509	482	27	17	465	0	239	175	27	11	0	6	7	0	0
인천광역시	계양구	효성1동	계	25297	13267	12030	184	13083	0	6230	5813	386	434	0	124	96	0	0
인천광역시	계양구	효성2동	계	26239	13363	12876	159	13204	0	6355	5804	391	437	0	112	105	0	0
인천광역시	계양구	계산1동	계	18736	8395	10341	90	8305	0	4021	3661	241	252	0	67	63	0	0
인천광역시	계양구	계산2동	계	15213	7177	8036	94	7083	0	3302	3128	217	286	0	57	93	0	0
인천광역시	계양구	계산3동	계	17768	8924	8844	89	8835	0	3816	4226	260	386	0	70	77	0	0
인천광역시	계양구	계산4동	계	17415	9849	7566	78	9771	0	4320	4559	291	468	0	72	61	0	0
인천광역시	계양구	작전1동	계	24619	12172	12447	148	12024	0	5331	5685	359	460	0	94	95	0	0
인천광역시	계양구	작전2동	계	22311	10793	11518	201	10592	0	5060	4719	304	348	0	83	78	0	0
인천광역시	계양구	작전서운동	계	25709	13044	12665	167	12877	0	5576	6165	438	531	0	87	80	0	0
인천광역시	계양구	계양1동	계	36729	18249	18480	214	18035	0	7919	8283	587	1015	0	106	125	0	0
인천광역시	계양구	계양2동	계	31119	14588	16531	275	14313	0	6283	6745	464	618	0	102	101	0	0
인천광역시	서구	관외사전투표		16847	16775	72	270	16505	0	7765	7300	528	572	0	174	166	0	0
인천광역시	서구	거소우편투표		731	697	34	45	652	0	354	229	22	20	0	15	12	0	0
인천광역시	서구	검암경서동	계	30506	14698	15808	192	14506	0	6196	6908	443	719	0	103	137	0	0
인천광역시	서구	연희동	계	34934	15837	19097	238	15599	0	8034	6384	434	480	0	133	134	0	0
인천광역시	서구	청라1동	계	18254	10451	7803	89	10362	0	4292	5028	375	547	0	65	55	0	0
인천광역시	서구	청라2동	계	30015	17491	12524	224	17267	0	8092	7471	577	946	0	89	92	0	0
인천광역시	서구	가정1동	계	10747	4810	5937	108	4702	0	2601	1807	100	110	0	44	40	0	0
인천광역시	서구	가정2동	계	6130	2864	3266	26	2838	0	1431	1177	94	87	0	36	13	0	0
인천광역시	서구	가정3동	계	9092	4592	4500	62	4530	0	2364	1819	138	145	0	36	28	0	0
인천광역시	서구	신현원창동	계	21408	10664	10744	133	10531	0	5717	4098	256	317	0	69	74	0	0
인천광역시	서구	석남1동	계	19208	8884	10324	150	8734	0	4836	3359	209	213	0	67	50	0	0
인천광역시	서구	석남2동	계	12900	6682	6218	130	6552	0	3608	2538	144	159	0	59	44	0	0
인천광역시	서구	석남3동	계	13616	6053	7563	131	5922	0	3114	2399	172	148	0	55	34	0	0
인천광역시	서구	가좌1동	계	10695	4963	5732	83	4880	0	2697	1869	113	115	0	49	37	0	0
인천광역시	서구	가좌2동	계	17508	10202	7306	125	10077	0	5136	4168	270	359	0	76	68	0	0
인천광역시	서구	가좌3동	계	15664	8235	7429	120	8115	0	4511	3062	192	234	0	66	50	0	0
인천광역시	서구	가좌4동	계	9264	4545	4719	72	4473	0	2381	1763	112	125	0	58	34	0	0
인천광역시	서구	검단1동	계	21056	9562	11494	126	9436	0	4740	3963	307	321	0	45	60	0	0
인천광역시	서구	검단2동	계	17043	8567	8476	96	8471	0	4063	3737	272	315	0	47	37	0	0
인천광역시	서구	검단3동	계	16625	8418	8207	82	8336	0	3152	4220	329	537	0	50	48	0	0
인천광역시	서구	검단4동	계	31599	16367	15232	185	16182	0	7186	7507	530	770	0	100	89	0	0
인천광역시	서구	검단5동	계	16769	8173	8596	107	8066	0	3979	3498	215	300	0	31	43	0	0
인천광역시	강화군	관외사전투표		4076	4076	0	75	4001	0	2238	1461	121	90	0	37	54	0	0
인천광역시	강화군	거소우편투표		388	346	42	52	294	0	198	56	13	13	0	7	7	0	0
인천광역시	강화군	강화읍	계	17377	10896	6481	434	10462	0	6865	2940	241	176	0	135	105	0	0
인천광역시	강화군	선원면	계	5463	3569	1894	160	3409	0	2260	874	97	84	0	50	44	0	0
인천광역시	강화군	불은면	계	3657	2277	1380	119	2158	0	1449	514	62	59	0	34	40	0	0
인천광역시	강화군	길상면	계	5251	3159	2092	153	3006	0	2254	592	50	55	0	26	29	0	0
인천광역시	강화군	화도면	계	3553	2222	1331	104	2118	0	1584	415	31	48	0	19	21	0	0
인천광역시	강화군	양도면	계	3089	1953	1136	100	1853	0	1262	414	43	62	0	32	40	0	0
인천광역시	강화군	내가면	계	2611	1771	840	84	1687	0	1238	325	37	40	0	30	17	0	0
인천광역시	강화군	하점면	계	3449	2158	1291	125	2033	0	1513	381	33	47	0	34	25	0	0
인천광역시	강화군	양사면	계	1554	1048	506	49	999	0	710	201	25	36	0	9	18	0	0
인천광역시	강화군	송해면	계	2621	1727	894	115	1612	0	1154	311	45	39	0	31	32	0	0
인천광역시	강화군	교동면	계	2537	1724	813	105	1619	0	1168	299	40	60	0	27	25	0	0
인천광역시	강화군	삼산면	계	1925	1255	670	55	1200	0	886	218	33	30	0	15	18	0	0
인천광역시	강화군	서도면	계	538	412	126	25	387	0	289	51	8	18	0	2	19	0	0
인천광역시	옹진군	관외사전투표		2069	2068	1	48	2020	0	1301	584	61	35	0	20	19	0	0
인천광역시	옹진군	거소우편투표		165	163	2	36	127	0	78	32	6	2	0	4	5	0	0
인천광역시	옹진군	북도면	계	1663	1262	401	82	1180	0	910	181	16	22	0	18	33	0	0
인천광역시	옹진군	연평면	계	1654	1161	493	44	1117	0	791	263	24	19	0	9	11	0	0
인천광역시	옹진군	백령면	계	4247	3068	1179	165	2903	0	2112	571	66	79	0	39	36	0	0
인천광역시	옹진군	대청면	계	1255	1070	185	53	1017	0	832	140	15	16	0	4	10	0	0
인천광역시	옹진군	덕적면	계	1511	1163	348	82	1081	0	766	211	28	45	0	17	14	0	0
인천광역시	옹진군	자월면	계	980	736	244	24	712	0	550	116	14	12	0	10	10	0	0
인천광역시	옹진군	영흥면	계	4580	2893	1687	104	2789	0	1828	762	60	71	0	33	35	0	0
광주광역시	동구	관외사전투표		5964	5959	5	116	5843	0	592	4225	669	245	0	112	0	0	0
광주광역시	동구	거소우편투표		362	347	15	42	305	0	66	158	35	21	0	25	0	0	0
광주광역시	동구	충장동	계	3997	1884	2113	45	1839	0	236	1350	161	55	0	37	0	0	0
광주광역시	동구	동명동	계	4137	2224	1913	62	2162	0	274	1547	220	68	0	53	0	0	0
광주광역시	동구	계림1동	계	7027	3328	3699	103	3225	0	380	2346	303	107	0	89	0	0	0
광주광역시	동구	계림2동	계	8310	4852	3458	128	4724	0	485	3468	488	158	0	125	0	0	0
광주광역시	동구	산수1동	계	6660	3553	3107	110	3443	0	269	2583	363	110	0	118	0	0	0
광주광역시	동구	산수2동	계	8682	5202	3480	127	5075	0	591	3681	530	165	0	108	0	0	0
광주광역시	동구	지산1동	계	4027	2178	1849	52	2126	0	176	1572	241	83	0	54	0	0	0
광주광역시	동구	지산2동	계	4696	2639	2057	57	2582	0	275	1817	296	128	0	66	0	0	0
광주광역시	동구	서남동	계	3392	1559	1833	38	1521	0	170	1100	156	65	0	30	0	0	0
광주광역시	동구	학동	계	6148	3500	2648	77	3423	0	291	2461	431	138	0	102	0	0	0
광주광역시	동구	학운동	계	10317	6640	3677	163	6477	0	919	4496	715	245	0	102	0	0	0
광주광역시	동구	지원1동	계	6887	4081	2806	109	3972	0	338	2863	484	156	0	131	0	0	0
광주광역시	동구	지원2동	계	5859	3282	2577	110	3172	0	313	2204	390	140	0	125	0	0	0
광주광역시	서구	관외사전투표		14674	14655	19	328	14327	0	1503	10151	1630	701	0	342	0	0	0
광주광역시	서구	거소우편투표		467	438	29	17	421	0	71	284	30	21	0	15	0	0	0
광주광역시	서구	양동	계	4338	2272	2066	61	2211	0	238	1715	160	55	0	43	0	0	0
광주광역시	서구	양3동	계	4324	2400	1924	63	2337	0	205	1692	286	94	0	60	0	0	0
광주광역시	서구	농성1동	계	7166	3536	3630	105	3431	0	387	2525	311	117	0	91	0	0	0
광주광역시	서구	농성2동	계	4939	2448	2491	58	2390	0	283	1741	225	84	0	57	0	0	0
광주광역시	서구	광천동	계	8415	4263	4152	104	4159	0	421	2980	511	133	0	114	0	0	0
광주광역시	서구	유덕동	계	8233	4503	3730	83	4420	0	346	3118	674	145	0	137	0	0	0
광주광역시	서구	치평동	계	21439	12574	8865	219	12355	0	1199	8675	1770	469	0	242	0	0	0
광주광역시	서구	상무1동	계	18651	9598	9053	140	9458	0	896	6723	1306	348	0	185	0	0	0
광주광역시	서구	상무2동	계	20388	10174	10214	264	9910	0	983	7220	938	565	0	204	0	0	0
광주광역시	서구	화정1동	계	12886	6671	6215	135	6536	0	626	4792	735	225	0	158	0	0	0
광주광역시	서구	화정2동	계	8960	5021	3939	100	4921	0	466	3703	475	176	0	101	0	0	0
광주광역시	서구	화정3동	계	9253	5134	4119	122	5012	0	490	3711	546	173	0	92	0	0	0
광주광역시	서구	화정4동	계	15220	9066	6154	162	8904	0	882	6499	986	360	0	177	0	0	0
광주광역시	서구	서창동	계	4963	2727	2236	62	2665	0	243	1883	294	170	0	75	0	0	0
광주광역시	서구	금호1동	계	18035	10602	7433	212	10390	0	943	7453	1090	701	0	203	0	0	0
광주광역시	서구	금호2동	계	19382	12170	7212	161	12009	0	1016	8576	1342	912	0	163	0	0	0
광주광역시	서구	풍암동	계	28268	16709	11559	265	16444	0	1540	11977	1930	715	0	282	0	0	0
광주광역시	서구	동천동	계	12200	7125	5075	103	7022	0	523	4947	1152	242	0	158	0	0	0
광주광역시	남구	관외사전투표		11174	11169	5	258	10911	0	1116	7677	1408	486	0	224	0	0	0
광주광역시	남구	거소우편투표		387	361	26	34	327	0	52	213	29	18	0	15	0	0	0
광주광역시	남구	양림동	계	6878	3981	2897	107	3874	0	331	2801	521	142	0	79	0	0	0
광주광역시	남구	방림1동	계	6432	3557	2875	82	3475	0	277	2541	423	146	0	88	0	0	0
광주광역시	남구	방림2동	계	8603	5032	3571	151	4881	0	424	3619	533	181	0	124	0	0	0
광주광역시	남구	봉선1동	계	12779	6702	6077	168	6534	0	607	4746	785	242	0	154	0	0	0
광주광역시	남구	봉선2동	계	19395	12365	7030	338	12027	0	1274	8471	1559	559	0	164	0	0	0
광주광역시	남구	사직동	계	4813	2267	2546	62	2205	0	204	1653	229	77	0	42	0	0	0
광주광역시	남구	월산동	계	8697	4449	4248	150	4299	0	364	3258	433	129	0	115	0	0	0
광주광역시	남구	월산4동	계	8669	4226	4443	117	4109	0	378	3100	433	106	0	92	0	0	0
광주광역시	남구	월산5동	계	6639	3331	3308	107	3224	0	243	2419	373	108	0	81	0	0	0
광주광역시	남구	백운1동	계	10487	6248	4239	132	6116	0	540	4463	808	197	0	108	0	0	0
광주광역시	남구	백운2동	계	4447	2206	2241	73	2133	0	236	1566	205	73	0	53	0	0	0
광주광역시	남구	주월1동	계	14795	7943	6852	190	7753	0	604	5714	976	298	0	161	0	0	0
광주광역시	남구	주월2동	계	7948	4194	3754	114	4080	0	344	3022	476	123	0	115	0	0	0
광주광역시	남구	효덕동	계	30189	18310	11879	444	17866	0	1498	12851	2535	686	0	296	0	0	0
광주광역시	남구	송암동	계	4595	2588	2007	75	2513	0	189	1869	319	90	0	46	0	0	0
광주광역시	남구	대촌동	계	5070	2788	2282	144	2644	0	216	1903	343	86	0	96	0	0	0
광주광역시	북구	관외사전투표		22505	22483	22	447	22036	0	2229	15611	2783	836	0	577	0	0	0
광주광역시	북구	거소우편투표		743	681	62	43	638	0	95	420	65	20	0	38	0	0	0
광주광역시	북구	중흥1동	계	3071	1375	1696	49	1326	0	131	978	138	40	0	39	0	0	0
광주광역시	북구	중흥2동	계	7144	3813	3331	107	3706	0	394	2615	440	147	0	110	0	0	0
광주광역시	북구	중흥3동	계	4812	2340	2472	69	2271	0	253	1640	232	77	0	69	0	0	0
광주광역시	북구	중앙동	계	3498	1628	1870	44	1584	0	167	1181	151	46	0	39	0	0	0
광주광역시	북구	임동	계	7939	4196	3743	71	4125	0	364	3005	526	151	0	79	0	0	0
광주광역시	북구	신안동	계	9791	4590	5201	100	4490	0	402	3214	594	149	0	131	0	0	0
광주광역시	북구	용봉동	계	29249	16272	12977	330	15942	0	1232	11325	2372	681	0	332	0	0	0
광주광역시	북구	운암1동	계	15292	9450	5842	151	9299	0	859	6782	1096	381	0	181	0	0	0
광주광역시	북구	운암2동	계	11700	5909	5791	118	5791	0	519	4277	664	186	0	145	0	0	0
광주광역시	북구	운암3동	계	13658	7888	5770	150	7738	0	663	5517	1034	296	0	228	0	0	0
광주광역시	북구	동림동	계	15895	8890	7005	180	8710	0	623	6365	1174	296	0	252	0	0	0
광주광역시	북구	우산동	계	11458	5586	5872	169	5417	0	563	3842	629	225	0	158	0	0	0
광주광역시	북구	풍향동	계	4331	2107	2224	52	2055	0	190	1473	254	76	0	62	0	0	0
광주광역시	북구	문화동	계	11927	6370	5557	216	6154	0	606	4454	652	220	0	222	0	0	0
광주광역시	북구	문흥1동	계	13674	8063	5611	151	7912	0	611	5781	1123	238	0	159	0	0	0
광주광역시	북구	문흥2동	계	13523	7519	6004	138	7381	0	480	5359	1056	288	0	198	0	0	0
광주광역시	북구	두암1동	계	7270	3797	3473	87	3710	0	334	2749	417	105	0	105	0	0	0
광주광역시	북구	두암2동	계	14990	7704	7286	198	7506	0	616	5523	884	210	0	273	0	0	0
광주광역시	북구	두암3동	계	13416	7004	6412	208	6796	0	647	4908	831	205	0	205	0	0	0
광주광역시	북구	삼각동	계	9455	5078	4377	91	4987	0	418	3577	723	154	0	115	0	0	0
광주광역시	북구	일곡동	계	22033	12856	9177	189	12667	0	926	8994	1844	590	0	313	0	0	0
광주광역시	북구	매곡동	계	10689	6360	4329	123	6237	0	515	4487	894	226	0	115	0	0	0
광주광역시	북구	오치1동	계	9887	5020	4867	120	4900	0	434	3546	635	152	0	133	0	0	0
광주광역시	북구	오치2동	계	11890	6116	5774	184	5932	0	508	4211	842	212	0	159	0	0	0
광주광역시	북구	석곡동	계	2398	1222	1176	37	1185	0	112	851	132	37	0	53	0	0	0
광주광역시	북구	건국동	계	24901	11692	13209	195	11497	0	799	8145	1706	542	0	305	0	0	0
광주광역시	북구	양산동	계	24741	12386	12355	218	12168	0	918	8695	1754	483	0	318	0	0	0
광주광역시	광산구	관외사전투표		16036	16016	20	318	15698	0	1530	10738	2256	751	0	423	0	0	0
광주광역시	광산구	거소우편투표		516	481	35	22	459	0	76	296	44	18	0	25	0	0	0
광주광역시	광산구	송정1동	계	8632	4656	3976	113	4543	0	386	3183	737	144	0	93	0	0	0
광주광역시	광산구	송정2동	계	5358	2959	2399	94	2865	0	354	1960	366	108	0	77	0	0	0
광주광역시	광산구	도산동	계	10576	5681	4895	115	5566	0	528	3838	905	165	0	130	0	0	0
광주광역시	광산구	신흥동	계	3817	1927	1890	42	1885	0	174	1316	281	64	0	50	0	0	0
광주광역시	광산구	어룡동	계	16429	8374	8055	228	8146	0	556	5677	1429	269	0	215	0	0	0
광주광역시	광산구	우산동	계	18268	8349	9919	272	8077	0	621	5577	1283	312	0	284	0	0	0
광주광역시	광산구	월곡1동	계	10493	5120	5373	116	5004	0	356	3500	818	199	0	131	0	0	0
광주광역시	광산구	월곡2동	계	14123	6937	7186	132	6805	0	443	4749	1219	232	0	162	0	0	0
광주광역시	광산구	비아동	계	5211	2194	3017	47	2147	0	147	1501	353	100	0	46	0	0	0
광주광역시	광산구	첨단1동	계	16343	9456	6887	135	9321	0	755	6448	1400	521	0	197	0	0	0
광주광역시	광산구	첨단2동	계	28326	14647	13679	229	14418	0	963	9946	2444	751	0	314	0	0	0
광주광역시	광산구	신가동	계	16603	8264	8339	152	8112	0	543	5628	1357	399	0	185	0	0	0
광주광역시	광산구	운남동	계	22144	12168	9976	208	11960	0	695	8316	2178	435	0	336	0	0	0
광주광역시	광산구	신창동	계	22192	11374	10818	173	11201	0	650	7706	1921	664	0	260	0	0	0
광주광역시	광산구	수완동	계	46716	24790	21926	335	24455	0	1690	16815	4086	1394	0	470	0	0	0
광주광역시	광산구	하남동	계	12595	6514	6081	105	6409	0	409	4432	1147	285	0	136	0	0	0
광주광역시	광산구	임곡동	계	2019	995	1024	42	953	0	72	653	128	49	0	51	0	0	0
광주광역시	광산구	동곡동	계	1854	1096	758	51	1045	0	89	693	151	47	0	65	0	0	0
광주광역시	광산구	평동	계	3355	1679	1676	86	1593	0	132	1050	298	42	0	71	0	0	0
광주광역시	광산구	삼도동	계	2240	1193	1047	79	1114	0	90	762	160	47	0	55	0	0	0
광주광역시	광산구	본량동	계	2029	1172	857	140	1032	0	105	693	127	62	0	45	0	0	0
대전광역시	동구	관외사전투표		8994	8990	4	164	8826	0	3673	4506	317	266	0	0	0	64	0
대전광역시	동구	거소우편투표		412	377	35	39	338	0	195	110	14	11	0	0	0	8	0
대전광역시	동구	중앙동	계	6345	2940	3405	103	2837	0	1758	972	46	44	0	0	0	17	0
대전광역시	동구	신인동	계	10695	5455	5240	117	5338	0	2748	2333	116	104	0	0	0	37	0
대전광역시	동구	효동	계	20350	10599	9751	250	10349	0	4561	5254	211	264	0	0	0	59	0
대전광역시	동구	판암1동	계	8450	4600	3850	154	4446	0	2385	1837	96	90	0	0	0	38	0
대전광역시	동구	판암2동	계	9345	4744	4601	199	4545	0	2544	1777	115	68	0	0	0	41	0
대전광역시	동구	용운동	계	16186	8172	8014	258	7914	0	3705	3792	175	187	0	0	0	55	0
대전광역시	동구	대동	계	10575	5176	5399	134	5042	0	2561	2274	90	88	0	0	0	29	0
대전광역시	동구	자양동	계	9731	4462	5269	116	4346	0	2313	1821	101	80	0	0	0	31	0
대전광역시	동구	가양1동	계	12873	6268	6605	193	6075	0	3240	2580	113	111	0	0	0	31	0
대전광역시	동구	가양2동	계	17388	7960	9428	191	7769	0	4094	3287	191	168	0	0	0	29	0
대전광역시	동구	용전동	계	17150	7455	9695	156	7299	0	3563	3381	163	158	0	0	0	34	0
대전광역시	동구	성남동	계	11352	5808	5544	140	5668	0	2719	2670	138	111	0	0	0	30	0
대전광역시	동구	홍도동	계	10471	4966	5505	103	4863	0	2438	2177	120	102	0	0	0	26	0
대전광역시	동구	삼성동	계	14174	7293	6881	176	7117	0	3693	3109	153	129	0	0	0	33	0
대전광역시	동구	대청동	계	2477	1328	1149	61	1267	0	773	416	26	37	0	0	0	15	0
대전광역시	동구	산내동	계	15703	8103	7600	231	7872	0	3745	3733	187	159	0	0	0	48	0
대전광역시	중구	관외사전투표		9936	9933	3	172	9761	0	4115	5016	284	288	0	0	0	58	0
대전광역시	중구	거소우편투표		498	457	41	42	415	0	223	153	17	10	0	0	0	12	0
대전광역시	중구	은행선화동	계	14516	6144	8372	142	6002	0	3060	2619	140	144	0	0	0	39	0
대전광역시	중구	목동	계	11150	6429	4721	98	6331	0	2707	3219	202	174	0	0	0	29	0
대전광역시	중구	중촌동	계	12394	6651	5743	176	6475	0	3211	2914	152	157	0	0	0	41	0
대전광역시	중구	대흥동	계	11270	5434	5836	112	5322	0	2676	2341	139	140	0	0	0	26	0
대전광역시	중구	문창동	계	4471	2234	2237	99	2135	0	1256	779	47	39	0	0	0	14	0
대전광역시	중구	석교동	계	15018	7518	7500	250	7268	0	4166	2778	152	117	0	0	0	55	0
대전광역시	중구	대사동	계	5492	2663	2829	119	2544	0	1494	939	52	46	0	0	0	13	0
대전광역시	중구	부사동	계	6156	3059	3097	100	2959	0	1702	1144	46	48	0	0	0	19	0
대전광역시	중구	용두동	계	8445	4428	4017	114	4314	0	2133	1961	100	90	0	0	0	30	0
대전광역시	중구	오류동	계	8391	4808	3583	117	4691	0	2488	1981	89	107	0	0	0	26	0
대전광역시	중구	태평1동	계	11056	6263	4793	97	6166	0	2814	3020	136	165	0	0	0	31	0
대전광역시	중구	태평2동	계	21782	12619	9163	302	12317	0	6452	5330	259	233	0	0	0	43	0
대전광역시	중구	유천1동	계	6016	2692	3324	164	2528	0	1425	988	55	38	0	0	0	22	0
대전광역시	중구	유천2동	계	12093	6617	5476	293	6324	0	3450	2590	132	115	0	0	0	37	0
대전광역시	중구	문화1동	계	18139	10340	7799	325	10015	0	4907	4625	197	237	0	0	0	49	0
대전광역시	중구	문화2동	계	12049	5996	6053	176	5820	0	3014	2543	124	104	0	0	0	35	0
대전광역시	중구	산성동	계	24367	11834	12533	607	11227	0	5823	4922	237	167	0	0	0	78	0
대전광역시	서구	관외사전투표		19471	19467	4	355	19112	0	7864	9825	637	608	0	0	0	178	0
대전광역시	서구	거소우편투표		719	680	39	35	645	0	351	232	29	22	0	0	0	11	0
대전광역시	서구	복수동	계	15928	8235	7693	164	8071	0	3640	4059	173	141	0	0	0	58	0
대전광역시	서구	도마1동	계	15360	6806	8554	151	6655	0	3642	2708	142	123	0	0	0	40	0
대전광역시	서구	도마2동	계	17414	8227	9187	156	8071	0	4338	3333	177	162	0	0	0	61	0
대전광역시	서구	정림동	계	14483	7727	6756	186	7541	0	3709	3475	178	133	0	0	0	46	0
대전광역시	서구	변동	계	14690	6514	8176	179	6335	0	3209	2747	148	169	0	0	0	62	0
대전광역시	서구	용문동	계	13498	5691	7807	196	5495	0	2745	2454	115	147	0	0	0	34	0
대전광역시	서구	탄방동	계	23235	10554	12681	204	10350	0	4476	5233	226	355	0	0	0	60	0
대전광역시	서구	둔산1동	계	12053	7357	4696	133	7224	0	3633	3249	146	163	0	0	0	33	0
대전광역시	서구	둔산2동	계	28110	16369	11741	233	16136	0	6163	8979	387	493	0	0	0	114	0
대전광역시	서구	둔산3동	계	16711	9551	7160	186	9365	0	4775	4139	174	208	0	0	0	69	0
대전광역시	서구	괴정동	계	16599	6642	9957	151	6491	0	2906	3175	150	215	0	0	0	45	0
대전광역시	서구	가장동	계	10668	5749	4919	141	5608	0	2830	2450	121	165	0	0	0	42	0
대전광역시	서구	내동	계	19622	10544	9078	188	10356	0	5086	4679	238	292	0	0	0	61	0
대전광역시	서구	갈마1동	계	19085	8847	10238	194	8653	0	4209	3949	187	248	0	0	0	60	0
대전광역시	서구	갈마2동	계	21534	9187	12347	203	8984	0	3749	4646	221	308	0	0	0	60	0
대전광역시	서구	월평1동	계	10163	4155	6008	70	4085	0	1890	1960	91	109	0	0	0	35	0
대전광역시	서구	월평2동	계	14286	8029	6257	218	7811	0	3858	3560	169	174	0	0	0	50	0
대전광역시	서구	월평3동	계	17887	11139	6748	185	10954	0	4789	5575	237	303	0	0	0	50	0
대전광역시	서구	만년동	계	10972	6513	4459	123	6390	0	2514	3476	160	203	0	0	0	37	0
대전광역시	서구	가수원동	계	19918	10575	9343	269	10306	0	4331	5395	256	261	0	0	0	63	0
대전광역시	서구	관저1동	계	11826	6505	5321	159	6346	0	2678	3304	174	148	0	0	0	42	0
대전광역시	서구	관저2동	계	21934	11736	10198	207	11529	0	4516	6327	311	307	0	0	0	68	0
대전광역시	서구	기성동	계	3720	2133	1587	193	1940	0	1207	579	70	39	0	0	0	45	0
대전광역시	유성구	관외사전투표		13716	13706	10	233	13473	0	5303	7067	490	525	0	0	0	88	0
대전광역시	유성구	거소우편투표		538	508	30	36	472	0	281	140	17	29	0	0	0	5	0
대전광역시	유성구	진잠동	계	25164	12564	12600	351	12213	0	5375	6122	309	325	0	0	0	82	0
대전광역시	유성구	원신흥동	계	24050	13111	10939	262	12849	0	5395	6580	339	467	0	0	0	68	0
대전광역시	유성구	온천1동	계	22599	9932	12667	307	9625	0	4650	4320	298	302	0	0	0	55	0
대전광역시	유성구	온천2동	계	25100	13629	11471	332	13297	0	5577	6566	408	688	0	0	0	58	0
대전광역시	유성구	노은1동	계	16728	9558	7170	153	9405	0	3611	5133	276	354	0	0	0	31	0
대전광역시	유성구	노은2동	계	32893	19665	13228	302	19363	0	6983	10960	605	755	0	0	0	60	0
대전광역시	유성구	신성동	계	18733	11159	7574	214	10945	0	4882	5284	333	391	0	0	0	55	0
대전광역시	유성구	전민동	계	18247	11196	7051	171	11025	0	4068	6015	408	488	0	0	0	46	0
대전광역시	유성구	구즉동	계	22494	11410	11084	254	11156	0	3927	6430	412	304	0	0	0	83	0
대전광역시	유성구	관평동	계	20227	12193	8034	204	11989	0	4237	6923	382	402	0	0	0	45	0
대전광역시	대덕구	관외사전투표		6797	6792	5	123	6669	0	2757	3344	306	203	0	0	0	59	0
대전광역시	대덕구	거소우편투표		311	292	19	29	263	0	161	66	15	8	0	0	0	13	0
대전광역시	대덕구	오정동	계	15072	7039	8033	158	6881	0	3725	2783	216	122	0	0	0	35	0
대전광역시	대덕구	대화동	계	7663	3657	4006	181	3476	0	1903	1314	137	74	0	0	0	48	0
대전광역시	대덕구	회덕동	계	13603	7061	6542	235	6826	0	3652	2794	235	112	0	0	0	33	0
대전광역시	대덕구	비래동	계	14450	7052	7398	110	6942	0	3507	3031	210	151	0	0	0	43	0
대전광역시	대덕구	송촌동	계	21838	11492	10346	211	11281	0	4738	5820	407	239	0	0	0	77	0
대전광역시	대덕구	중리동	계	18534	8129	10405	140	7989	0	4061	3510	230	147	0	0	0	41	0
대전광역시	대덕구	법1동	계	10938	5670	5268	140	5530	0	2690	2437	240	125	0	0	0	38	0
대전광역시	대덕구	법2동	계	14691	8279	6412	214	8065	0	3918	3617	337	148	0	0	0	45	0
대전광역시	대덕구	신탄진동	계	10424	5379	5045	150	5229	0	2747	2163	187	86	0	0	0	46	0
대전광역시	대덕구	석봉동	계	9102	4533	4569	108	4425	0	2013	2095	182	106	0	0	0	29	0
대전광역시	대덕구	덕암동	계	12742	6035	6707	169	5866	0	2704	2715	282	122	0	0	0	43	0
대전광역시	대덕구	목상동	계	5522	2462	3060	69	2393	0	1013	1208	105	51	0	0	0	16	0
울산광역시	중구	관외사전투표		8460	8445	15	160	8285	0	4096	2626	778	385	0	400	0	0	0
울산광역시	중구	거소우편투표		482	452	30	21	431	0	265	94	30	11	0	31	0	0	0
울산광역시	중구	학성동	계	9672	4840	4832	81	4759	0	3309	874	262	123	0	191	0	0	0
울산광역시	중구	반구1동	계	13118	6830	6288	139	6691	0	4033	1349	681	238	0	390	0	0	0
울산광역시	중구	반구2동	계	8180	4530	3650	94	4436	0	2678	964	363	163	0	268	0	0	0
울산광역시	중구	복산1동	계	8033	4038	3995	85	3953	0	2613	831	267	98	0	144	0	0	0
울산광역시	중구	복산2동	계	7739	4180	3559	54	4126	0	2386	1007	387	147	0	199	0	0	0
울산광역시	중구	북정동	계	17028	8730	8298	102	8628	0	4692	2259	841	358	0	478	0	0	0
울산광역시	중구	중앙동	계	12405	5817	6588	85	5732	0	4043	1060	270	158	0	201	0	0	0
울산광역시	중구	우정동	계	18429	10221	8208	212	10009	0	6067	2559	658	314	0	411	0	0	0
울산광역시	중구	태화동	계	21789	12794	8995	211	12583	0	7107	3491	998	422	0	565	0	0	0
울산광역시	중구	다운동	계	23086	12262	10824	342	11920	0	7284	2643	999	392	0	602	0	0	0
울산광역시	중구	병영1동	계	20400	11629	8771	176	11453	0	6405	2668	1436	391	0	553	0	0	0
울산광역시	중구	병영2동	계	14514	8032	6482	137	7895	0	4268	1785	1121	291	0	430	0	0	0
울산광역시	중구	약사동	계	5883	3856	2027	67	3789	0	1917	1089	444	144	0	195	0	0	0
울산광역시	남구	관외사전투표		12337	12329	8	205	12124	0	5992	3810	1267	551	0	504	0	0	0
울산광역시	남구	거소우편투표		624	604	20	20	584	0	346	127	53	22	0	36	0	0	0
울산광역시	남구	신정1동	계	16761	8320	8441	162	8158	0	5504	1541	606	255	0	252	0	0	0
울산광역시	남구	신정2동	계	18189	9682	8507	129	9553	0	5726	2432	767	358	0	270	0	0	0
울산광역시	남구	신정3동	계	13759	6980	6779	86	6894	0	4184	1577	627	222	0	284	0	0	0
울산광역시	남구	신정4동	계	18515	10127	8388	129	9998	0	5722	2605	938	362	0	371	0	0	0
울산광역시	남구	신정5동	계	7208	3343	3865	45	3298	0	2104	680	283	126	0	105	0	0	0
울산광역시	남구	달동	계	24044	11672	12372	169	11503	0	6660	2859	1131	330	0	523	0	0	0
울산광역시	남구	삼산동	계	38978	18329	20649	240	18089	0	9579	4582	2563	618	0	747	0	0	0
울산광역시	남구	삼호동	계	20397	10469	9928	154	10315	0	5911	2486	1128	396	0	394	0	0	0
울산광역시	남구	무거동	계	27165	15075	12090	220	14855	0	7939	4110	1706	597	0	503	0	0	0
울산광역시	남구	옥동	계	19936	11852	8084	169	11683	0	6524	3447	978	432	0	302	0	0	0
울산광역시	남구	야음장생포동	계	11004	5623	5381	146	5477	0	3710	844	528	138	0	257	0	0	0
울산광역시	남구	대현동	계	23298	13113	10185	228	12885	0	7220	3140	1550	451	0	524	0	0	0
울산광역시	남구	수암동	계	12977	7668	5309	105	7563	0	4116	2058	794	254	0	341	0	0	0
울산광역시	남구	선암동	계	12288	6376	5912	93	6283	0	3713	1441	642	192	0	295	0	0	0
울산광역시	동구	관외사전투표		5795	5794	1	100	5694	0	2552	1498	945	232	0	467	0	0	0
울산광역시	동구	거소우편투표		273	259	14	16	243	0	135	48	28	13	0	19	0	0	0
울산광역시	동구	방어동	계	32284	16252	16032	393	15859	0	8490	3135	2576	382	0	1276	0	0	0
울산광역시	동구	일산동	계	6372	3129	3243	70	3059	0	1859	513	413	77	0	197	0	0	0
울산광역시	동구	화정동	계	14236	7099	7137	180	6919	0	3866	1270	1063	172	0	548	0	0	0
울산광역시	동구	대송동	계	11342	6116	5226	111	6005	0	2868	1230	1161	141	0	605	0	0	0
울산광역시	동구	전하1동	계	13471	7930	5541	108	7822	0	3920	1880	1294	208	0	520	0	0	0
울산광역시	동구	전하2동	계	18086	11196	6890	145	11051	0	5562	2572	1920	271	0	726	0	0	0
울산광역시	동구	남목1동	계	8728	5212	3516	72	5140	0	2670	1067	788	169	0	446	0	0	0
울산광역시	동구	남목2동	계	19615	11706	7909	167	11539	0	5530	2976	1643	432	0	958	0	0	0
울산광역시	동구	남목3동	계	11064	6890	4174	104	6786	0	3282	1483	1159	239	0	623	0	0	0
울산광역시	북구	관외사전투표		6588	6585	3	95	6490	0	2824	1675	1210	347	0	434	0	0	0
울산광역시	북구	거소우편투표		304	292	12	11	281	0	166	44	36	16	0	19	0	0	0
울산광역시	북구	농소1동	계	22271	12239	10032	189	12050	0	6516	2601	1900	520	0	513	0	0	0
울산광역시	북구	농소2동	계	22613	11918	10695	170	11748	0	6148	2441	2114	418	0	627	0	0	0
울산광역시	북구	농소3동	계	28045	15497	12548	200	15297	0	6869	3656	3478	612	0	682	0	0	0
울산광역시	북구	강동동	계	3853	2117	1736	76	2041	0	1586	225	99	86	0	45	0	0	0
울산광역시	북구	효문동	계	21427	11464	9963	174	11290	0	5385	2278	2528	460	0	639	0	0	0
울산광역시	북구	송정동	계	14547	8638	5909	112	8526	0	3924	1822	1743	580	0	457	0	0	0
울산광역시	북구	양정동	계	9696	5513	4183	76	5437	0	2139	1345	1255	274	0	424	0	0	0
울산광역시	북구	염포동	계	10003	5497	4506	82	5415	0	2459	1101	1265	207	0	383	0	0	0
울산광역시	울주군	관외사전투표		7861	7857	4	144	7713	0	4045	2238	723	409	0	298	0	0	0
울산광역시	울주군	거소우편투표		518	425	93	45	380	0	244	65	25	15	0	31	0	0	0
울산광역시	울주군	온산읍	계	19111	8293	10818	181	8112	0	5078	1763	593	282	0	396	0	0	0
울산광역시	울주군	언양읍	계	20386	11144	9242	272	10872	0	6963	2318	736	388	0	467	0	0	0
울산광역시	울주군	온양읍	계	18377	9275	9102	180	9095	0	5526	2011	689	479	0	390	0	0	0
울산광역시	울주군	범서읍	계	46778	27131	19647	480	26651	0	13199	8224	2916	1160	0	1152	0	0	0
울산광역시	울주군	서생면	계	7110	3701	3409	156	3545	0	2653	535	147	119	0	91	0	0	0
울산광역시	울주군	청량면	계	10618	5585	5033	150	5435	0	3447	1233	369	184	0	202	0	0	0
울산광역시	울주군	웅촌면	계	6926	3623	3303	104	3519	0	2423	660	204	116	0	116	0	0	0
울산광역시	울주군	두동면	계	3376	1956	1420	157	1799	0	1288	266	84	90	0	71	0	0	0
울산광역시	울주군	두서면	계	2866	1853	1013	127	1726	0	1247	226	78	102	0	73	0	0	0
울산광역시	울주군	상북면	계	7007	3674	3333	153	3521	0	2470	607	170	128	0	146	0	0	0
울산광역시	울주군	삼남면	계	12522	6492	6030	177	6315	0	4442	1174	328	164	0	207	0	0	0
울산광역시	울주군	삼동면	계	1558	1025	533	32	993	0	715	161	44	34	0	39	0	0	0
세종특별자치시	세종특별자치시	관외사전투표		6883	6869	14	100	6769	0	2622	4147	0	0	0	0	0	0	0
세종특별자치시	세종특별자치시	거소우편투표		353	328	25	62	266	0	152	114	0	0	0	0	0	0	0
세종특별자치시	세종특별자치시	조치원읍	계	34797	20019	14778	541	19478	0	8995	10483	0	0	0	0	0	0	0
세종특별자치시	세종특별자치시	연기면	계	2283	1413	870	76	1337	0	745	592	0	0	0	0	0	0	0
세종특별자치시	세종특별자치시	연동면	계	3227	1996	1231	86	1910	0	1152	758	0	0	0	0	0	0	0
세종특별자치시	세종특별자치시	부강면	계	5370	3489	1881	120	3369	0	2026	1343	0	0	0	0	0	0	0
세종특별자치시	세종특별자치시	금남면	계	8273	4780	3493	160	4620	0	2563	2057	0	0	0	0	0	0	0
세종특별자치시	세종특별자치시	장군면	계	4369	2488	1881	90	2398	0	1446	952	0	0	0	0	0	0	0
세종특별자치시	세종특별자치시	연서면	계	6230	3807	2423	162	3645	0	2003	1642	0	0	0	0	0	0	0
세종특별자치시	세종특별자치시	전의면	계	5537	3108	2429	140	2968	0	1927	1041	0	0	0	0	0	0	0
세종특별자치시	세종특별자치시	전동면	계	3529	1957	1572	83	1874	0	1178	696	0	0	0	0	0	0	0
세종특별자치시	세종특별자치시	소정면	계	2322	1219	1103	58	1161	0	770	391	0	0	0	0	0	0	0
세종특별자치시	세종특별자치시	한솔동	계	12373	8305	4068	105	8200	0	2277	5923	0	0	0	0	0	0	0
세종특별자치시	세종특별자치시	도담동	계	6013	3826	2187	70	3756	0	1279	2477	0	0	0	0	0	0	0
경기도	수원시장안구	관외사전투표		11019	11013	6	194	10819	0	4443	5249	462	393	0	118	95	59	0
경기도	수원시장안구	거소우편투표		493	460	33	17	443	0	253	138	13	16	0	12	8	3	0
경기도	수원시장안구	파장동	계	19549	9957	9592	213	9744	0	4672	4327	323	311	0	36	39	36	0
경기도	수원시장안구	율천동	계	33517	19459	14058	362	19097	0	7256	9787	772	888	0	219	115	60	0
경기도	수원시장안구	정자1동	계	25428	14250	11178	199	14051	0	6097	6651	540	526	0	126	64	47	0
경기도	수원시장안구	정자2동	계	24741	13543	11198	620	12923	0	5973	5813	494	438	0	101	59	45	0
경기도	수원시장안구	정자3동	계	31286	19799	11487	397	19402	0	7419	9939	839	882	0	181	93	49	0
경기도	수원시장안구	영화동	계	18714	8454	10260	245	8209	0	4515	3124	218	259	0	31	36	26	0
경기도	수원시장안구	송죽동	계	15081	7555	7526	196	7359	0	3432	3344	224	261	0	36	37	25	0
경기도	수원시장안구	조원1동	계	24763	12863	11900	379	12484	0	6321	5170	357	462	0	56	64	54	0
경기도	수원시장안구	조원2동	계	15132	9945	5187	170	9775	0	4673	4245	319	397	0	45	54	42	0
경기도	수원시장안구	연무동	계	16941	8376	8565	316	8060	0	4676	2841	191	244	0	45	33	30	0
경기도	수원시권선구	관외사전투표		10164	10149	15	167	9982	0	4326	4660	451	311	0	90	90	54	0
경기도	수원시권선구	거소우편투표		479	451	28	33	418	0	232	132	20	10	0	6	12	6	0
경기도	수원시권선구	세류1동	계	3556	1542	2014	43	1499	0	895	523	44	23	0	6	3	5	0
경기도	수원시권선구	세류2동	계	22360	9318	13042	243	9075	0	4849	3637	246	216	0	50	36	41	0
경기도	수원시권선구	세류3동	계	19919	8442	11477	190	8252	0	4445	3300	221	176	0	37	40	33	0
경기도	수원시권선구	평동	계	27579	13836	13743	256	13580	0	6743	5749	563	343	0	66	64	52	0
경기도	수원시권선구	구운동	계	22034	11207	10827	170	11037	0	5308	4901	338	349	0	53	54	34	0
경기도	수원시권선구	금호동	계	37849	20693	17156	341	20352	0	8744	9378	1277	702	0	72	124	55	0
경기도	수원시권선구	권선1동	계	20000	9385	10615	223	9162	0	4480	4084	246	255	0	37	36	24	0
경기도	수원시권선구	권선2동	계	30417	17885	12532	308	17577	0	8170	8109	570	567	0	65	58	38	0
경기도	수원시권선구	곡선동	계	23984	10817	13167	214	10603	0	4170	5467	381	436	0	63	46	40	0
경기도	수원시권선구	입북동	계	12563	7352	5211	135	7217	0	2869	3710	289	257	0	37	29	26	0
경기도	수원시팔달구	관외사전투표		9066	9064	2	155	8909	0	3869	4167	367	316	0	73	79	38	0
경기도	수원시팔달구	거소우편투표		294	283	11	12	271	0	153	99	10	5	0	3	0	1	0
경기도	수원시팔달구	행궁동	계	10443	5025	5418	171	4854	0	2941	1607	108	122	0	31	24	21	0
경기도	수원시팔달구	매교동	계	9465	4208	5257	102	4106	0	2478	1375	117	79	0	20	16	21	0
경기도	수원시팔달구	매산동	계	10336	4957	5379	107	4850	0	2528	1941	173	146	0	29	21	12	0
경기도	수원시팔달구	고등동	계	10086	4369	5717	106	4263	0	2367	1604	143	87	0	23	23	16	0
경기도	수원시팔달구	화서1동	계	20451	10416	10035	192	10224	0	4995	4354	423	332	0	49	46	25	0
경기도	수원시팔달구	화서2동	계	21347	13309	8038	230	13079	0	5598	6138	577	591	0	71	66	38	0
경기도	수원시팔달구	지동	계	12762	6013	6749	159	5854	0	3449	2044	134	130	0	44	23	30	0
경기도	수원시팔달구	우만1동	계	18799	9014	9785	263	8751	0	4437	3657	260	233	0	76	48	40	0
경기도	수원시팔달구	우만2동	계	13981	8279	5702	127	8152	0	3645	3757	259	355	0	54	59	23	0
경기도	수원시팔달구	인계동	계	33731	15626	18105	246	15380	0	7676	6524	437	526	0	101	73	43	0
경기도	수원시팔달구	서둔동	계	32780	15060	17720	342	14718	0	7008	6504	565	438	0	70	65	68	0
경기도	수원시영통구	관외사전투표		11983	11978	5	198	11780	0	4562	6029	481	475	0	83	103	47	0
경기도	수원시영통구	거소우편투표		300	288	12	6	282	0	152	97	11	9	0	8	3	2	0
경기도	수원시영통구	매탄1동	계	16025	9250	6775	236	9014	0	4089	4187	280	370	0	34	32	22	0
경기도	수원시영통구	매탄2동	계	13118	6652	6466	162	6490	0	3095	2878	216	235	0	23	25	18	0
경기도	수원시영통구	매탄3동	계	28013	15987	12026	280	15707	0	6438	7645	634	796	0	71	77	46	0
경기도	수원시영통구	매탄4동	계	18658	9470	9188	198	9272	0	4070	4355	372	365	0	48	37	25	0
경기도	수원시영통구	원천동	계	15941	7836	8105	142	7694	0	3029	3958	243	367	0	35	42	20	0
경기도	수원시영통구	광교동	계	37985	22817	15168	297	22520	0	8317	11895	879	1221	0	59	103	46	0
경기도	수원시영통구	영통1동	계	30288	17905	12383	252	17653	0	6526	9239	711	963	0	76	109	29	0
경기도	수원시영통구	영통2동	계	33077	20358	12719	321	20037	0	7439	10589	767	1005	0	84	107	46	0
경기도	수원시영통구	태장동	계	35388	19756	15632	271	19485	0	8171	9703	687	744	0	57	64	59	0
경기도	성남시수정구	관외사전투표		10082	10078	4	156	9922	0	3877	5092	416	327	0	70	80	60	0
경기도	성남시수정구	거소우편투표		336	326	10	12	314	0	151	121	16	14	0	3	5	4	0
경기도	성남시수정구	신흥1동	계	12631	5163	7468	157	5006	0	2213	2390	191	130	0	27	24	31	0
경기도	성남시수정구	신흥2동	계	22428	11325	11103	169	11156	0	4867	5488	326	347	0	42	43	43	0
경기도	성남시수정구	신흥3동	계	9678	4146	5532	79	4067	0	1938	1867	104	112	0	12	14	20	0
경기도	성남시수정구	태평1동	계	15303	7224	8079	104	7120	0	3118	3491	209	220	0	31	28	23	0
경기도	성남시수정구	태평2동	계	14845	6698	8147	113	6585	0	2901	3257	192	132	0	36	33	34	0
경기도	성남시수정구	태평3동	계	12832	6053	6779	105	5948	0	2631	2894	187	156	0	31	26	23	0
경기도	성남시수정구	태평4동	계	12382	6018	6364	163	5855	0	2477	2916	216	152	0	39	14	41	0
경기도	성남시수정구	수진1동	계	12965	5556	7409	163	5393	0	2479	2541	168	110	0	35	25	35	0
경기도	성남시수정구	수진2동	계	15531	7954	7577	192	7762	0	3545	3674	216	228	0	39	28	32	0
경기도	성남시수정구	단대동	계	13437	7006	6431	91	6915	0	3195	3272	179	183	0	34	29	23	0
경기도	성남시수정구	산성동	계	12313	6074	6239	135	5939	0	2507	2921	246	168	0	46	20	31	0
경기도	성남시수정구	양지동	계	8585	4497	4088	100	4397	0	1865	2168	156	149	0	21	17	21	0
경기도	성남시수정구	복정동	계	10437	5151	5286	85	5066	0	1543	2933	190	340	0	16	26	18	0
경기도	성남시수정구	신촌동	계	3101	1597	1504	17	1580	0	932	560	34	42	0	2	3	7	0
경기도	성남시수정구	고등동	계	2343	1315	1028	25	1290	0	828	392	28	29	0	5	4	4	0
경기도	성남시수정구	시흥동	계	2565	1428	1137	23	1405	0	908	399	31	44	0	5	8	10	0
경기도	성남시중원구	관외사전투표		10843	10823	20	208	10615	0	4136	5419	463	357	0	86	94	60	0
경기도	성남시중원구	거소우편투표		399	354	45	21	333	0	166	115	13	14	0	8	10	7	0
경기도	성남시중원구	성남동	계	25822	12366	13456	451	11915	0	5380	5747	343	312	0	52	48	33	0
경기도	성남시중원구	중앙동	계	17523	7966	9557	364	7602	0	3602	3415	283	184	0	39	40	39	0
경기도	성남시중원구	금광1동	계	18143	8359	9784	309	8050	0	3695	3716	351	176	0	44	24	44	0
경기도	성남시중원구	금광2동	계	22933	10705	12228	361	10344	0	4502	4990	405	291	0	75	34	47	0
경기도	성남시중원구	은행1동	계	9629	4876	4753	101	4775	0	2037	2354	199	117	0	23	23	22	0
경기도	성남시중원구	은행2동	계	21984	10888	11096	438	10450	0	4521	5064	418	301	0	52	49	45	0
경기도	성남시중원구	상대원1동	계	23160	11260	11900	422	10838	0	4765	5295	357	276	0	56	41	48	0
경기도	성남시중원구	상대원2동	계	13803	6309	7494	228	6081	0	2892	2750	212	135	0	39	20	33	0
경기도	성남시중원구	상대원3동	계	12087	5150	6937	132	5018	0	2296	2344	166	137	0	40	16	19	0
경기도	성남시중원구	하대원동	계	17723	10119	7604	265	9854	0	4602	4605	284	248	0	47	32	36	0
경기도	성남시중원구	도촌동	계	17634	10201	7433	253	9948	0	4156	4923	384	370	0	42	49	24	0
경기도	성남시분당구	관외사전투표		20438	20433	5	293	20140	0	9167	9089	574	820	0	96	309	85	0
경기도	성남시분당구	거소우편투표		568	542	26	35	507	0	304	137	21	18	0	8	13	6	0
경기도	성남시분당구	분당동	계	21332	12347	8985	259	12088	0	5824	5021	333	618	0	44	205	43	0
경기도	성남시분당구	수내1동	계	13725	8119	5606	137	7982	0	4251	2969	157	423	0	23	134	25	0
경기도	성남시분당구	수내2동	계	7784	4979	2805	79	4900	0	2760	1722	82	203	0	11	112	10	0
경기도	성남시분당구	수내3동	계	11091	6567	4524	105	6462	0	3075	2793	154	304	0	13	110	13	0
경기도	성남시분당구	정자1동	계	36918	20545	16373	275	20270	0	11444	7193	411	850	0	49	284	39	0
경기도	성남시분당구	정자2동	계	13874	8328	5546	149	8179	0	3601	3728	225	389	0	38	159	39	0
경기도	성남시분당구	정자3동	계	12629	7474	5155	189	7285	0	3444	3153	193	324	0	26	129	16	0
경기도	성남시분당구	서현1동	계	24378	14326	10052	182	14144	0	7541	5317	292	703	0	31	225	35	0
경기도	성남시분당구	서현2동	계	15048	9225	5823	154	9071	0	4392	3795	213	456	0	26	165	24	0
경기도	성남시분당구	이매1동	계	20358	12936	7422	167	12769	0	6674	5005	250	575	0	34	195	36	0
경기도	성남시분당구	이매2동	계	11193	7106	4087	116	6990	0	4001	2485	125	268	0	15	78	18	0
경기도	성남시분당구	야탑1동	계	14531	8723	5808	107	8616	0	4278	3678	179	295	0	29	114	43	0
경기도	성남시분당구	야탑2동	계	13989	8875	5114	127	8748	0	4869	3237	170	304	0	17	123	28	0
경기도	성남시분당구	야탑3동	계	24885	14387	10498	247	14140	0	5976	6863	353	634	0	65	204	45	0
경기도	성남시분당구	금곡동	계	23487	13896	9591	276	13620	0	7034	5429	328	571	0	32	171	55	0
경기도	성남시분당구	구미동	계	25697	15439	10258	515	14924	0	7257	6238	430	692	0	60	209	38	0
경기도	성남시분당구	구미1동	계	14383	8342	6041	105	8237	0	3807	3663	223	358	0	13	144	29	0
경기도	성남시분당구	판교동	계	15840	10071	5769	100	9971	0	4504	4307	225	736	0	31	152	16	0
경기도	성남시분당구	삼평동	계	18205	11017	7188	182	10835	0	4570	5258	259	537	0	23	171	17	0
경기도	성남시분당구	백현동	계	14359	8913	5446	128	8785	0	3602	4171	228	613	0	22	111	38	0
경기도	성남시분당구	운중동	계	15222	9081	6141	136	8945	0	4266	3715	199	610	0	22	117	16	0
경기도	의정부시	관외사전투표		13699	13692	7	258	13434	0	5784	6405	404	504	0	105	135	97	0
경기도	의정부시	거소우편투표		668	644	24	21	623	0	340	217	22	22	0	9	7	6	0
경기도	의정부시	의정부1동	계	16914	6651	10263	168	6483	0	3679	2436	136	131	0	30	43	28	0
경기도	의정부시	의정부2동	계	22644	9048	13596	274	8774	0	4353	3783	199	277	0	57	53	52	0
경기도	의정부시	의정부3동	계	11934	4898	7036	132	4766	0	2528	1899	112	143	0	39	25	20	0
경기도	의정부시	호원1동	계	26594	14437	12157	378	14059	0	6922	6163	344	470	0	61	54	45	0
경기도	의정부시	호원2동	계	29222	16433	12789	357	16076	0	7635	7322	433	503	0	58	73	52	0
경기도	의정부시	장암동	계	16869	9189	7680	351	8838	0	4269	3793	271	385	0	42	41	37	0
경기도	의정부시	신곡1동	계	34850	17223	17627	363	16860	0	8183	7447	391	600	0	117	75	47	0
경기도	의정부시	신곡2동	계	35611	18143	17468	452	17691	0	8687	7641	490	654	0	79	74	66	0
경기도	의정부시	송산1동	계	26601	11641	14960	226	11415	0	5771	4877	273	326	0	51	64	53	0
경기도	의정부시	송산2동	계	31986	14695	17291	223	14472	0	6531	6811	448	477	0	93	60	52	0
경기도	의정부시	자금동	계	23212	10539	12673	208	10331	0	5229	4335	256	343	0	82	44	42	0
경기도	의정부시	가능1동	계	20541	8767	11774	217	8550	0	4673	3301	214	242	0	36	49	35	0
경기도	의정부시	가능2동	계	7844	3171	4673	89	3082	0	1665	1206	66	77	0	24	27	17	0
경기도	의정부시	가능3동	계	8972	3979	4993	118	3861	0	2116	1493	96	86	0	24	27	19	0
경기도	의정부시	녹양동	계	17547	8222	9325	141	8081	0	4077	3398	205	273	0	50	54	24	0
경기도	안양시만안구	관외사전투표		8768	8765	3	121	8644	0	3692	4211	263	305	0	81	53	39	0
경기도	안양시만안구	거소우편투표		395	373	22	13	360	0	188	128	17	9	0	6	5	7	0
경기도	안양시만안구	안양1동	계	14412	8650	5762	118	8532	0	3988	3853	237	348	0	35	44	27	0
경기도	안양시만안구	안양2동	계	19245	9338	9907	334	9004	0	4632	3793	230	263	0	32	35	19	0
경기도	안양시만안구	안양3동	계	14814	7333	7481	157	7176	0	3523	3174	199	182	0	30	36	32	0
경기도	안양시만안구	안양4동	계	5930	3204	2726	78	3126	0	1673	1229	80	110	0	9	11	14	0
경기도	안양시만안구	안양5동	계	11892	5783	6109	87	5696	0	3066	2271	127	151	0	22	28	31	0
경기도	안양시만안구	안양6동	계	17085	8234	8851	291	7943	0	4055	3357	191	236	0	37	36	31	0
경기도	안양시만안구	안양7동	계	3384	1597	1787	64	1533	0	714	693	47	55	0	13	7	4	0
경기도	안양시만안구	안양8동	계	9947	4897	5050	276	4621	0	2233	2062	114	150	0	24	25	13	0
경기도	안양시만안구	안양9동	계	14334	7557	6777	151	7406	0	3766	3097	205	239	0	32	22	45	0
경기도	안양시만안구	석수1동	계	15922	9578	6344	264	9314	0	4154	4394	251	389	0	38	61	27	0
경기도	안양시만안구	석수2동	계	26892	15198	11694	478	14720	0	6696	6833	410	591	0	80	63	47	0
경기도	안양시만안구	석수3동	계	11975	6052	5923	296	5756	0	2533	2710	187	216	0	39	45	26	0
경기도	안양시만안구	박달1동	계	14041	6864	7177	252	6612	0	3235	2883	230	172	0	33	29	30	0
경기도	안양시만안구	박달2동	계	16963	9890	7073	272	9618	0	4522	4289	338	331	0	39	62	37	0
경기도	안양시동안구	관외사전투표		12762	12761	1	216	12545	0	5124	6193	417	523	0	101	126	61	0
경기도	안양시동안구	거소우편투표		442	430	12	17	413	0	230	150	12	9	0	4	4	4	0
경기도	안양시동안구	비산1동	계	20129	12524	7605	317	12207	0	5784	5551	305	417	0	51	67	32	0
경기도	안양시동안구	비산2동	계	11020	6786	4234	220	6566	0	3103	2963	158	271	0	24	32	15	0
경기도	안양시동안구	비산3동	계	19812	10815	8997	442	10373	0	5008	4552	284	369	0	45	78	37	0
경기도	안양시동안구	부흥동	계	14068	8727	5341	186	8541	0	3594	4115	279	447	0	38	47	21	0
경기도	안양시동안구	달안동	계	9925	5543	4382	166	5377	0	1937	2852	204	304	0	31	30	19	0
경기도	안양시동안구	관양1동	계	31006	16757	14249	473	16284	0	7358	7595	455	654	0	83	77	62	0
경기도	안양시동안구	관양2동	계	12863	6432	6431	330	6102	0	2694	2871	176	267	0	28	48	18	0
경기도	안양시동안구	부림동	계	19509	11292	8217	375	10917	0	3956	5676	425	713	0	57	66	24	0
경기도	안양시동안구	평촌동	계	12071	7529	4542	129	7400	0	3061	3538	211	505	0	25	43	17	0
경기도	안양시동안구	평안동	계	17920	11554	6366	146	11408	0	4385	5787	348	752	0	52	60	24	0
경기도	안양시동안구	귀인동	계	12346	7879	4467	98	7781	0	3691	3322	235	435	0	21	56	21	0
경기도	안양시동안구	호계1동	계	13880	6850	7030	284	6566	0	3192	2886	157	223	0	41	35	32	0
경기도	안양시동안구	호계2동	계	21374	12231	9143	327	11904	0	5483	5487	329	457	0	62	60	26	0
경기도	안양시동안구	호계3동	계	19223	10309	8914	304	10005	0	4711	4548	285	352	0	33	47	29	0
경기도	안양시동안구	범계동	계	12081	7711	4370	104	7607	0	3655	3203	183	485	0	21	42	18	0
경기도	안양시동안구	신촌동	계	10693	6641	4052	155	6486	0	2909	2975	209	312	0	15	49	17	0
경기도	안양시동안구	갈산동	계	9222	5586	3636	122	5464	0	2863	2109	134	282	0	20	47	9	0
경기도	부천시원미구	관외사전투표		16905	16863	42	291	16572	0	6445	8292	709	676	0	169	178	103	0
경기도	부천시원미구	거소우편투표		620	588	32	24	564	0	266	234	26	17	0	9	8	4	0
경기도	부천시원미구	심곡1동	계	11663	4830	6833	71	4759	0	2148	2192	205	151	0	32	18	13	0
경기도	부천시원미구	심곡2동	계	15720	6029	9691	106	5923	0	2552	2798	266	215	0	34	35	23	0
경기도	부천시원미구	심곡3동	계	11491	4893	6598	93	4800	0	2250	2158	174	146	0	33	19	20	0
경기도	부천시원미구	원미1동	계	14633	6933	7700	163	6770	0	3074	3158	237	208	0	33	33	27	0
경기도	부천시원미구	원미2동	계	12024	5612	6412	95	5517	0	2605	2428	239	133	0	43	34	35	0
경기도	부천시원미구	소사동	계	8448	3694	4754	64	3630	0	1713	1595	157	102	0	25	20	18	0
경기도	부천시원미구	역곡1동	계	15686	8090	7596	138	7952	0	3403	3899	221	317	0	40	48	24	0
경기도	부천시원미구	역곡2동	계	16537	8265	8272	142	8123	0	3192	4175	274	340	0	58	48	36	0
경기도	부천시원미구	춘의동	계	11797	5401	6396	127	5274	0	2467	2437	149	141	0	36	25	19	0
경기도	부천시원미구	도당동	계	19700	8503	11197	192	8311	0	3787	3950	232	207	0	61	31	43	0
경기도	부천시원미구	약대동	계	11447	5454	5993	97	5357	0	2250	2624	170	208	0	34	34	37	0
경기도	부천시원미구	중동	계	20560	10022	10538	191	9831	0	4361	4636	278	364	0	85	55	52	0
경기도	부천시원미구	중1동	계	26777	14000	12777	235	13765	0	5630	6789	467	657	0	78	71	73	0
경기도	부천시원미구	중2동	계	24899	13230	11669	182	13048	0	6413	5580	391	470	0	58	71	65	0
경기도	부천시원미구	중3동	계	19114	9940	9174	155	9785	0	4263	4611	336	420	0	53	48	54	0
경기도	부천시원미구	중4동	계	16926	9185	7741	145	9040	0	3760	4449	270	403	0	60	51	47	0
경기도	부천시원미구	상동	계	16501	8245	8256	148	8097	0	3836	3544	246	315	0	71	53	32	0
경기도	부천시원미구	상1동	계	20163	11255	8908	127	11128	0	4134	5792	405	589	0	95	61	52	0
경기도	부천시원미구	상2동	계	22724	13093	9631	150	12943	0	5026	6526	473	729	0	87	70	32	0
경기도	부천시원미구	상3동	계	24118	14260	9858	165	14095	0	6088	6851	424	542	0	99	56	35	0
경기도	부천시소사구	관외사전투표		8221	8217	4	141	8076	0	3238	3994	313	301	0	88	91	51	0
경기도	부천시소사구	거소우편투표		354	312	42	52	260	0	136	97	9	7	0	3	5	3	0
경기도	부천시소사구	심곡본1동	계	16565	7228	9337	179	7049	0	3331	3172	214	209	0	42	38	43	0
경기도	부천시소사구	심곡본동	계	15753	7478	8275	156	7322	0	3597	3182	206	221	0	51	38	27	0
경기도	부천시소사구	소사본동	계	21470	9914	11556	169	9745	0	4681	4350	253	318	0	69	39	35	0
경기도	부천시소사구	소사본3동	계	26912	14830	12082	213	14617	0	6322	7106	445	521	0	86	65	72	0
경기도	부천시소사구	범박동	계	17711	10594	7117	114	10480	0	4568	5071	285	417	0	43	60	36	0
경기도	부천시소사구	괴안동	계	17564	8815	8749	117	8698	0	3916	4071	260	312	0	38	49	52	0
경기도	부천시소사구	역곡3동	계	21633	10520	11113	162	10358	0	4502	4911	328	432	0	79	70	36	0
경기도	부천시소사구	송내1동	계	19458	10351	9107	149	10202	0	4461	4899	296	387	0	70	53	36	0
경기도	부천시소사구	송내2동	계	22305	11609	10696	207	11402	0	5067	5321	355	473	0	83	62	41	0
경기도	부천시오정구	관외사전투표		5728	5728	0	118	5610	0	2245	2769	243	208	0	55	56	34	0
경기도	부천시오정구	거소우편투표		286	276	10	10	266	0	130	103	14	4	0	8	4	3	0
경기도	부천시오정구	성곡동	계	34890	16401	18489	366	16035	0	7034	7653	535	582	0	92	73	66	0
경기도	부천시오정구	원종1동	계	19403	8308	11095	206	8102	0	3777	3755	242	228	0	34	40	26	0
경기도	부천시오정구	원종2동	계	19335	8532	10803	254	8278	0	3511	4069	236	318	0	53	43	48	0
경기도	부천시오정구	고강본동	계	24932	10238	14694	291	9947	0	4378	4794	318	307	0	63	39	48	0
경기도	부천시오정구	고강1동	계	13080	5587	7493	174	5413	0	2402	2616	167	153	0	22	33	20	0
경기도	부천시오정구	오정동	계	18381	8606	9775	268	8338	0	3768	3892	262	305	0	37	44	30	0
경기도	부천시오정구	신흥동	계	16269	6607	9662	248	6359	0	2952	2962	174	163	0	40	39	29	0
경기도	광명시	관외사전투표		11354	11344	10	161	11183	0	4290	5815	360	489	0	88	81	60	0
경기도	광명시	거소우편투표		401	385	16	22	363	0	188	140	14	17	0	3	1	0	0
경기도	광명시	광명1동	계	12286	5766	6520	160	5606	0	2586	2610	141	189	0	27	24	29	0
경기도	광명시	광명2동	계	9767	4673	5094	113	4560	0	2056	2191	123	128	0	18	21	23	0
경기도	광명시	광명3동	계	9183	4201	4982	118	4083	0	1793	1982	110	142	0	20	16	20	0
경기도	광명시	광명4동	계	13059	6739	6320	117	6622	0	3010	3036	194	320	0	28	22	12	0
경기도	광명시	광명5동	계	12778	6408	6370	92	6316	0	2731	3003	179	329	0	19	32	23	0
경기도	광명시	광명6동	계	12233	6566	5667	152	6414	0	2898	2915	164	347	0	33	25	32	0
경기도	광명시	광명7동	계	19935	10072	9863	241	9831	0	4289	4578	311	510	0	44	49	50	0
경기도	광명시	철산1동	계	10439	6084	4355	126	5958	0	2312	3115	170	266	0	33	43	19	0
경기도	광명시	철산2동	계	13792	6993	6799	150	6843	0	2908	3302	222	313	0	39	35	24	0
경기도	광명시	철산3동	계	28010	17623	10387	239	17384	0	7258	8466	557	876	0	66	114	47	0
경기도	광명시	철산4동	계	11885	6613	5272	94	6519	0	2414	3337	241	428	0	39	39	21	0
경기도	광명시	하안1동	계	20897	12258	8639	199	12059	0	4732	6100	406	629	0	49	97	46	0
경기도	광명시	하안2동	계	12352	6954	5398	156	6798	0	2314	3764	243	378	0	39	35	25	0
경기도	광명시	하안3동	계	18045	10185	7860	260	9925	0	3923	4971	430	453	0	66	50	32	0
경기도	광명시	하안4동	계	10216	6055	4161	57	5998	0	2123	3223	228	350	0	29	24	21	0
경기도	광명시	소하1동	계	23507	13882	9625	230	13652	0	5238	6958	603	665	0	81	65	42	0
경기도	광명시	소하2동	계	25590	14138	11452	307	13831	0	5884	6700	568	467	0	89	70	53	0
경기도	광명시	학온동	계	2308	1260	1048	25	1235	0	834	343	28	20	0	2	5	3	0
경기도	평택시	관외사전투표		15261	15250	11	225	15025	0	7286	6313	676	392	0	150	130	78	0
경기도	평택시	거소우편투표		1233	1198	35	61	1137	0	718	309	38	24	0	14	19	15	0
경기도	평택시	팽성읍	계	24888	10751	14137	386	10365	0	6630	3114	295	175	0	59	43	49	0
경기도	평택시	안중읍	계	27484	13232	14252	294	12938	0	6004	5676	632	338	0	154	66	68	0
경기도	평택시	포승읍	계	19359	7560	11799	201	7359	0	4058	2780	242	172	0	46	28	33	0
경기도	평택시	진위면	계	10332	4738	5594	171	4567	0	2617	1653	118	84	0	42	25	28	0
경기도	평택시	서탄면	계	3294	1660	1634	77	1583	0	1054	444	35	24	0	12	7	7	0
경기도	평택시	고덕면	계	10070	4634	5436	166	4468	0	2571	1596	137	88	0	39	17	20	0
경기도	평택시	오성면	계	5568	2800	2768	137	2663	0	1781	693	67	49	0	41	17	15	0
경기도	평택시	청북면	계	14258	6295	7963	156	6139	0	2938	2705	227	166	0	44	23	36	0
경기도	평택시	현덕면	계	5202	2744	2458	138	2606	0	1822	643	63	37	0	13	9	19	0
경기도	평택시	중앙동	계	33846	17267	16579	768	16499	0	8242	6809	768	411	0	119	75	75	0
경기도	평택시	서정동	계	24312	9717	14595	559	9158	0	5088	3429	306	211	0	46	35	43	0
경기도	평택시	송탄동	계	11092	5735	5357	95	5640	0	2839	2329	241	141	0	46	23	21	0
경기도	평택시	지산동	계	8314	3570	4744	89	3481	0	1859	1377	96	94	0	24	17	14	0
경기도	평택시	송북동	계	16865	8027	8838	224	7803	0	4238	2997	273	181	0	47	36	31	0
경기도	평택시	신장1동	계	4851	1937	2914	83	1854	0	1142	604	48	37	0	7	8	8	0
경기도	평택시	신장2동	계	6155	2576	3579	121	2455	0	1691	658	44	39	0	11	8	4	0
경기도	평택시	신평동	계	18965	8609	10356	335	8274	0	4749	2896	332	183	0	36	43	35	0
경기도	평택시	원평동	계	10461	4917	5544	169	4748	0	2623	1724	179	133	0	38	25	26	0
경기도	평택시	통복동	계	4055	1888	2167	74	1814	0	1148	569	40	29	0	8	9	11	0
경기도	평택시	비전1동	계	18921	9010	9911	236	8774	0	4835	3248	356	221	0	52	33	29	0
경기도	평택시	비전2동	계	35380	18067	17313	450	17617	0	9220	6839	798	507	0	111	87	55	0
경기도	평택시	세교동	계	17443	9062	8381	207	8855	0	4647	3524	331	181	0	87	40	45	0
경기도	양주시	관외사전투표		6969	6965	4	117	6848	0	3148	3127	220	181	0	55	72	45	0
경기도	양주시	거소우편투표		445	414	31	49	365	0	203	96	18	9	0	15	8	16	0
경기도	양주시	백석읍	계	22205	10795	11410	241	10554	0	6135	3904	183	191	0	47	37	57	0
경기도	양주시	은현면	계	5892	2887	3005	80	2807	0	1898	792	40	45	0	16	6	10	0
경기도	양주시	남면	계	6178	3057	3121	112	2945	0	2015	785	42	52	0	13	10	28	0
경기도	양주시	광적면	계	9511	4675	4836	133	4542	0	2865	1480	74	60	0	19	23	21	0
경기도	양주시	장흥면	계	8397	4186	4211	75	4111	0	2683	1252	72	64	0	14	12	14	0
경기도	양주시	양주1동	계	5481	2699	2782	86	2613	0	1591	896	60	41	0	8	7	10	0
경기도	양주시	양주2동	계	37077	17981	19096	355	17626	0	8141	8152	498	619	0	92	55	69	0
경기도	양주시	회천1동	계	6499	3158	3341	79	3079	0	1814	1083	76	61	0	12	15	18	0
경기도	양주시	회천2동	계	22104	10064	12040	186	9878	0	5021	4285	244	204	0	35	35	54	0
경기도	양주시	회천3동	계	20793	10637	10156	200	10437	0	5077	4628	352	264	0	51	36	29	0
경기도	양주시	회천4동	계	3817	1703	2114	40	1663	0	979	590	33	40	0	6	7	8	0
경기도	동두천시	관외사전투표		3370	3369	1	62	3307	0	1502	1535	108	98	0	29	22	13	0
경기도	동두천시	거소우편투표		208	197	11	9	188	0	112	66	4	1	0	2	1	2	0
경기도	동두천시	생연1동	계	6021	2780	3241	120	2660	0	1651	876	49	51	0	17	10	6	0
경기도	동두천시	생연2동	계	9530	4926	4604	195	4731	0	2724	1712	88	134	0	21	19	33	0
경기도	동두천시	중앙동	계	5243	2472	2771	87	2385	0	1540	719	44	47	0	10	11	14	0
경기도	동두천시	보산동	계	2981	1221	1760	42	1179	0	733	374	29	26	0	6	2	9	0
경기도	동두천시	불현동	계	20236	9561	10675	318	9243	0	5259	3362	215	249	0	68	25	65	0
경기도	동두천시	송내동	계	18365	9102	9263	263	8839	0	4522	3754	217	220	0	45	32	49	0
경기도	동두천시	소요동	계	7623	3783	3840	134	3649	0	2332	1091	59	74	0	44	29	20	0
경기도	동두천시	상패동	계	4875	2421	2454	147	2274	0	1398	728	58	58	0	11	7	14	0
경기도	안산시상록구	관외사전투표		11867	11861	6	239	11622	0	4472	5777	570	434	0	146	145	78	0
경기도	안산시상록구	거소우편투표		481	450	31	15	435	0	206	169	18	15	0	7	13	7	0
경기도	안산시상록구	일동	계	20953	8612	12341	139	8473	0	3647	4083	295	275	0	73	63	37	0
경기도	안산시상록구	이동	계	23741	9810	13931	123	9687	0	4133	4656	366	352	0	78	62	40	0
경기도	안산시상록구	사1동	계	29436	13018	16418	276	12742	0	5127	6455	443	506	0	79	68	64	0
경기도	안산시상록구	사2동	계	26081	12505	13576	244	12261	0	5377	5865	421	402	0	65	71	60	0
경기도	안산시상록구	사3동	계	14933	8452	6481	78	8374	0	3917	3841	242	275	0	33	31	35	0
경기도	안산시상록구	본오1동	계	32002	12364	19638	260	12104	0	5185	5816	557	352	0	72	60	62	0
경기도	안산시상록구	본오2동	계	23674	11341	12333	147	11194	0	4870	5278	503	371	0	83	45	44	0
경기도	안산시상록구	본오3동	계	18754	8751	10003	109	8642	0	3743	4156	313	303	0	52	47	28	0
경기도	안산시상록구	부곡동	계	17449	7407	10042	192	7215	0	3165	3511	233	175	0	45	46	40	0
경기도	안산시상록구	월피동	계	34235	15402	18833	343	15059	0	6376	7473	513	454	0	117	67	59	0
경기도	안산시상록구	성포동	계	21886	12412	9474	135	12277	0	5595	5679	389	426	0	69	71	48	0
경기도	안산시상록구	반월동	계	16408	8552	7856	150	8402	0	3971	3696	321	288	0	47	39	40	0
경기도	안산시상록구	안산동	계	8010	3700	4310	119	3581	0	1832	1499	102	90	0	23	18	17	0
경기도	안산시단원구	관외사전투표		9875	9870	5	191	9679	0	3966	4663	449	333	0	99	101	68	0
경기도	안산시단원구	거소우편투표		700	665	35	23	642	0	348	230	23	19	0	4	8	10	0
경기도	안산시단원구	와동	계	34583	12793	21790	314	12479	0	5311	6144	443	341	0	113	64	63	0
경기도	안산시단원구	고잔1동	계	17814	8358	9456	224	8134	0	3483	3944	293	255	0	72	46	41	0
경기도	안산시단원구	고잔2동	계	18918	9419	9499	115	9304	0	3841	4618	315	368	0	70	58	34	0
경기도	안산시단원구	호수동	계	32580	18575	14005	204	18371	0	8098	8792	582	693	0	84	69	53	0
경기도	안산시단원구	원곡본동	계	27221	10645	16576	396	10249	0	4707	4774	286	289	0	95	56	42	0
경기도	안산시단원구	원곡1동	계	7795	3096	4699	50	3046	0	1544	1321	62	68	0	22	15	14	0
경기도	안산시단원구	원곡2동	계	12428	6709	5719	132	6577	0	2988	3160	178	155	0	44	23	29	0
경기도	안산시단원구	초지동	계	34353	17106	17247	365	16741	0	6924	8427	547	601	0	101	86	55	0
경기도	안산시단원구	선부1동	계	13514	5956	7558	267	5689	0	2453	2722	198	184	0	50	36	46	0
경기도	안산시단원구	선부2동	계	18360	6829	11531	220	6609	0	2970	3143	205	158	0	68	32	33	0
경기도	안산시단원구	선부3동	계	26813	11899	14914	316	11583	0	4979	5680	367	323	0	112	64	58	0
경기도	안산시단원구	대부동	계	6146	2867	3279	83	2784	0	1966	705	42	46	0	9	9	7	0
경기도	고양시덕양구	관외사전투표		15670	15663	7	258	15405	0	6474	6972	644	887	0	184	166	78	0
경기도	고양시덕양구	거소우편투표		847	795	52	53	742	0	370	250	45	31	0	11	16	19	0
경기도	고양시덕양구	주교동	계	14734	6633	8101	238	6395	0	3307	2416	181	346	0	76	25	44	0
경기도	고양시덕양구	원신동	계	9852	5128	4724	150	4978	0	2273	2026	128	472	0	43	26	10	0
경기도	고양시덕양구	흥도동	계	10935	5885	5050	132	5753	0	2504	2305	170	672	0	53	30	19	0
경기도	고양시덕양구	성사1동	계	20381	10316	10065	194	10122	0	4801	4159	300	660	0	93	50	59	0
경기도	고양시덕양구	성사2동	계	9826	5712	4114	160	5552	0	2679	2219	158	402	0	59	18	17	0
경기도	고양시덕양구	효자동	계	2101	949	1152	33	916	0	608	251	17	24	0	4	9	3	0
경기도	고양시덕양구	신도동	계	6241	3374	2867	97	3277	0	1874	1133	66	131	0	32	28	13	0
경기도	고양시덕양구	창릉동	계	7926	4267	3659	59	4208	0	2027	1824	104	196	0	31	17	9	0
경기도	고양시덕양구	고양동	계	24873	11700	13173	315	11385	0	5718	4318	339	777	0	128	58	47	0
경기도	고양시덕양구	관산동	계	24955	10856	14099	303	10553	0	5763	3762	300	518	0	87	52	71	0
경기도	고양시덕양구	능곡동	계	15665	7732	7933	133	7599	0	3783	2985	341	369	0	47	50	24	0
경기도	고양시덕양구	화정1동	계	32520	17817	14703	438	17379	0	8213	6971	481	1455	0	139	88	32	0
경기도	고양시덕양구	화정2동	계	26082	15264	10818	302	14962	0	5696	6886	537	1503	0	195	97	48	0
경기도	고양시덕양구	행주동	계	17979	7534	10445	215	7319	0	3584	2978	340	315	0	50	30	22	0
경기도	고양시덕양구	행신1동	계	19023	10558	8465	192	10366	0	4453	4828	312	587	0	91	66	29	0
경기도	고양시덕양구	행신2동	계	27575	15211	12364	222	14989	0	6253	6744	760	989	0	95	110	38	0
경기도	고양시덕양구	행신3동	계	38080	20871	17209	319	20552	0	8471	9578	646	1353	0	254	193	57	0
경기도	고양시덕양구	화전동	계	4181	1890	2291	48	1842	0	1086	639	39	49	0	9	8	12	0
경기도	고양시덕양구	대덕동	계	3759	1888	1871	58	1830	0	1055	638	33	67	0	9	16	12	0
경기도	고양시일산동구	관외사전투표		11287	11247	40	188	11059	0	4603	5178	404	594	0	111	124	45	0
경기도	고양시일산동구	거소우편투표		490	471	19	33	438	0	250	131	19	14	0	7	6	11	0
경기도	고양시일산동구	식사동	계	20979	11181	9798	171	11010	0	5394	4684	258	536	0	59	58	21	0
경기도	고양시일산동구	중산동	계	33386	16667	16719	343	16324	0	7491	7202	436	904	0	140	95	56	0
경기도	고양시일산동구	정발산동	계	21671	10623	11048	188	10435	0	4731	4603	272	642	0	84	74	29	0
경기도	고양시일산동구	풍산동	계	28621	15061	13560	220	14841	0	6446	6863	389	897	0	110	104	32	0
경기도	고양시일산동구	백석1동	계	21231	11207	10024	155	11052	0	4569	5156	335	824	0	67	67	34	0
경기도	고양시일산동구	백석2동	계	18416	8720	9696	107	8613	0	3672	3955	236	596	0	59	70	25	0
경기도	고양시일산동구	마두1동	계	20369	11688	8681	164	11524	0	5226	5079	329	695	0	51	117	27	0
경기도	고양시일산동구	마두2동	계	13027	7961	5066	100	7861	0	3907	3106	187	542	0	32	68	19	0
경기도	고양시일산동구	장항1동	계	2583	1247	1336	25	1222	0	794	369	23	27	0	4	3	2	0
경기도	고양시일산동구	장항2동	계	21828	9598	12230	136	9462	0	4143	4198	263	713	0	48	78	19	0
경기도	고양시일산동구	고봉동	계	12668	5191	7477	125	5066	0	2988	1681	116	191	0	39	30	21	0
경기도	고양시일산서구	관외사전투표		10810	10805	5	184	10621	0	4435	4999	369	542	0	103	121	52	0
경기도	고양시일산서구	거소우편투표		480	463	17	15	448	0	246	151	16	15	0	3	10	7	0
경기도	고양시일산서구	일산1동	계	22169	10964	11205	179	10785	0	4852	5022	282	477	0	50	68	34	0
경기도	고양시일산서구	일산2동	계	17119	8422	8697	137	8285	0	3966	3601	236	382	0	36	44	20	0
경기도	고양시일산서구	일산3동	계	27675	16664	11011	203	16461	0	6551	8033	493	1148	0	77	120	39	0
경기도	고양시일산서구	탄현동	계	35814	18209	17605	300	17909	0	7521	8609	547	987	0	95	105	45	0
경기도	고양시일산서구	주엽1동	계	23077	13493	9584	145	13348	0	6079	5940	325	771	0	115	81	37	0
경기도	고양시일산서구	주엽2동	계	24484	14071	10413	194	13877	0	6438	6017	324	871	0	100	94	33	0
경기도	고양시일산서구	대화동	계	26131	13071	13060	143	12928	0	5834	5760	351	737	0	114	100	32	0
경기도	고양시일산서구	송포동	계	12681	7387	5294	117	7270	0	3664	2955	195	334	0	59	50	13	0
경기도	고양시일산서구	송산동	계	29295	14674	14621	171	14503	0	7010	6250	349	700	0	81	82	31	0
경기도	과천시	관외사전투표		2961	2960	1	40	2920	0	1241	1251	83	152	0	20	163	10	0
경기도	과천시	거소우편투표		90	82	8	4	78	0	39	29	2	0	0	1	4	3	0
경기도	과천시	중앙동	계	7826	5380	2446	105	5275	0	2565	1827	103	349	0	20	398	13	0
경기도	과천시	갈현동	계	10668	7080	3588	135	6945	0	3160	2675	146	516	0	36	401	11	0
경기도	과천시	별양동	계	11903	7802	4101	197	7605	0	3543	2785	130	551	0	47	534	15	0
경기도	과천시	부림동	계	10311	6868	3443	194	6674	0	2752	2669	131	523	0	40	538	21	0
경기도	과천시	과천동	계	6737	3694	3043	158	3536	0	1834	1277	63	167	0	35	150	10	0
경기도	과천시	문원동	계	5285	3466	1819	123	3343	0	1550	1233	69	220	0	22	236	13	0
경기도	의왕시	관외사전투표		5937	5932	5	104	5828	0	2519	2713	183	220	0	35	128	30	0
경기도	의왕시	거소우편투표		197	192	5	11	181	0	99	65	7	3	0	1	5	1	0
경기도	의왕시	고천동	계	10114	6212	3902	119	6093	0	3180	2450	133	165	0	24	121	20	0
경기도	의왕시	부곡동	계	20499	11453	9046	291	11162	0	5308	4888	259	310	0	138	222	37	0
경기도	의왕시	오전동	계	32148	18699	13449	347	18352	0	8342	8530	390	546	0	125	371	48	0
경기도	의왕시	내손1동	계	17060	9833	7227	247	9586	0	4433	4165	230	538	0	38	163	19	0
경기도	의왕시	내손2동	계	25914	14694	11220	298	14396	0	6290	6586	340	807	0	72	254	47	0
경기도	의왕시	청계동	계	15377	8961	6416	274	8687	0	3792	3797	233	569	0	38	230	28	0
경기도	구리시	관외사전투표		6573	6572	1	102	6470	0	2685	3214	237	201	0	55	56	22	0
경기도	구리시	거소우편투표		262	257	5	6	251	0	136	91	8	9	0	4	2	1	0
경기도	구리시	갈매동	계	1351	604	747	22	582	0	363	185	16	9	0	0	5	4	0
경기도	구리시	동구동	계	31211	17923	13288	410	17513	0	7835	8085	641	751	0	62	80	59	0
경기도	구리시	인창동	계	19486	10310	9176	229	10081	0	4755	4509	359	323	0	52	46	37	0
경기도	구리시	교문1동	계	14570	6551	8019	204	6347	0	3424	2472	179	173	0	28	36	35	0
경기도	구리시	교문2동	계	17846	10569	7277	177	10392	0	4890	4678	301	387	0	53	48	35	0
경기도	구리시	수택1동	계	19140	8376	10764	274	8102	0	4104	3414	222	246	0	44	35	37	0
경기도	구리시	수택2동	계	21636	9945	11691	322	9623	0	4777	4134	276	248	0	81	54	53	0
경기도	구리시	수택3동	계	17878	9486	8392	187	9299	0	4229	4277	311	373	0	41	43	25	0
경기도	남양주시	관외사전투표		18665	18659	6	310	18349	0	7986	8733	584	617	0	156	167	106	0
경기도	남양주시	거소우편투표		660	630	30	52	578	0	300	203	18	23	0	10	16	8	0
경기도	남양주시	와부읍	계	52859	28934	23925	668	28266	0	13714	12330	692	1156	0	125	149	100	0
경기도	남양주시	진접읍	계	69658	29751	39907	938	28813	0	13739	13078	689	964	0	142	107	94	0
경기도	남양주시	화도읍	계	72250	30585	41665	538	30047	0	14768	13255	668	931	0	154	153	118	0
경기도	남양주시	진건읍	계	22388	10055	12333	401	9654	0	5271	3730	273	243	0	53	45	39	0
경기도	남양주시	오남읍	계	40162	17345	22817	596	16749	0	7845	7721	443	528	0	71	70	71	0
경기도	남양주시	별내면	계	16546	8256	8290	355	7901	0	3727	3514	238	313	0	37	40	32	0
경기도	남양주시	퇴계원면	계	23542	11355	12187	458	10897	0	5372	4732	322	333	0	56	52	30	0
경기도	남양주시	수동면	계	7066	3376	3690	131	3245	0	2085	967	62	55	0	20	27	29	0
경기도	남양주시	조안면	계	3430	1845	1585	87	1758	0	1104	537	34	44	0	8	21	10	0
경기도	남양주시	호평동	계	31185	15303	15882	191	15112	0	6330	7520	418	626	0	66	90	62	0
경기도	남양주시	평내동	계	29555	14680	14875	368	14312	0	6130	7042	395	524	0	68	107	46	0
경기도	남양주시	금곡동	계	17959	8087	9872	251	7836	0	4325	3061	158	193	0	33	38	28	0
경기도	남양주시	양정동	계	4604	2241	2363	101	2140	0	1311	722	39	37	0	11	9	11	0
경기도	남양주시	지금동	계	12652	6247	6405	239	6008	0	2826	2705	182	218	0	33	28	16	0
경기도	남양주시	도농동	계	29220	15937	13283	499	15438	0	7898	6404	443	518	0	66	60	49	0
경기도	남양주시	별내동	계	31897	16156	15741	315	15841	0	6968	7675	424	605	0	49	70	50	0
경기도	오산시	관외사전투표		6843	6837	6	110	6727	0	2771	3304	281	224	0	48	61	38	0
경기도	오산시	거소우편투표		214	208	6	8	200	0	113	73	5	0	0	4	1	4	0
경기도	오산시	중앙동	계	21330	11074	10256	261	10813	0	5186	4739	382	342	0	62	51	51	0
경기도	오산시	대원동	계	46324	22672	23652	592	22080	0	9842	10390	808	722	0	129	95	94	0
경기도	오산시	남촌동	계	19048	5551	13497	170	5381	0	2468	2457	197	162	0	38	32	27	0
경기도	오산시	신장동	계	37046	16443	20603	489	15954	0	7373	7259	587	498	0	90	70	77	0
경기도	오산시	세마동	계	12873	7037	5836	188	6849	0	2997	3241	271	233	0	35	42	30	0
경기도	오산시	초평동	계	12275	5535	6740	190	5345	0	2411	2511	195	137	0	47	16	28	0
경기도	화성시	관외사전투표		17192	17160	32	254	16906	0	7709	7572	702	590	0	108	136	89	0
경기도	화성시	거소우편투표		721	686	35	62	624	0	327	175	46	28	0	21	12	15	0
경기도	화성시	봉담읍	계	47180	22537	24643	420	22117	0	9988	10180	1046	639	0	108	90	66	0
경기도	화성시	우정읍	계	13636	6677	6959	199	6478	0	3807	2008	389	146	0	62	23	43	0
경기도	화성시	향남읍	계	40463	17786	22677	417	17369	0	7634	7727	1194	551	0	120	90	53	0
경기도	화성시	매송면	계	7003	3419	3584	75	3344	0	2082	1044	109	63	0	22	11	13	0
경기도	화성시	비봉면	계	5010	2460	2550	57	2403	0	1698	602	50	26	0	12	5	10	0
경기도	화성시	마도면	계	5218	2433	2785	42	2391	0	1625	658	43	39	0	14	9	3	0
경기도	화성시	송산면	계	8893	3946	4947	109	3837	0	2793	891	58	48	0	18	13	16	0
경기도	화성시	서신면	계	5700	2580	3120	54	2526	0	1853	590	30	30	0	5	6	12	0
경기도	화성시	팔탄면	계	8879	3799	5080	90	3709	0	2318	1188	116	53	0	10	9	15	0
경기도	화성시	장안면	계	8972	4073	4899	149	3924	0	2476	1127	163	79	0	32	16	31	0
경기도	화성시	양감면	계	3659	1761	1898	134	1627	0	1075	468	42	18	0	5	8	11	0
경기도	화성시	정남면	계	10330	4463	5867	151	4312	0	2722	1326	122	83	0	26	17	16	0
경기도	화성시	동탄면	계	3236	1458	1778	31	1427	0	799	525	44	41	0	5	5	8	0
경기도	화성시	남양동	계	18287	8194	10093	144	8050	0	4441	3025	291	191	0	33	35	34	0
경기도	화성시	진안동	계	26471	11309	15162	358	10951	0	4388	5556	430	427	0	54	51	45	0
경기도	화성시	병점1동	계	19975	10013	9962	214	9799	0	3920	5068	403	309	0	42	28	29	0
경기도	화성시	병점2동	계	17959	9387	8572	265	9122	0	3355	4788	529	345	0	42	39	24	0
경기도	화성시	반월동	계	13666	7632	6034	116	7516	0	3311	3583	294	253	0	27	29	19	0
경기도	화성시	기배동	계	10332	4973	5359	129	4844	0	2196	2282	188	125	0	23	15	15	0
경기도	화성시	화산동	계	17887	8141	9746	263	7878	0	3814	3492	241	223	0	40	31	37	0
경기도	화성시	동탄1동	계	33998	19129	14869	164	18965	0	6634	10504	696	957	0	66	69	39	0
경기도	화성시	동탄2동	계	23340	13271	10069	132	13139	0	4958	6853	513	655	0	60	60	40	0
경기도	화성시	동탄3동	계	27344	14357	12987	109	14248	0	4299	8411	578	796	0	60	56	48	0
경기도	시흥시	관외사전투표		11802	11791	11	172	11619	0	5050	5562	350	318	0	118	135	86	0
경기도	시흥시	거소우편투표		522	509	13	27	482	0	255	159	28	22	0	3	9	6	0
경기도	시흥시	대야동	계	27204	13848	13356	374	13474	0	6625	5970	247	437	0	65	84	46	0
경기도	시흥시	신천동	계	33018	15031	17987	503	14528	0	7019	6593	343	370	0	83	57	63	0
경기도	시흥시	신현동	계	9435	4946	4489	123	4823	0	2778	1805	104	86	0	16	20	14	0
경기도	시흥시	은행동	계	22327	12075	10252	332	11743	0	5146	5762	281	373	0	77	60	44	0
경기도	시흥시	매화동	계	10243	4851	5392	96	4755	0	2366	2118	120	94	0	23	18	16	0
경기도	시흥시	목감동	계	8822	4566	4256	71	4495	0	2548	1712	98	88	0	15	22	12	0
경기도	시흥시	군자동	계	19895	8368	11527	192	8176	0	3981	3659	228	162	0	62	39	45	0
경기도	시흥시	정왕본동	계	20810	5069	15741	105	4964	0	2208	2399	130	147	0	40	20	20	0
경기도	시흥시	정왕1동	계	23566	7847	15719	171	7676	0	3326	3841	206	199	0	52	27	25	0
경기도	시흥시	정왕2동	계	25607	11654	13953	163	11491	0	4731	6022	301	290	0	60	46	41	0
경기도	시흥시	정왕3동	계	20075	8177	11898	146	8031	0	3456	4018	211	231	0	42	40	33	0
경기도	시흥시	정왕4동	계	17063	8768	8295	121	8647	0	3480	4510	250	295	0	43	44	25	0
경기도	시흥시	과림동	계	2173	1129	1044	41	1088	0	723	318	15	24	0	2	2	4	0
경기도	시흥시	연성동	계	17559	9659	7900	168	9491	0	4148	4649	282	300	0	48	28	36	0
경기도	시흥시	능곡동	계	11280	5976	5304	82	5894	0	2639	2804	193	194	0	28	22	14	0
경기도	시흥시	월곶동	계	12370	5572	6798	92	5480	0	2441	2641	148	182	0	23	22	23	0
경기도	시흥시	장곡동	계	12477	7022	5455	78	6944	0	2725	3737	204	197	0	35	25	21	0
경기도	군포시	관외사전투표		10427	10425	2	137	10288	0	4031	5316	340	387	0	72	86	56	0
경기도	군포시	거소우편투표		326	321	5	12	309	0	159	128	3	5	0	5	7	2	0
경기도	군포시	군포1동	계	27702	13615	14087	210	13405	0	6324	6186	307	356	0	123	56	53	0
경기도	군포시	군포2동	계	37179	21502	15677	397	21105	0	8882	10507	540	774	0	220	106	76	0
경기도	군포시	산본1동	계	16687	8196	8491	176	8020	0	3780	3666	195	262	0	37	47	33	0
경기도	군포시	산본2동	계	22645	13903	8742	236	13667	0	6076	6373	396	642	0	55	90	35	0
경기도	군포시	금정동	계	15810	7242	8568	155	7087	0	3248	3356	171	217	0	32	34	29	0
경기도	군포시	재궁동	계	17812	9692	8120	252	9440	0	3922	4601	298	488	0	31	61	39	0
경기도	군포시	오금동	계	18693	11522	7171	245	11277	0	4262	5865	410	577	0	56	64	43	0
경기도	군포시	수리동	계	15176	9064	6112	223	8841	0	3791	4159	307	442	0	51	60	31	0
경기도	군포시	궁내동	계	15814	9821	5993	181	9640	0	4032	4675	309	503	0	47	57	17	0
경기도	군포시	광정동	계	20245	12069	8176	273	11796	0	5127	5550	358	601	0	44	74	42	0
경기도	군포시	대야동	계	7382	4415	2967	72	4343	0	1854	2048	124	198	0	61	45	13	0
경기도	하남시	관외사전투표		5763	5759	4	86	5673	0	2629	2554	194	193	0	36	41	26	0
경기도	하남시	거소우편투표		206	201	5	12	189	0	100	63	12	7	0	0	3	4	0
경기도	하남시	천현동	계	6734	3312	3422	178	3134	0	1937	1003	81	76	0	6	15	16	0
경기도	하남시	신장1동	계	5887	2822	3065	149	2673	0	1401	1073	88	69	0	18	10	14	0
경기도	하남시	신장2동	계	34486	19902	14584	536	19366	0	9920	8004	604	632	0	64	73	69	0
경기도	하남시	덕풍1동	계	14533	7513	7020	202	7311	0	3700	3069	229	232	0	34	22	25	0
경기도	하남시	덕풍2동	계	17650	8840	8810	258	8582	0	4576	3399	258	246	0	36	39	28	0
경기도	하남시	덕풍3동	계	19479	10485	8994	314	10171	0	5116	4202	367	375	0	27	42	42	0
경기도	하남시	풍산동	계	2051	823	1228	31	792	0	497	257	19	10	0	3	4	2	0
경기도	하남시	감북동	계	5192	2348	2844	102	2246	0	1386	740	42	50	0	11	9	8	0
경기도	하남시	춘궁동	계	3274	1775	1499	82	1693	0	1147	453	43	35	0	9	3	3	0
경기도	하남시	초이동	계	3011	1522	1489	53	1469	0	900	506	23	30	0	3	6	1	0
경기도	파주시	관외사전투표		15384	15393	-9	242	15151	0	6929	6470	714	646	0	117	188	87	0
경기도	파주시	거소우편투표		925	889	36	39	850	0	488	255	38	24	0	15	16	14	0
경기도	파주시	문산읍	계	34903	16863	18040	614	16249	0	9163	5940	519	374	0	109	69	75	0
경기도	파주시	조리읍	계	24392	12024	12368	414	11610	0	6484	4339	322	319	0	54	53	39	0
경기도	파주시	법원읍	계	10506	5142	5364	331	4811	0	3224	1260	134	80	0	43	25	45	0
경기도	파주시	파주읍	계	11659	5703	5956	299	5404	0	3480	1586	131	107	0	57	16	27	0
경기도	파주시	광탄면	계	10311	4830	5481	235	4595	0	2998	1350	103	77	0	22	16	29	0
경기도	파주시	탄현면	계	10843	5223	5620	170	5053	0	2810	1701	199	219	0	52	57	15	0
경기도	파주시	월롱면	계	12951	5765	7186	208	5557	0	1994	2781	411	167	0	84	54	66	0
경기도	파주시	적성면	계	6394	3215	3179	178	3037	0	2133	763	61	41	0	11	12	16	0
경기도	파주시	파평면	계	3616	2099	1517	116	1983	0	1380	479	43	38	0	15	16	12	0
경기도	파주시	군내면	계	529	375	154	24	351	0	232	96	9	8	0	1	1	4	0
경기도	파주시	진동면	계	145	103	42	4	99	0	63	32	1	1	0	0	2	0	0
경기도	파주시	교하동	계	29193	14622	14571	336	14286	0	6195	6435	649	754	0	67	142	44	0
경기도	파주시	운정1동	계	23112	11738	11374	164	11574	0	4945	5517	460	490	0	69	59	34	0
경기도	파주시	운정2동	계	20146	10890	9256	205	10685	0	4433	5184	437	489	0	54	65	23	0
경기도	파주시	운정3동	계	34344	16977	17367	324	16653	0	6803	8065	768	819	0	81	82	35	0
경기도	파주시	금촌1동	계	18199	7778	10421	367	7411	0	4323	2598	227	150	0	44	38	31	0
경기도	파주시	금촌2동	계	25156	12847	12309	328	12519	0	5775	5661	572	358	0	67	44	42	0
경기도	파주시	금촌3동	계	21136	10172	10964	305	9867	0	4915	4198	360	231	0	71	51	41	0
경기도	여주시	관외사전투표		4979	4961	18	87	4874	0	2507	1917	179	136	0	49	41	45	0
경기도	여주시	거소우편투표		196	184	12	11	173	0	98	57	5	5	0	4	2	2	0
경기도	여주시	가남읍	계	12618	5807	6811	96	5711	0	3544	1782	152	136	0	28	30	39	0
경기도	여주시	점동면	계	3955	2092	1863	83	2009	0	1459	428	40	47	0	4	8	23	0
경기도	여주시	능서면	계	5385	2886	2499	76	2810	0	2025	586	76	57	0	19	8	39	0
경기도	여주시	흥천면	계	4306	2317	1989	58	2259	0	1691	447	38	39	0	13	6	25	0
경기도	여주시	금사면	계	2519	1428	1091	37	1391	0	1082	217	26	33	0	6	10	17	0
경기도	여주시	산북면	계	2084	1123	961	29	1094	0	770	262	21	27	0	3	2	9	0
경기도	여주시	대신면	계	6280	3338	2942	113	3225	0	2381	631	68	72	0	26	18	29	0
경기도	여주시	북내면	계	4277	2255	2022	126	2129	0	1501	471	48	53	0	19	11	26	0
경기도	여주시	강천면	계	3055	1794	1261	135	1659	0	1151	394	32	34	0	17	12	19	0
경기도	여주시	여흥동	계	16388	7701	8687	357	7344	0	4362	2417	217	213	0	58	33	44	0
경기도	여주시	중앙동	계	14057	6752	7305	247	6505	0	3728	2261	204	161	0	58	47	46	0
경기도	여주시	오학동	계	9241	4386	4855	170	4216	0	2443	1451	99	127	0	31	27	38	0
경기도	이천시	관외사전투표		8305	8302	3	172	8130	0	3706	3658	287	237	0	79	111	52	0
경기도	이천시	거소우편투표		461	423	38	58	365	0	195	97	18	15	0	14	7	19	0
경기도	이천시	장호원읍	계	12341	5969	6372	262	5707	0	3665	1664	126	97	0	33	88	34	0
경기도	이천시	부발읍	계	26830	12249	14581	302	11947	0	5534	5333	425	305	0	92	189	69	0
경기도	이천시	신둔면	계	8468	4287	4181	118	4169	0	2580	1303	130	84	0	24	17	31	0
경기도	이천시	백사면	계	7673	3917	3756	213	3704	0	2320	1082	119	83	0	54	23	23	0
경기도	이천시	호법면	계	4596	2487	2109	86	2401	0	1661	604	56	46	0	7	11	16	0
경기도	이천시	마장면	계	6519	3055	3464	70	2985	0	2052	760	56	64	0	21	14	18	0
경기도	이천시	대월면	계	10076	4728	5348	172	4556	0	2265	1890	186	80	0	29	69	37	0
경기도	이천시	모가면	계	3912	2051	1861	114	1937	0	1370	446	37	36	0	11	19	18	0
경기도	이천시	설성면	계	4390	2313	2077	165	2148	0	1437	561	59	26	0	12	32	21	0
경기도	이천시	율면	계	2559	1362	1197	44	1318	0	810	365	42	23	0	12	53	13	0
경기도	이천시	창전동	계	14991	6810	8181	172	6638	0	4045	2091	231	141	0	64	22	44	0
경기도	이천시	증포동	계	28903	15157	13746	430	14727	0	6897	6446	693	384	0	114	98	95	0
경기도	이천시	중리동	계	11582	5438	6144	146	5292	0	3126	1793	155	129	0	24	30	35	0
경기도	이천시	관고동	계	8127	3897	4230	119	3778	0	2282	1210	116	88	0	30	28	24	0
경기도	용인시처인구	관외사전투표		7671	7668	3	144	7524	0	3681	3169	274	193	0	70	83	54	0
경기도	용인시처인구	거소우편투표		398	374	24	19	355	0	197	107	12	13	0	7	8	11	0
경기도	용인시처인구	포곡읍	계	24555	10925	13630	574	10351	0	5199	4387	296	293	0	65	55	56	0
경기도	용인시처인구	모현면	계	18357	8522	9835	420	8102	0	4311	3234	203	243	0	35	38	38	0
경기도	용인시처인구	남사면	계	5826	2991	2835	215	2776	0	1815	790	67	55	0	19	8	22	0
경기도	용인시처인구	이동면	계	15415	7270	8145	451	6819	0	3888	2424	189	173	0	57	35	53	0
경기도	용인시처인구	원삼면	계	6232	3221	3011	141	3080	0	2070	785	65	107	0	21	17	15	0
경기도	용인시처인구	백암면	계	7625	3757	3868	174	3583	0	2364	973	96	68	0	34	17	31	0
경기도	용인시처인구	양지면	계	12508	5959	6549	197	5762	0	3341	2002	144	173	0	37	37	28	0
경기도	용인시처인구	중앙동	계	18254	8483	9771	403	8080	0	4662	2911	198	198	0	45	38	28	0
경기도	용인시처인구	역삼동	계	19458	9405	10053	281	9124	0	4640	3791	254	312	0	49	44	34	0
경기도	용인시처인구	유림동	계	23179	10190	12989	418	9772	0	4737	4331	271	278	0	51	48	56	0
경기도	용인시처인구	동부동	계	10980	5125	5855	148	4977	0	2865	1784	129	114	0	34	33	18	0
경기도	용인시수지구	관외사전투표		10223	10220	3	156	10064	0	4476	4581	351	454	0	62	86	54	0
경기도	용인시수지구	거소우편투표		294	283	11	10	273	0	148	89	12	9	0	2	5	8	0
경기도	용인시수지구	풍덕천1동	계	26577	13849	12728	218	13631	0	5987	6373	401	686	0	53	100	31	0
경기도	용인시수지구	풍덕천2동	계	28032	16394	11638	191	16203	0	6941	7569	542	967	0	60	93	31	0
경기도	용인시수지구	신봉동	계	24283	14324	9959	228	14096	0	7467	5474	342	671	0	45	75	22	0
경기도	용인시수지구	죽전1동	계	42253	23863	18390	674	23189	0	10183	10661	688	1375	0	78	144	60	0
경기도	용인시수지구	죽전2동	계	14600	8093	6507	269	7824	0	3267	3795	225	442	0	29	48	18	0
경기도	용인시수지구	동천동	계	25000	14620	10380	192	14428	0	6965	6005	413	822	0	50	138	35	0
경기도	용인시수지구	상현1동	계	33088	18873	14215	301	18572	0	9176	7798	497	925	0	43	93	40	0
경기도	용인시수지구	성복동	계	27146	15591	11555	202	15389	0	9865	4608	272	509	0	28	80	27	0
경기도	용인시기흥구	관외사전투표		14246	14237	9	218	14019	0	6044	6567	519	620	0	74	130	65	0
경기도	용인시기흥구	거소우편투표		389	374	15	10	364	0	218	116	9	11	0	4	6	0	0
경기도	용인시기흥구	신갈동	계	26177	13839	12338	268	13571	0	6068	6199	522	624	0	59	54	45	0
경기도	용인시기흥구	영덕동	계	30209	16369	13840	244	16125	0	6378	7961	708	873	0	59	108	38	0
경기도	용인시기흥구	구갈동	계	20410	10345	10065	121	10224	0	4492	4806	340	445	0	46	55	40	0
경기도	용인시기흥구	상갈동	계	33287	18052	15235	209	17843	0	7933	8250	556	858	0	93	91	62	0
경기도	용인시기흥구	기흥동	계	15789	7686	8103	184	7502	0	3666	3139	277	341	0	30	22	27	0
경기도	용인시기흥구	서농동	계	14125	7102	7023	93	7009	0	2609	3690	290	348	0	25	26	21	0
경기도	용인시기흥구	구성동	계	28810	15792	13018	159	15633	0	7870	6454	448	698	0	50	78	35	0
경기도	용인시기흥구	마북동	계	23548	13316	10232	148	13168	0	7175	5045	292	531	0	38	54	33	0
경기도	용인시기흥구	동백동	계	47545	27204	20341	229	26975	0	10475	13406	1043	1764	0	82	132	73	0
경기도	용인시기흥구	상하동	계	17312	9082	8230	110	8972	0	4134	4046	273	401	0	42	46	30	0
경기도	용인시기흥구	보정동	계	26090	14874	11216	153	14721	0	7698	5790	336	739	0	36	73	49	0
경기도	용인시기흥구	상현2동	계	23073	13246	9827	167	13079	0	6698	5287	366	605	0	33	51	39	0
경기도	안성시	관외사전투표		6733	6732	1	106	6626	0	3042	2986	223	185	0	66	81	43	0
경기도	안성시	거소우편투표		384	350	34	57	293	0	160	93	13	10	0	5	6	6	0
경기도	안성시	공도읍	계	40133	18230	21903	586	17644	0	7890	8194	705	576	0	121	86	72	0
경기도	안성시	보개면	계	5121	2732	2389	133	2599	0	1627	783	67	69	0	23	12	18	0
경기도	안성시	금광면	계	6402	3364	3038	130	3234	0	1691	1305	78	85	0	18	32	25	0
경기도	안성시	서운면	계	3276	1703	1573	92	1611	0	1077	443	42	20	0	8	6	15	0
경기도	안성시	미양면	계	6013	2792	3221	148	2644	0	1491	958	97	44	0	24	10	20	0
경기도	안성시	대덕면	계	9313	3466	5847	142	3324	0	1901	1184	111	66	0	23	18	21	0
경기도	안성시	양성면	계	4653	2413	2240	126	2287	0	1573	578	44	36	0	19	19	18	0
경기도	안성시	원곡면	계	4028	1969	2059	183	1786	0	1099	583	44	34	0	9	7	10	0
경기도	안성시	일죽면	계	6902	3832	3070	230	3602	0	2423	991	63	57	0	25	15	28	0
경기도	안성시	죽산면	계	6110	3318	2792	123	3195	0	2101	953	50	53	0	13	8	17	0
경기도	안성시	삼죽면	계	3091	1706	1385	98	1608	0	1001	514	31	20	0	18	4	20	0
경기도	안성시	고삼면	계	1743	1036	707	48	988	0	638	293	28	13	0	6	4	6	0
경기도	안성시	안성1동	계	10381	5509	4872	264	5245	0	3113	1784	137	112	0	36	29	34	0
경기도	안성시	안성2동	계	13684	6519	7165	293	6226	0	3223	2542	226	119	0	49	26	41	0
경기도	안성시	안성3동	계	16487	8893	7594	212	8681	0	4575	3425	357	176	0	64	47	37	0
경기도	김포시	관외사전투표		11705	11701	4	180	11521	0	5245	5344	322	374	0	67	114	55	0
경기도	김포시	거소우편투표		457	430	27	25	405	0	224	131	16	11	0	9	5	9	0
경기도	김포시	통진읍	계	21219	9644	11575	308	9336	0	5569	3261	179	181	0	48	45	53	0
경기도	김포시	고촌읍	계	19139	10917	8222	301	10616	0	5576	4208	283	433	0	26	54	36	0
경기도	김포시	양촌읍	계	19755	8887	10868	292	8595	0	4822	3266	173	205	0	47	26	56	0
경기도	김포시	대곶면	계	8419	3920	4499	129	3791	0	2570	1030	68	65	0	16	19	23	0
경기도	김포시	월곶면	계	4799	2386	2413	93	2293	0	1578	595	42	48	0	8	7	15	0
경기도	김포시	하성면	계	7271	3767	3504	157	3610	0	2534	910	49	58	0	18	12	29	0
경기도	김포시	김포1동	계	37917	20194	17723	388	19806	0	9981	8465	491	617	0	85	91	76	0
경기도	김포시	김포2동	계	32291	16989	15302	214	16775	0	7103	8350	445	715	0	46	78	38	0
경기도	김포시	사우동	계	16428	8135	8293	232	7903	0	3879	3409	243	279	0	32	31	30	0
경기도	김포시	풍무동	계	28109	15318	12791	564	14754	0	7042	6550	479	533	0	51	44	55	0
경기도	김포시	장기동	계	24061	12501	11560	139	12362	0	5499	5972	300	464	0	36	58	33	0
경기도	김포시	구래동	계	16574	8182	8392	107	8075	0	3172	4186	224	390	0	38	30	35	0
경기도	광주시	관외사전투표		10430	10425	5	128	10297	0	4652	4748	313	368	0	68	85	63	0
경기도	광주시	거소우편투표		458	442	16	76	366	0	180	146	12	17	0	4	7	0	0
경기도	광주시	오포읍	계	57339	26228	31111	684	25544	0	12258	11491	650	822	0	108	106	109	0
경기도	광주시	초월읍	계	27859	13524	14335	229	13295	0	6894	5567	294	362	0	60	62	56	0
경기도	광주시	곤지암읍	계	18122	8179	9943	214	7965	0	4552	2915	180	169	0	44	43	62	0
경기도	광주시	도척면	계	7174	3311	3863	74	3237	0	1929	1105	78	70	0	18	13	24	0
경기도	광주시	퇴촌면	계	9923	4750	5173	57	4693	0	2817	1565	118	124	0	17	42	10	0
경기도	광주시	남종면	계	1383	823	560	27	796	0	570	180	11	21	0	5	6	3	0
경기도	광주시	중부면	계	2301	1306	995	32	1274	0	764	400	37	59	0	5	4	5	0
경기도	광주시	경안동	계	27148	11898	15250	185	11713	0	5943	5083	255	286	0	53	43	50	0
경기도	광주시	송정동	계	38421	17619	20802	302	17317	0	8607	7604	406	476	0	95	68	61	0
경기도	광주시	광남동	계	30515	14260	16255	166	14094	0	6583	6624	307	416	0	68	53	43	0
경기도	포천시	관외사전투표		6103	6099	4	131	5968	0	2933	2497	221	151	0	66	57	43	0
경기도	포천시	거소우편투표		360	344	16	26	318	0	170	73	27	16	0	10	5	17	0
경기도	포천시	소흘읍	계	35710	15922	19788	779	15143	0	8349	5564	539	401	0	117	73	100	0
경기도	포천시	군내면	계	5420	2740	2680	117	2623	0	1787	671	67	40	0	19	12	27	0
경기도	포천시	내촌면	계	4338	2009	2329	136	1873	0	1361	419	27	38	0	9	7	12	0
경기도	포천시	가산면	계	7119	3198	3921	190	3008	0	1995	812	69	67	0	25	12	28	0
경기도	포천시	신북면	계	10565	4909	5656	168	4741	0	3083	1367	99	103	0	37	18	34	0
경기도	포천시	창수면	계	2095	1224	871	49	1175	0	809	282	26	31	0	6	5	16	0
경기도	포천시	영중면	계	4774	2378	2396	69	2309	0	1553	593	63	49	0	21	8	22	0
경기도	포천시	일동면	계	8552	4383	4169	276	4107	0	2829	1023	99	86	0	22	17	31	0
경기도	포천시	이동면	계	4909	2588	2321	136	2452	0	1709	613	43	37	0	17	10	23	0
경기도	포천시	영북면	계	7328	4014	3314	230	3784	0	2620	893	90	86	0	30	29	36	0
경기도	포천시	관인면	계	2730	1663	1067	62	1601	0	1140	367	28	24	0	15	7	20	0
경기도	포천시	화현면	계	2252	1263	989	62	1201	0	863	277	21	28	0	2	3	7	0
경기도	포천시	포천동	계	14316	7380	6936	180	7200	0	4230	2448	202	175	0	64	33	48	0
경기도	포천시	선단동	계	10846	4768	6078	177	4591	0	2847	1472	101	93	0	30	15	33	0
경기도	연천군	관외사전투표		2443	2442	1	52	2390	0	1196	975	78	75	0	25	22	19	0
경기도	연천군	거소우편투표		345	327	18	29	298	0	189	62	10	14	0	7	6	10	0
경기도	연천군	연천읍	계	5360	3347	2013	203	3144	0	1929	941	86	74	0	43	26	45	0
경기도	연천군	전곡읍	계	15274	7910	7364	170	7740	0	4746	2458	180	186	0	60	36	74	0
경기도	연천군	군남면	계	2977	1781	1196	130	1651	0	1106	389	38	67	0	16	14	21	0
경기도	연천군	청산면	계	3648	1829	1819	64	1765	0	1225	433	24	40	0	14	11	18	0
경기도	연천군	백학면	계	2315	1218	1097	26	1192	0	817	296	24	24	0	5	6	20	0
경기도	연천군	미산면	계	1477	837	640	35	802	0	554	180	24	21	0	9	5	9	0
경기도	연천군	왕징면	계	976	695	281	64	631	0	374	195	22	19	0	6	4	11	0
경기도	연천군	신서면	계	2676	1703	973	91	1612	0	1030	457	36	41	0	23	8	17	0
경기도	연천군	중면	계	177	124	53	8	116	0	78	32	1	2	0	1	1	1	0
경기도	연천군	장남면	계	585	399	186	12	387	0	272	93	8	7	0	3	1	3	0
경기도	양평군	관외사전투표		5532	5532	0	102	5430	0	3056	1890	193	159	0	39	58	35	0
경기도	양평군	거소우편투표		357	327	30	24	303	0	158	74	26	21	0	11	6	7	0
경기도	양평군	양평읍	계	21910	12091	9819	351	11740	0	7341	3382	381	377	0	83	81	95	0
경기도	양평군	강상면	계	5760	3162	2598	104	3058	0	1958	811	88	125	0	29	23	24	0
경기도	양평군	강하면	계	3494	1957	1537	45	1912	0	1362	408	40	64	0	3	20	15	0
경기도	양평군	양서면	계	8816	4693	4123	116	4577	0	2918	1207	142	182	0	35	49	44	0
경기도	양평군	옥천면	계	5532	3261	2271	84	3177	0	2103	832	69	109	0	17	26	21	0
경기도	양평군	서종면	계	6234	3263	2971	70	3193	0	2029	827	104	153	0	21	39	20	0
경기도	양평군	단월면	계	2870	1742	1128	90	1652	0	1142	364	48	46	0	11	21	20	0
경기도	양평군	청운면	계	3183	1866	1317	112	1754	0	1254	389	35	29	0	13	12	22	0
경기도	양평군	양동면	계	3888	2252	1636	116	2136	0	1503	452	59	55	0	27	19	21	0
경기도	양평군	지평면	계	5365	3190	2175	168	3022	0	2013	689	89	125	0	31	29	46	0
경기도	양평군	용문면	계	10881	6264	4617	255	6009	0	3864	1595	198	204	0	47	48	53	0
경기도	양평군	개군면	계	3780	2211	1569	104	2107	0	1467	448	49	58	0	18	30	37	0
경기도	가평군	관외사전투표		2620	2618	2	65	2553	0	1377	904	102	83	0	23	33	31	0
경기도	가평군	거소우편투표		556	520	36	45	475	0	263	112	27	39	0	11	4	19	0
경기도	가평군	가평읍	계	15296	9865	5431	664	9201	0	5834	2400	294	319	0	102	82	170	0
경기도	가평군	설악면	계	6470	3876	2594	168	3708	0	2703	708	88	92	0	35	23	59	0
경기도	가평군	청평면	계	11538	6892	4646	314	6578	0	4437	1547	216	184	0	61	42	91	0
경기도	가평군	상면	계	4332	2832	1500	209	2623	0	1872	499	64	74	0	30	31	53	0
경기도	가평군	하면	계	7353	4534	2819	321	4213	0	2771	939	126	172	0	80	48	77	0
경기도	가평군	북면	계	3310	2078	1232	110	1968	0	1358	396	61	67	0	24	25	37	0
강원도	춘천시	관외사전투표		14461	14457	4	255	14202	0	6086	6774	453	458	0	154	277	0	0
강원도	춘천시	거소우편투표		723	660	63	51	609	0	325	200	28	22	0	15	19	0	0
강원도	춘천시	신북읍	계	6316	3705	2611	122	3583	0	2114	1163	94	105	0	45	62	0	0
강원도	춘천시	동면	계	9148	5307	3841	91	5216	0	2596	2238	129	154	0	49	50	0	0
강원도	춘천시	동산면	계	1276	753	523	31	722	0	478	193	17	21	0	7	6	0	0
강원도	춘천시	신동면	계	2056	1323	733	55	1268	0	803	376	26	32	0	14	17	0	0
강원도	춘천시	동내면	계	11112	6276	4836	121	6155	0	3115	2578	175	163	0	64	60	0	0
강원도	춘천시	남면	계	908	593	315	13	580	0	411	123	14	10	0	13	9	0	0
강원도	춘천시	남산면	계	3154	1733	1421	52	1681	0	1124	457	36	31	0	16	17	0	0
강원도	춘천시	서면	계	3412	1981	1431	41	1940	0	1276	515	45	61	0	11	32	0	0
강원도	춘천시	사북면	계	2132	1302	830	30	1272	0	826	325	37	46	0	18	20	0	0
강원도	춘천시	북산면	계	789	499	290	7	492	0	371	98	8	6	0	5	4	0	0
강원도	춘천시	소양동	계	6939	3821	3118	65	3756	0	2122	1390	71	72	0	27	74	0	0
강원도	춘천시	교동	계	3418	1815	1603	48	1767	0	990	643	45	56	0	12	21	0	0
강원도	춘천시	조운동	계	3113	1514	1599	36	1478	0	944	442	35	31	0	11	15	0	0
강원도	춘천시	약사명동	계	3628	1962	1666	32	1930	0	1165	633	54	34	0	20	24	0	0
강원도	춘천시	근화동	계	6119	3222	2897	75	3147	0	1758	1143	80	73	0	34	59	0	0
강원도	춘천시	후평1동	계	10413	5454	4959	130	5324	0	3029	1902	115	168	0	46	64	0	0
강원도	춘천시	후평2동	계	10910	5904	5006	107	5797	0	3063	2294	127	195	0	57	61	0	0
강원도	춘천시	후평3동	계	15865	8768	7097	197	8571	0	4582	3307	182	307	0	91	102	0	0
강원도	춘천시	효자1동	계	2854	1486	1368	36	1450	0	864	495	32	30	0	13	16	0	0
강원도	춘천시	효자2동	계	10162	5204	4958	115	5089	0	2942	1790	131	135	0	40	51	0	0
강원도	춘천시	효자3동	계	4109	2116	1993	39	2077	0	1147	780	41	69	0	14	26	0	0
강원도	춘천시	석사동	계	28359	16112	12247	251	15861	0	7580	7044	458	460	0	143	176	0	0
강원도	춘천시	퇴계동	계	32116	19237	12879	337	18900	0	9168	8311	519	539	0	170	193	0	0
강원도	춘천시	강남동	계	11492	6692	4800	95	6597	0	3541	2605	150	161	0	65	75	0	0
강원도	춘천시	신사우동	계	15213	9020	6193	141	8879	0	4807	3359	191	204	0	99	219	0	0
강원도	원주시	관외사전투표		15169	15161	8	236	14925	0	6478	7190	448	399	0	225	185	0	0
강원도	원주시	거소우편투표		532	497	35	17	480	0	268	180	5	9	0	8	10	0	0
강원도	원주시	문막읍	계	14643	7065	7578	157	6908	0	3737	2722	173	126	0	109	41	0	0
강원도	원주시	소초면	계	7643	3987	3656	97	3890	0	2488	1192	76	58	0	42	34	0	0
강원도	원주시	호저면	계	3540	2080	1460	64	2016	0	1309	603	42	27	0	23	12	0	0
강원도	원주시	지정면	계	2559	1609	950	72	1537	0	1075	386	34	18	0	17	7	0	0
강원도	원주시	부론면	계	2178	1335	843	60	1275	0	878	330	26	20	0	10	11	0	0
강원도	원주시	귀래면	계	1760	1057	703	28	1029	0	738	244	25	7	0	6	9	0	0
강원도	원주시	흥업면	계	6567	3347	3220	56	3291	0	1831	1234	76	77	0	44	29	0	0
강원도	원주시	판부면	계	5395	2725	2670	42	2683	0	1500	1021	60	58	0	21	23	0	0
강원도	원주시	신림면	계	3300	1828	1472	53	1775	0	1198	495	39	21	0	13	9	0	0
강원도	원주시	중앙동	계	2865	1439	1426	23	1416	0	996	368	10	28	0	8	6	0	0
강원도	원주시	원인동	계	5309	2690	2619	35	2655	0	1556	946	54	46	0	40	13	0	0
강원도	원주시	개운동	계	10947	6158	4789	91	6067	0	3574	2168	111	107	0	64	43	0	0
강원도	원주시	명륜1동	계	8141	4614	3527	74	4540	0	2656	1624	85	89	0	61	25	0	0
강원도	원주시	명륜2동	계	14073	7576	6497	110	7466	0	4092	2872	175	186	0	92	49	0	0
강원도	원주시	단구동	계	33247	17146	16101	233	16913	0	8749	7148	385	340	0	194	97	0	0
강원도	원주시	일산동	계	7120	3653	3467	46	3607	0	2194	1191	64	80	0	48	30	0	0
강원도	원주시	학성동	계	4902	2629	2273	44	2585	0	1649	805	39	36	0	47	9	0	0
강원도	원주시	단계동	계	18381	9731	8650	138	9593	0	5354	3637	187	215	0	157	43	0	0
강원도	원주시	우산동	계	10491	5528	4963	83	5445	0	3261	1880	127	92	0	57	28	0	0
강원도	원주시	태장1동	계	7851	4043	3808	64	3979	0	2249	1489	91	77	0	52	21	0	0
강원도	원주시	태장2동	계	19225	9522	9703	125	9397	0	5363	3508	194	169	0	113	50	0	0
강원도	원주시	봉산동	계	8183	4564	3619	81	4483	0	2758	1511	64	62	0	58	30	0	0
강원도	원주시	행구동	계	6048	3517	2531	71	3446	0	1884	1336	92	78	0	30	26	0	0
강원도	원주시	무실동	계	21854	11546	10308	124	11422	0	5482	5066	284	352	0	180	58	0	0
강원도	원주시	반곡관설동	계	15165	7885	7280	111	7774	0	3583	3683	194	188	0	82	44	0	0
강원도	강릉시	관외사전투표		10505	10490	15	191	10299	0	5056	4407	331	258	0	125	122	0	0
강원도	강릉시	거소우편투표		648	593	55	22	571	0	373	139	18	21	0	9	11	0	0
강원도	강릉시	주문진읍	계	15450	8294	7156	391	7903	0	5713	1743	182	163	0	51	51	0	0
강원도	강릉시	성산면	계	2810	1760	1050	96	1664	0	1098	476	26	35	0	11	18	0	0
강원도	강릉시	왕산면	계	1514	939	575	39	900	0	649	196	19	15	0	10	11	0	0
강원도	강릉시	구정면	계	3303	2052	1251	129	1923	0	1321	461	52	41	0	24	24	0	0
강원도	강릉시	강동면	계	4238	2684	1554	155	2529	0	1807	534	58	61	0	45	24	0	0
강원도	강릉시	옥계면	계	3514	2523	991	120	2403	0	1733	495	50	65	0	34	26	0	0
강원도	강릉시	사천면	계	3676	2286	1390	110	2176	0	1562	475	47	40	0	18	34	0	0
강원도	강릉시	연곡면	계	5454	3283	2171	108	3175	0	2103	873	62	79	0	37	21	0	0
강원도	강릉시	홍제동	계	6399	3544	2855	68	3476	0	2225	1043	92	60	0	34	22	0	0
강원도	강릉시	중앙동	계	5156	2692	2464	56	2636	0	1918	607	57	32	0	8	14	0	0
강원도	강릉시	옥천동	계	3435	1827	1608	30	1797	0	1332	388	23	30	0	9	15	0	0
강원도	강릉시	교1동	계	20994	11888	9106	217	11671	0	6705	4235	362	231	0	76	62	0	0
강원도	강릉시	교2동	계	7353	4004	3349	79	3925	0	2618	1118	76	59	0	29	25	0	0
강원도	강릉시	포남1동	계	9835	5439	4396	127	5312	0	3754	1323	110	61	0	27	37	0	0
강원도	강릉시	포남2동	계	12181	6463	5718	159	6304	0	4056	1942	107	100	0	58	41	0	0
강원도	강릉시	초당동	계	4304	2573	1731	60	2513	0	1475	880	56	49	0	20	33	0	0
강원도	강릉시	송정동	계	5468	3296	2172	90	3206	0	1979	1059	65	61	0	25	17	0	0
강원도	강릉시	내곡동	계	9507	5207	4300	125	5082	0	3024	1720	130	100	0	70	38	0	0
강원도	강릉시	강남동	계	16115	8976	7139	225	8751	0	5824	2413	180	188	0	97	49	0	0
강원도	강릉시	성덕동	계	20454	11078	9376	271	10807	0	6271	3842	307	188	0	120	79	0	0
강원도	강릉시	경포동	계	4117	2397	1720	85	2312	0	1584	600	51	37	0	15	25	0	0
강원도	동해시	관외사전투표		4641	4641	0	114	4527	0	2203	1991	136	93	0	57	47	0	0
강원도	동해시	거소우편투표		1335	1282	53	91	1191	0	743	361	25	18	0	18	26	0	0
강원도	동해시	천곡동	계	21319	12084	9235	276	11808	0	7197	3930	295	207	0	99	80	0	0
강원도	동해시	송정동	계	3894	2221	1673	88	2133	0	1498	515	40	38	0	26	16	0	0
강원도	동해시	북삼동	계	14731	8527	6204	208	8319	0	4475	3233	256	193	0	117	45	0	0
강원도	동해시	부곡동	계	5211	2825	2386	87	2738	0	1851	728	57	55	0	25	22	0	0
강원도	동해시	동호동	계	3927	2116	1811	73	2043	0	1444	486	49	28	0	20	16	0	0
강원도	동해시	발한동	계	3886	2129	1757	60	2069	0	1515	467	36	28	0	16	7	0	0
강원도	동해시	묵호동	계	3449	1894	1555	85	1809	0	1359	337	37	43	0	14	19	0	0
강원도	동해시	북평동	계	7427	4380	3047	183	4197	0	2678	1237	99	93	0	60	30	0	0
강원도	동해시	망상동	계	2981	1742	1239	73	1669	0	1204	353	35	34	0	29	14	0	0
강원도	동해시	삼화동	계	2995	1786	1209	68	1718	0	1199	389	53	37	0	27	13	0	0
강원도	삼척시	관외사전투표		5036	5034	2	144	4890	0	2340	2068	202	122	0	78	80	0	0
강원도	삼척시	거소우편투표		404	360	44	14	346	0	238	74	8	13	0	11	2	0	0
강원도	삼척시	도계읍	계	11099	6789	4310	353	6436	0	4254	1492	254	198	0	148	90	0	0
강원도	삼척시	원덕읍	계	5073	3496	1577	141	3355	0	2369	623	119	105	0	78	61	0	0
강원도	삼척시	근덕면	계	4986	3472	1514	184	3288	0	2181	685	101	156	0	101	64	0	0
강원도	삼척시	하장면	계	1271	844	427	39	805	0	521	176	37	37	0	25	9	0	0
강원도	삼척시	노곡면	계	660	478	182	26	452	0	273	99	16	24	0	22	18	0	0
강원도	삼척시	미로면	계	1750	1245	505	79	1166	0	760	227	39	67	0	46	27	0	0
강원도	삼척시	가곡면	계	655	492	163	18	474	0	325	90	25	17	0	9	8	0	0
강원도	삼척시	신기면	계	662	461	201	27	434	0	270	86	22	30	0	17	9	0	0
강원도	삼척시	남양동	계	7564	5247	2317	230	5017	0	3403	1184	127	173	0	81	49	0	0
강원도	삼척시	성내동	계	6656	4478	2178	190	4288	0	2698	1162	131	171	0	71	55	0	0
강원도	삼척시	교동	계	7644	4885	2759	144	4741	0	2668	1610	187	132	0	94	50	0	0
강원도	삼척시	정라동	계	8137	5095	3042	150	4945	0	2928	1581	170	125	0	73	68	0	0
강원도	태백시	관외사전투표		3638	3637	1	84	3553	0	1601	1712	88	66	0	46	40	0	0
강원도	태백시	거소우편투표		83	75	8	1	74	0	38	31	1	1	0	2	1	0	0
강원도	태백시	황지동	계	5063	3260	1803	124	3136	0	1995	983	62	39	0	36	21	0	0
강원도	태백시	황연동	계	4237	2654	1583	117	2537	0	1676	726	38	44	0	33	20	0	0
강원도	태백시	삼수동	계	5242	3128	2114	113	3015	0	1806	1011	65	66	0	41	26	0	0
강원도	태백시	상장동	계	10718	6686	4032	163	6523	0	3394	2737	157	115	0	85	35	0	0
강원도	태백시	문곡소도동	계	2848	1860	988	81	1779	0	1136	568	31	18	0	16	10	0	0
강원도	태백시	장성동	계	3051	2215	836	115	2100	0	1337	672	32	26	0	19	14	0	0
강원도	태백시	구문소동	계	2751	1906	845	83	1823	0	1272	464	34	29	0	14	10	0	0
강원도	태백시	철암동	계	2439	1659	780	64	1595	0	1096	410	24	34	0	19	12	0	0
강원도	정선군	관외사전투표		2361	2361	0	49	2312	0	1005	1168	47	38	0	31	23	0	0
강원도	정선군	거소우편투표		134	126	8	4	122	0	73	37	4	3	0	2	3	0	0
강원도	정선군	정선읍	계	8624	6316	2308	260	6056	0	3340	2304	134	135	0	100	43	0	0
강원도	정선군	고한읍	계	4198	2604	1594	132	2472	0	1269	1077	50	37	0	24	15	0	0
강원도	정선군	사북읍	계	4337	2801	1536	108	2693	0	1562	978	57	48	0	29	19	0	0
강원도	정선군	신동읍	계	3233	2291	942	131	2160	0	1386	605	42	39	0	26	62	0	0
강원도	정선군	화암면	계	1410	964	446	60	904	0	554	287	14	15	0	29	5	0	0
강원도	정선군	남면	계	2744	1903	841	87	1816	0	1030	648	40	33	0	51	14	0	0
강원도	정선군	여량면	계	1779	1332	447	87	1245	0	820	350	22	27	0	13	13	0	0
강원도	정선군	북평면	계	2141	1511	630	132	1379	0	866	419	32	27	0	18	17	0	0
강원도	정선군	임계면	계	3070	2171	899	218	1953	0	1222	611	38	35	0	26	21	0	0
강원도	속초시	관외사전투표		4449	4447	2	82	4365	0	2053	1998	120	95	0	58	41	0	0
강원도	속초시	거소우편투표		397	373	24	20	353	0	183	132	13	9	0	7	9	0	0
강원도	속초시	영랑동	계	4340	2494	1846	97	2397	0	1648	613	45	48	0	26	17	0	0
강원도	속초시	동명동	계	3127	1709	1418	78	1631	0	1114	431	35	24	0	13	14	0	0
강원도	속초시	금호동	계	5897	3391	2506	124	3267	0	2120	957	63	69	0	34	24	0	0
강원도	속초시	교동	계	8513	4715	3798	175	4540	0	2794	1449	125	98	0	46	28	0	0
강원도	속초시	노학동	계	16893	9239	7654	248	8991	0	5301	3157	200	181	0	110	42	0	0
강원도	속초시	조양동	계	16712	9032	7680	224	8808	0	4953	3355	190	169	0	96	45	0	0
강원도	속초시	청호동	계	3520	1935	1585	109	1826	0	1334	397	32	37	0	15	11	0	0
강원도	속초시	대포동	계	2929	1767	1162	59	1708	0	1178	426	31	37	0	14	22	0	0
강원도	고성군	관외사전투표		2010	2010	0	59	1951	0	979	780	90	45	0	34	23	0	0
강원도	고성군	거소우편투표		604	578	26	41	537	0	325	148	12	16	0	20	16	0	0
강원도	고성군	간성읍	계	5537	3904	1633	161	3743	0	2272	1169	100	71	0	84	47	0	0
강원도	고성군	거진읍	계	5936	4289	1647	217	4072	0	2742	989	81	108	0	97	55	0	0
강원도	고성군	현내면	계	2305	1714	591	95	1619	0	1196	302	53	29	0	19	20	0	0
강원도	고성군	죽왕면	계	3271	2358	913	119	2239	0	1493	520	71	59	0	58	38	0	0
강원도	고성군	토성면	계	6572	4325	2247	214	4111	0	2739	1025	103	92	0	87	65	0	0
강원도	양양군	관외사전투표		1679	1679	0	47	1632	0	726	793	46	31	0	14	22	0	0
강원도	양양군	거소우편투표		238	225	13	9	216	0	150	52	3	3	0	2	6	0	0
강원도	양양군	양양읍	계	8829	6222	2607	244	5978	0	3645	2022	98	100	0	47	66	0	0
강원도	양양군	서면	계	2671	1916	755	113	1803	0	1181	479	39	41	0	32	31	0	0
강원도	양양군	손양면	계	1975	1489	486	96	1393	0	864	419	28	30	0	33	19	0	0
강원도	양양군	현북면	계	2271	1670	601	113	1557	0	1003	434	45	36	0	21	18	0	0
강원도	양양군	현남면	계	2685	2032	653	139	1893	0	1227	512	49	51	0	19	35	0	0
강원도	양양군	강현면	계	3439	2308	1131	95	2213	0	1457	616	46	49	0	22	23	0	0
강원도	인제군	관외사전투표		1913	1912	1	62	1850	0	858	867	52	35	0	15	23	0	0
강원도	인제군	거소우편투표		298	287	11	25	262	0	169	68	7	9	0	4	5	0	0
강원도	인제군	인제읍	계	7232	5220	2012	231	4989	0	2821	1915	89	78	0	51	35	0	0
강원도	인제군	남면	계	2938	2057	881	130	1927	0	1176	614	48	40	0	31	18	0	0
강원도	인제군	북면	계	6601	4594	2007	227	4367	0	2497	1620	90	72	0	53	35	0	0
강원도	인제군	기린면	계	3984	2905	1079	208	2697	0	1701	803	57	43	0	33	60	0	0
강원도	인제군	서화면	계	2357	1707	650	102	1605	0	1008	503	38	21	0	14	21	0	0
강원도	인제군	상남면	계	1278	1004	274	98	906	0	551	273	21	24	0	28	9	0	0
강원도	홍천군	관외사전투표		3593	3591	2	72	3519	0	1690	1548	93	93	0	44	51	0	0
강원도	홍천군	거소우편투표		147	137	10	7	130	0	75	39	4	5	0	4	3	0	0
강원도	홍천군	홍천읍	계	26364	16221	10143	517	15704	0	9173	5470	425	304	0	200	132	0	0
강원도	홍천군	화촌면	계	4047	2588	1459	142	2446	0	1568	631	86	77	0	51	33	0	0
강원도	홍천군	두촌면	계	2077	1396	681	62	1334	0	945	289	22	36	0	22	20	0	0
강원도	홍천군	내촌면	계	2015	1385	630	52	1333	0	890	346	21	33	0	17	26	0	0
강원도	홍천군	서석면	계	3241	2240	1001	99	2141	0	1292	635	74	60	0	44	36	0	0
강원도	홍천군	동면	계	3145	2077	1068	115	1962	0	1100	628	110	60	0	39	25	0	0
강원도	홍천군	남면	계	5111	3203	1908	126	3077	0	1888	929	111	67	0	47	35	0	0
강원도	홍천군	서면	계	3116	1767	1349	68	1699	0	1202	382	42	43	0	14	16	0	0
강원도	홍천군	북방면	계	3305	2062	1243	77	1985	0	1260	542	61	66	0	32	24	0	0
강원도	홍천군	내면	계	2849	1895	954	80	1815	0	1079	550	43	80	0	31	32	0	0
강원도	횡성군	관외사전투표		2394	2394	0	38	2356	0	1190	986	83	48	0	25	24	0	0
강원도	횡성군	거소우편투표		86	83	3	3	80	0	49	26	2	0	0	2	1	0	0
강원도	횡성군	횡성읍	계	15294	10219	5075	282	9937	0	6097	3168	315	185	0	105	67	0	0
강원도	횡성군	우천면	계	3710	2450	1260	102	2348	0	1420	724	81	63	0	44	16	0	0
강원도	횡성군	안흥면	계	2183	1493	690	77	1416	0	960	353	34	41	0	17	11	0	0
강원도	횡성군	둔내면	계	4585	2890	1695	103	2787	0	1801	815	68	58	0	22	23	0	0
강원도	횡성군	갑천면	계	1880	1257	623	61	1196	0	822	297	28	25	0	12	12	0	0
강원도	횡성군	청일면	계	2018	1322	696	74	1248	0	846	292	40	45	0	10	15	0	0
강원도	횡성군	공근면	계	3031	2001	1030	104	1897	0	1156	582	64	57	0	22	16	0	0
강원도	횡성군	서원면	계	1850	1233	617	46	1187	0	691	381	27	34	0	35	19	0	0
강원도	횡성군	강림면	계	1314	907	407	34	873	0	581	227	29	22	0	8	6	0	0
강원도	영월군	관외사전투표		2039	2038	1	37	2001	0	970	916	42	37	0	14	22	0	0
강원도	영월군	거소우편투표		178	159	19	18	141	0	87	27	9	8	0	7	3	0	0
강원도	영월군	영월읍	계	16776	10852	5924	269	10583	0	6121	3864	188	214	0	106	90	0	0
강원도	영월군	상동읍	계	1047	690	357	38	652	0	456	164	8	9	0	6	9	0	0
강원도	영월군	중동면	계	1333	889	444	49	840	0	554	248	13	13	0	6	6	0	0
강원도	영월군	김삿갓면	계	1509	976	533	44	932	0	605	262	12	28	0	12	13	0	0
강원도	영월군	북면	계	1907	1268	639	49	1219	0	816	315	31	28	0	12	17	0	0
강원도	영월군	남면	계	1933	1291	642	50	1241	0	782	349	38	37	0	23	12	0	0
강원도	영월군	한반도면	계	2647	1806	841	84	1722	0	1134	446	44	43	0	38	17	0	0
강원도	영월군	주천면	계	3349	2277	1072	108	2169	0	1437	601	42	42	0	20	27	0	0
강원도	영월군	수주면	계	1555	1038	517	38	1000	0	672	277	20	20	0	6	5	0	0
강원도	평창군	관외사전투표		2388	2387	1	31	2356	0	1098	1109	78	30	0	19	22	0	0
강원도	평창군	거소우편투표		165	141	24	11	130	0	48	67	3	5	0	6	1	0	0
강원도	평창군	평창읍	계	6958	4827	2131	159	4668	0	2943	1517	57	72	0	46	33	0	0
강원도	평창군	미탄면	계	1459	1026	433	41	985	0	598	323	14	14	0	21	15	0	0
강원도	평창군	방림면	계	2076	1423	653	55	1368	0	820	473	30	23	0	10	12	0	0
강원도	평창군	대화면	계	4660	3119	1541	115	3004	0	1787	1070	51	33	0	30	33	0	0
강원도	평창군	봉평면	계	4393	2817	1576	128	2689	0	1745	760	47	34	0	22	81	0	0
강원도	평창군	용평면	계	2482	1750	732	63	1687	0	1123	462	34	31	0	22	15	0	0
강원도	평창군	진부면	계	7565	4987	2578	211	4776	0	2723	1865	77	58	0	28	25	0	0
강원도	평창군	대관령면	계	5010	2920	2090	72	2848	0	1869	866	36	29	0	24	24	0	0
강원도	화천군	관외사전투표		1806	1805	1	49	1756	0	935	686	55	30	0	19	31	0	0
강원도	화천군	거소우편투표		311	304	7	20	284	0	171	77	9	6	0	11	10	0	0
강원도	화천군	화천읍	계	6165	4148	2017	155	3993	0	2569	1161	88	77	0	50	48	0	0
강원도	화천군	간동면	계	2123	1527	596	83	1444	0	879	434	35	32	0	25	39	0	0
강원도	화천군	하남면	계	1925	1367	558	54	1313	0	788	392	42	56	0	16	19	0	0
강원도	화천군	상서면	계	3146	2051	1095	115	1936	0	1196	541	63	59	0	31	46	0	0
강원도	화천군	사내면	계	4982	3342	1640	132	3210	0	2132	899	58	47	0	31	43	0	0
강원도	양구군	관외사전투표		1540	1540	0	37	1503	0	746	654	53	19	0	12	19	0	0
강원도	양구군	거소우편투표		409	395	14	23	372	0	227	101	14	12	0	5	13	0	0
강원도	양구군	양구읍	계	10275	7405	2870	270	7135	0	4357	2357	150	130	0	63	78	0	0
강원도	양구군	남면	계	2848	2066	782	123	1943	0	1197	591	45	56	0	33	21	0	0
강원도	양구군	동면	계	1746	1364	382	65	1299	0	836	365	37	22	0	15	24	0	0
강원도	양구군	방산면	계	1165	857	308	50	807	0	512	229	17	22	0	11	16	0	0
강원도	양구군	해안면	계	1135	856	279	50	806	0	418	329	17	20	0	13	9	0	0
강원도	철원군	관외사전투표		2416	2414	2	62	2352	0	1172	1023	61	53	0	17	26	0	0
강원도	철원군	거소우편투표		314	310	4	25	285	0	154	107	9	4	0	6	5	0	0
강원도	철원군	철원읍	계	4099	2610	1489	119	2491	0	1555	774	62	58	0	20	22	0	0
강원도	철원군	김화읍	계	2640	1813	827	95	1718	0	1141	462	39	44	0	18	14	0	0
강원도	철원군	갈말읍	계	9870	6302	3568	213	6089	0	3833	1955	117	94	0	52	38	0	0
강원도	철원군	동송읍	계	12530	7703	4827	273	7430	0	4657	2388	145	126	0	56	58	0	0
강원도	철원군	서면	계	4716	2979	1737	119	2860	0	1823	912	51	35	0	26	13	0	0
강원도	철원군	근남면	계	1807	1214	593	50	1164	0	731	358	34	26	0	5	10	0	0
강원도	철원군	근북면	계	108	92	16	6	86	0	56	26	1	3	0	0	0	0	0
충청북도	청주시상당구	관외사전투표		10772	10769	3	162	10607	0	4516	5087	445	292	0	117	150	0	0
충청북도	청주시상당구	거소우편투표		484	460	24	24	436	0	230	138	21	24	0	14	9	0	0
충청북도	청주시상당구	중앙동	계	5589	3152	2437	136	3016	0	1848	993	87	54	0	18	16	0	0
충청북도	청주시상당구	성안동	계	5929	2922	3007	111	2811	0	1889	772	57	60	0	21	12	0	0
충청북도	청주시상당구	우암동	계	11079	5483	5596	209	5274	0	3210	1731	144	120	0	34	35	0	0
충청북도	청주시상당구	내덕제1동	계	8653	4409	4244	93	4316	0	2704	1364	125	70	0	23	30	0	0
충청북도	청주시상당구	내덕제2동	계	9648	4823	4825	138	4685	0	2721	1672	145	92	0	21	34	0	0
충청북도	청주시상당구	율량·사천동	계	31499	16378	15121	299	16079	0	7995	6861	570	428	0	125	100	0	0
충청북도	청주시상당구	탑·대성동	계	9162	4781	4381	185	4596	0	2801	1519	133	83	0	28	32	0	0
충청북도	청주시상당구	영운동	계	9626	4938	4688	115	4823	0	2755	1731	144	82	0	69	42	0	0
충청북도	청주시상당구	금천동	계	23756	12953	10803	382	12571	0	6325	5314	476	277	0	87	92	0	0
충청북도	청주시상당구	용담·명암·산성동	계	8234	4768	3466	88	4680	0	2359	2019	146	106	0	23	27	0	0
충청북도	청주시상당구	용암제1동	계	32228	16998	15230	278	16720	0	8028	7341	566	410	0	239	136	0	0
충청북도	청주시상당구	용암제2동	계	18486	9798	8688	195	9603	0	4618	4259	331	160	0	168	67	0	0
충청북도	청주시상당구	오근장동	계	9056	4737	4319	100	4637	0	2278	2005	159	122	0	35	38	0	0
충청북도	청주시흥덕구	관외사전투표		16869	16859	10	242	16617	0	6896	8061	750	479	0	209	222	0	0
충청북도	청주시흥덕구	거소우편투표		594	543	51	24	519	0	296	153	32	18	0	6	14	0	0
충청북도	청주시흥덕구	사직제1동	계	8218	4382	3836	87	4295	0	2634	1416	105	79	0	27	34	0	0
충청북도	청주시흥덕구	사직제2동	계	12309	7363	4946	130	7233	0	3778	2985	206	168	0	59	37	0	0
충청북도	청주시흥덕구	사창동	계	13533	6599	6934	124	6475	0	3611	2423	216	136	0	42	47	0	0
충청북도	청주시흥덕구	모충동	계	15222	7482	7740	153	7329	0	4189	2701	187	147	0	71	34	0	0
충청북도	청주시흥덕구	운천·신봉동	계	16091	8287	7804	179	8108	0	4243	3333	249	160	0	64	59	0	0
충청북도	청주시흥덕구	산남동	계	20331	11686	8645	143	11543	0	5002	5608	445	303	0	76	109	0	0
충청북도	청주시흥덕구	분평동	계	24595	14374	10221	190	14184	0	6178	6873	558	363	0	110	102	0	0
충청북도	청주시흥덕구	수곡제1동	계	13260	6733	6527	135	6598	0	3650	2520	177	127	0	85	39	0	0
충청북도	청주시흥덕구	수곡제2동	계	13015	7003	6012	155	6848	0	3678	2676	211	131	0	103	49	0	0
충청북도	청주시흥덕구	성화·개신·죽림동	계	36307	19191	17116	243	18948	0	8460	9035	656	527	0	155	115	0	0
충청북도	청주시흥덕구	복대제1동	계	33311	16857	16454	177	16680	0	7163	8153	625	440	0	190	109	0	0
충청북도	청주시흥덕구	복대제2동	계	15439	7131	8308	117	7014	0	3906	2605	221	161	0	68	53	0	0
충청북도	청주시흥덕구	가경동	계	38664	19904	18760	443	19461	0	9139	8752	781	495	0	163	131	0	0
충청북도	청주시흥덕구	봉명제1동	계	9825	4205	5620	92	4113	0	2218	1638	124	76	0	33	24	0	0
충청북도	청주시흥덕구	봉명제2·송정동	계	20983	9697	11286	155	9542	0	4523	4268	346	253	0	94	58	0	0
충청북도	청주시흥덕구	강서제1동	계	16832	8304	8528	256	8048	0	4129	3351	270	182	0	64	52	0	0
충청북도	청주시흥덕구	강서제2동	계	3050	1399	1651	35	1364	0	808	465	37	26	0	18	10	0	0
충청북도	청주시청원구	관외사전투표		6076	6075	1	95	5980	0	2574	2900	203	176	0	59	68	0	0
충청북도	청주시청원구	거소우편투표		726	685	41	33	652	0	357	198	38	23	0	13	23	0	0
충청북도	청주시청원구	내수읍	계	16239	8293	7946	223	8070	0	4125	3297	342	158	0	85	63	0	0
충청북도	청주시청원구	오창읍	계	34102	17419	16683	363	17056	0	6820	8609	804	557	0	140	126	0	0
충청북도	청주시청원구	오송읍	계	15559	8574	6985	334	8240	0	3816	3636	295	377	0	52	64	0	0
충청북도	청주시청원구	낭성면	계	1988	1294	694	50	1244	0	856	316	34	20	0	7	11	0	0
충청북도	청주시청원구	미원면	계	4470	2867	1603	110	2757	0	1699	824	103	48	0	34	49	0	0
충청북도	청주시청원구	가덕면	계	3733	2193	1540	89	2104	0	1287	663	56	30	0	40	28	0	0
충청북도	청주시청원구	남일면	계	6136	3590	2546	98	3492	0	2069	1219	90	64	0	23	27	0	0
충청북도	청주시청원구	남이면	계	6055	3479	2576	246	3233	0	1934	1033	81	73	0	77	35	0	0
충청북도	청주시청원구	문의면	계	3976	2307	1669	101	2206	0	1353	702	58	47	0	14	32	0	0
충청북도	청주시청원구	현도면	계	3244	2022	1222	100	1922	0	1224	568	57	32	0	23	18	0	0
충청북도	청주시청원구	강내면	계	8583	4882	3701	118	4764	0	2378	2012	150	158	0	33	33	0	0
충청북도	청주시청원구	옥산면	계	7959	4404	3555	138	4266	0	2438	1489	170	87	0	45	37	0	0
충청북도	청주시청원구	북이면	계	4611	2725	1886	119	2606	0	1520	821	146	48	0	38	33	0	0
충청북도	충주시	관외사전투표		10167	10156	11	170	9986	0	4509	4718	300	251	0	112	96	0	0
충청북도	충주시	거소우편투표		395	364	31	18	346	0	187	121	19	7	0	7	5	0	0
충청북도	충주시	주덕읍	계	4951	2813	2138	125	2688	0	1670	857	71	42	0	26	22	0	0
충청북도	충주시	살미면	계	1888	1165	723	46	1119	0	671	382	21	27	0	10	8	0	0
충청북도	충주시	수안보면	계	2862	1825	1037	109	1716	0	1096	521	37	32	0	13	17	0	0
충청북도	충주시	대소원면	계	4478	2385	2093	97	2288	0	1452	674	74	52	0	20	16	0	0
충청북도	충주시	신니면	계	2998	1932	1066	102	1830	0	1180	544	42	29	0	20	15	0	0
충청북도	충주시	노은면	계	2167	1332	835	102	1230	0	762	373	36	44	0	7	8	0	0
충청북도	충주시	앙성면	계	3777	2316	1461	125	2191	0	1476	583	40	61	0	18	13	0	0
충청북도	충주시	중앙탑면	계	2372	1415	957	78	1337	0	866	397	26	29	0	9	10	0	0
충청북도	충주시	금가면	계	3288	1914	1374	82	1832	0	1072	629	36	67	0	13	15	0	0
충청북도	충주시	동량면	계	3392	2168	1224	116	2052	0	1356	557	53	46	0	27	13	0	0
충청북도	충주시	산척면	계	2292	1482	810	57	1425	0	859	470	30	30	0	18	18	0	0
충청북도	충주시	엄정면	계	3080	2067	1013	119	1948	0	1323	499	53	44	0	10	19	0	0
충청북도	충주시	소태면	계	1706	1076	630	61	1015	0	657	287	26	25	0	10	10	0	0
충청북도	충주시	성내·충인동	계	2812	1457	1355	35	1422	0	1020	343	23	22	0	8	6	0	0
충청북도	충주시	교현·안림동	계	17347	9013	8334	411	8602	0	5238	2850	191	190	0	82	51	0	0
충청북도	충주시	교현2동	계	7190	3725	3465	213	3512	0	2210	1114	78	61	0	31	18	0	0
충청북도	충주시	용산동	계	12104	6466	5638	132	6334	0	3438	2517	152	124	0	62	41	0	0
충청북도	충주시	지현동	계	4808	2663	2145	65	2598	0	1657	804	57	52	0	17	11	0	0
충청북도	충주시	문화동	계	9284	5354	3930	167	5187	0	3504	1452	90	78	0	38	25	0	0
충청북도	충주시	호암·직동	계	7961	4222	3739	116	4106	0	2107	1738	109	98	0	34	20	0	0
충청북도	충주시	달천동	계	3714	1843	1871	54	1789	0	1151	552	30	33	0	15	8	0	0
충청북도	충주시	봉방동	계	6977	3624	3353	114	3510	0	2250	1084	77	57	0	24	18	0	0
충청북도	충주시	칠금·금릉동	계	12664	7062	5602	128	6934	0	3805	2697	182	151	0	61	38	0	0
충청북도	충주시	연수동	계	29382	15371	14011	533	14838	0	8143	5728	433	316	0	133	85	0	0
충청북도	충주시	목행·용탄동	계	5089	2665	2424	41	2624	0	1393	1069	65	63	0	16	18	0	0
충청북도	제천시	관외사전투표		6678	6669	9	129	6540	0	2823	3161	238	173	0	73	72	0	0
충청북도	제천시	거소우편투표		238	219	19	7	212	0	129	58	10	7	0	4	4	0	0
충청북도	제천시	봉양읍	계	6124	3781	2343	176	3605	0	2041	1225	123	129	0	49	38	0	0
충청북도	제천시	금성면	계	1781	1106	675	50	1056	0	611	351	47	23	0	11	13	0	0
충청북도	제천시	청풍면	계	1103	706	397	30	676	0	461	175	12	11	0	8	9	0	0
충청북도	제천시	수산면	계	1879	1189	690	56	1133	0	821	226	36	20	0	13	17	0	0
충청북도	제천시	덕산면	계	1971	1250	721	45	1205	0	751	311	39	30	0	26	48	0	0
충청북도	제천시	한수면	계	658	409	249	11	398	0	274	102	3	8	0	6	5	0	0
충청북도	제천시	백운면	계	2856	1818	1038	69	1749	0	1137	493	30	49	0	24	16	0	0
충청북도	제천시	송학면	계	4274	2766	1508	137	2629	0	1728	682	64	73	0	58	24	0	0
충청북도	제천시	교동	계	13285	7584	5701	409	7175	0	3754	2925	200	194	0	53	49	0	0
충청북도	제천시	의암동	계	6955	4146	2809	167	3979	0	2098	1625	106	87	0	33	30	0	0
충청북도	제천시	인성동	계	5615	3120	2495	91	3029	0	2007	873	58	36	0	27	28	0	0
충청북도	제천시	남현동	계	5077	2842	2235	160	2682	0	1753	808	40	52	0	13	16	0	0
충청북도	제천시	영서동	계	6633	3660	2973	108	3552	0	2193	1156	87	56	0	32	28	0	0
충청북도	제천시	용두동	계	13571	7669	5902	177	7492	0	3871	3050	231	207	0	79	54	0	0
충청북도	제천시	신백동	계	9861	5568	4293	356	5212	0	2704	2162	144	118	0	49	35	0	0
충청북도	제천시	청전동	계	15202	8822	6380	294	8528	0	5152	2931	179	165	0	57	44	0	0
충청북도	제천시	화산동	계	8252	4382	3870	146	4236	0	2581	1388	90	96	0	48	33	0	0
충청북도	단양군	관외사전투표		1607	1607	0	19	1588	0	706	774	43	38	0	10	17	0	0
충청북도	단양군	거소우편투표		116	108	8	10	98	0	48	42	5	1	0	0	2	0	0
충청북도	단양군	단양읍	계	8495	5893	2602	206	5687	0	3267	2159	107	89	0	38	27	0	0
충청북도	단양군	매포읍	계	5084	3478	1606	124	3354	0	2085	1030	64	83	0	42	50	0	0
충청북도	단양군	단성면	계	1496	987	509	40	947	0	631	259	20	19	0	13	5	0	0
충청북도	단양군	대강면	계	2178	1435	743	79	1356	0	990	294	20	29	0	11	12	0	0
충청북도	단양군	가곡면	계	1789	1212	577	48	1164	0	711	364	24	35	0	17	13	0	0
충청북도	단양군	영춘면	계	2958	2090	868	97	1993	0	1381	434	64	49	0	33	32	0	0
충청북도	단양군	어상천면	계	1615	964	651	61	903	0	507	338	20	17	0	12	9	0	0
충청북도	단양군	적성면	계	1354	903	451	34	869	0	579	229	19	19	0	12	11	0	0
충청북도	영동군	관외사전투표		2771	2771	0	65	2706	0	1184	1316	97	51	0	31	27	0	0
충청북도	영동군	거소우편투표		314	292	22	38	254	0	139	82	9	11	0	10	3	0	0
충청북도	영동군	영동읍	계	16229	11208	5021	412	10796	0	6006	4094	303	185	0	132	76	0	0
충청북도	영동군	용산면	계	2971	2002	969	125	1877	0	1151	569	54	51	0	29	23	0	0
충청북도	영동군	황간면	계	3883	2580	1303	150	2430	0	1594	678	52	54	0	27	25	0	0
충청북도	영동군	추풍령면	계	2154	1544	610	79	1465	0	942	422	38	28	0	19	16	0	0
충청북도	영동군	매곡면	계	1786	1283	503	76	1207	0	925	220	16	23	0	12	11	0	0
충청북도	영동군	상촌면	계	2087	1582	505	107	1475	0	966	401	38	35	0	18	17	0	0
충청북도	영동군	양강면	계	2698	1845	853	105	1740	0	1057	502	49	54	0	30	48	0	0
충청북도	영동군	용화면	계	866	649	217	41	608	0	381	176	14	21	0	6	10	0	0
충청북도	영동군	학산면	계	2586	1767	819	73	1694	0	1051	478	41	84	0	20	20	0	0
충청북도	영동군	양산면	계	1743	1206	537	49	1157	0	705	346	34	42	0	16	14	0	0
충청북도	영동군	심천면	계	2924	1960	964	89	1871	0	1249	509	37	36	0	21	19	0	0
충청북도	보은군	관외사전투표		2324	2322	2	71	2251	0	1051	1006	72	59	0	31	32	0	0
충청북도	보은군	거소우편투표		325	306	19	19	287	0	168	89	10	4	0	6	10	0	0
충청북도	보은군	보은읍	계	11460	8175	3285	395	7780	0	4526	2539	225	221	0	190	79	0	0
충청북도	보은군	속리산면	계	1815	1315	500	79	1236	0	768	365	44	35	0	13	11	0	0
충청북도	보은군	장안면	계	1102	830	272	45	785	0	454	212	40	44	0	23	12	0	0
충청북도	보은군	마로면	계	2178	1637	541	97	1540	0	933	448	42	65	0	29	23	0	0
충청북도	보은군	탄부면	계	1652	1207	445	92	1115	0	669	321	31	53	0	23	18	0	0
충청북도	보은군	삼승면	계	2029	1526	503	167	1359	0	796	443	42	40	0	26	12	0	0
충청북도	보은군	수한면	계	1589	1152	437	91	1061	0	675	248	31	45	0	39	23	0	0
충청북도	보은군	회남면	계	639	505	134	36	469	0	256	136	13	15	0	7	42	0	0
충청북도	보은군	회인면	계	1601	1256	345	151	1105	0	638	300	45	69	0	23	30	0	0
충청북도	보은군	내북면	계	1547	1120	427	74	1046	0	541	310	39	89	0	37	30	0	0
충청북도	보은군	산외면	계	1548	1208	340	124	1084	0	661	276	34	47	0	36	30	0	0
충청북도	옥천군	관외사전투표		2259	2259	0	46	2213	0	985	1085	69	32	0	18	24	0	0
충청북도	옥천군	거소우편투표		589	547	42	31	516	0	323	121	25	19	0	8	20	0	0
충청북도	옥천군	옥천읍	계	22119	14614	7505	473	14141	0	7649	5585	359	239	0	177	132	0	0
충청북도	옥천군	동이면	계	2818	1919	899	106	1813	0	968	713	43	40	0	19	30	0	0
충청북도	옥천군	안남면	계	1262	939	323	69	870	0	444	333	33	25	0	17	18	0	0
충청북도	옥천군	안내면	계	1848	1289	559	72	1217	0	756	369	31	26	0	12	23	0	0
충청북도	옥천군	청성면	계	2134	1465	669	102	1363	0	773	443	40	59	0	26	22	0	0
충청북도	옥천군	청산면	계	2944	2104	840	178	1926	0	1199	535	55	80	0	28	29	0	0
충청북도	옥천군	이원면	계	3946	2675	1271	161	2514	0	1522	838	59	45	0	26	24	0	0
충청북도	옥천군	군서면	계	2025	1417	608	71	1346	0	773	493	27	21	0	10	22	0	0
충청북도	옥천군	군북면	계	2546	1663	883	101	1562	0	817	652	32	29	0	20	12	0	0
충청북도	음성군	관외사전투표		3596	3595	1	74	3521	0	1562	1627	133	105	0	36	58	0	0
충청북도	음성군	거소우편투표		789	728	61	174	554	0	276	156	27	37	0	28	30	0	0
충청북도	음성군	음성읍	계	14435	8406	6029	533	7873	0	4360	2984	197	125	0	117	90	0	0
충청북도	음성군	금왕읍	계	16095	8084	8011	276	7808	0	4153	3170	192	179	0	72	42	0	0
충청북도	음성군	소이면	계	2668	1709	959	103	1606	0	920	512	57	44	0	26	47	0	0
충청북도	음성군	원남면	계	2689	1631	1058	181	1450	0	834	486	38	39	0	24	29	0	0
충청북도	음성군	맹동면	계	4013	1969	2044	216	1753	0	959	640	51	40	0	22	41	0	0
충청북도	음성군	대소면	계	12642	5828	6814	133	5695	0	2760	2575	154	113	0	61	32	0	0
충청북도	음성군	삼성면	계	6598	3517	3081	121	3396	0	2026	1153	80	81	0	27	29	0	0
충청북도	음성군	생극면	계	4047	2161	1886	57	2104	0	1359	631	39	41	0	15	19	0	0
충청북도	음성군	감곡면	계	8863	4406	4457	120	4286	0	2611	1412	104	108	0	25	26	0	0
충청북도	진천군	관외사전투표		2620	2619	1	51	2568	0	1133	1190	141	52	0	29	23	0	0
충청북도	진천군	거소우편투표		158	148	10	6	142	0	85	46	4	0	0	3	4	0	0
충청북도	진천군	진천읍	계	22532	13248	9284	646	12602	0	6474	4950	703	236	0	168	71	0	0
충청북도	진천군	덕산면	계	4634	2767	1867	81	2686	0	1552	929	97	56	0	31	21	0	0
충청북도	진천군	초평면	계	2925	1985	940	90	1895	0	991	730	77	42	0	34	21	0	0
충청북도	진천군	문백면	계	3234	1968	1266	110	1858	0	1102	613	60	33	0	33	17	0	0
충청북도	진천군	백곡면	계	1840	1235	605	70	1165	0	775	275	56	22	0	19	18	0	0
충청북도	진천군	이월면	계	6047	3474	2573	137	3337	0	1901	1076	216	57	0	62	25	0	0
충청북도	진천군	광혜원면	계	8241	4224	4017	154	4070	0	2186	1619	130	66	0	38	31	0	0
충청북도	괴산군	관외사전투표		2386	2385	1	61	2324	0	1071	1056	91	58	0	21	27	0	0
충청북도	괴산군	거소우편투표		254	230	24	29	201	0	121	48	7	2	0	11	12	0	0
충청북도	괴산군	괴산읍	계	7539	5213	2326	190	5023	0	2854	1752	154	94	0	75	94	0	0
충청북도	괴산군	감물면	계	1605	1146	459	88	1058	0	689	260	26	27	0	25	31	0	0
충청북도	괴산군	장연면	계	1701	1124	577	69	1055	0	693	239	32	28	0	35	28	0	0
충청북도	괴산군	연풍면	계	2099	1508	591	73	1435	0	943	325	36	31	0	61	39	0	0
충청북도	괴산군	칠성면	계	2527	1763	764	106	1657	0	1006	442	69	48	0	27	65	0	0
충청북도	괴산군	문광면	계	1815	1237	578	79	1158	0	598	409	54	37	0	37	23	0	0
충청북도	괴산군	청천면	계	4288	3052	1236	171	2881	0	1842	689	87	79	0	39	145	0	0
충청북도	괴산군	청안면	계	2924	1931	993	151	1780	0	1111	468	43	51	0	72	35	0	0
충청북도	괴산군	사리면	계	2425	1719	706	104	1615	0	998	419	54	79	0	38	27	0	0
충청북도	괴산군	소수면	계	1701	1140	561	78	1062	0	594	345	38	45	0	21	19	0	0
충청북도	괴산군	불정면	계	2440	1804	636	96	1708	0	1075	427	62	71	0	36	37	0	0
충청북도	증평군	관외사전투표		1278	1277	1	25	1252	0	573	599	28	26	0	11	15	0	0
충청북도	증평군	거소우편투표		66	64	2	4	60	0	33	15	5	4	0	2	1	0	0
충청북도	증평군	증평읍	계	24278	15510	8768	559	14951	0	8313	5715	358	270	0	152	143	0	0
충청북도	증평군	도안면	계	1860	1347	513	68	1279	0	705	451	45	36	0	19	23	0	0
충청남도	천안시서북구	관외사전투표		9571	9557	14	152	9405	0	3701	4775	297	314	0	116	144	58	0
충청남도	천안시서북구	거소우편투표		308	290	18	15	275	0	143	102	3	8	0	5	9	5	0
충청남도	천안시서북구	성환읍	계	22962	10879	12083	448	10431	0	6225	3618	227	176	0	83	53	49	0
충청남도	천안시서북구	성거읍	계	15075	6381	8694	223	6158	0	3031	2716	184	102	0	54	40	31	0
충청남도	천안시서북구	직산읍	계	16717	6813	9904	191	6622	0	3304	2848	177	115	0	88	36	54	0
충청남도	천안시서북구	입장면	계	8444	3894	4550	157	3737	0	2310	1222	76	62	0	36	8	23	0
충청남도	천안시서북구	성정1동	계	15097	5817	9280	136	5681	0	3081	2220	138	113	0	48	56	25	0
충청남도	천안시서북구	성정2동	계	21490	6992	14498	141	6851	0	3188	3103	182	168	0	85	92	33	0
충청남도	천안시서북구	쌍용1동	계	12583	6085	6498	108	5977	0	3040	2563	149	107	0	43	52	23	0
충청남도	천안시서북구	쌍용3동	계	16025	8079	7946	156	7923	0	3409	3897	212	223	0	59	79	44	0
충청남도	천안시서북구	백석동	계	20944	10540	10404	134	10406	0	4165	5373	275	282	0	83	186	42	0
충청남도	천안시서북구	불당동	계	14814	7623	7191	82	7541	0	2755	4099	234	310	0	38	86	19	0
충청남도	천안시서북구	부성1동	계	25640	10746	14894	201	10545	0	4083	5569	304	356	0	126	49	58	0
충청남도	천안시서북구	부성2동	계	23443	9588	13855	147	9441	0	3465	5158	303	273	0	120	85	37	0
충청남도	천안시동남구	관외사전투표		11033	11004	29	162	10842	0	4587	5283	352	303	0	125	127	65	0
충청남도	천안시동남구	거소우편투표		412	394	18	8	386	0	224	118	17	7	0	6	10	4	0
충청남도	천안시동남구	목천읍	계	19511	8756	10755	167	8589	0	4090	3888	252	194	0	72	46	47	0
충청남도	천안시동남구	풍세면	계	3919	2114	1805	69	2045	0	1302	611	46	30	0	23	10	23	0
충청남도	천안시동남구	광덕면	계	3799	2218	1581	122	2096	0	1328	642	45	28	0	22	10	21	0
충청남도	천안시동남구	북면	계	3950	1859	2091	82	1777	0	1092	543	53	39	0	22	6	22	0
충청남도	천안시동남구	성남면	계	3152	1779	1373	94	1685	0	1033	545	41	28	0	15	8	15	0
충청남도	천안시동남구	수신면	계	2153	1158	995	59	1099	0	717	323	20	13	0	9	7	10	0
충청남도	천안시동남구	병천면	계	5463	2713	2750	123	2590	0	1597	842	62	43	0	15	15	16	0
충청남도	천안시동남구	동면	계	2116	1185	931	83	1102	0	734	282	22	25	0	8	9	22	0
충청남도	천안시동남구	중앙동	계	5155	2357	2798	55	2302	0	1548	654	28	38	0	9	12	13	0
충청남도	천안시동남구	문성동	계	4328	1759	2569	42	1717	0	1047	565	29	41	0	15	13	7	0
충청남도	천안시동남구	원성1동	계	8445	3879	4566	90	3789	0	2225	1360	70	73	0	37	13	11	0
충청남도	천안시동남구	원성2동	계	10268	4668	5600	134	4534	0	2737	1567	89	66	0	45	11	19	0
충청남도	천안시동남구	봉명동	계	16510	6276	10234	129	6147	0	3251	2501	137	125	0	60	42	31	0
충청남도	천안시동남구	일봉동	계	17339	8135	9204	166	7969	0	3866	3570	218	169	0	67	42	37	0
충청남도	천안시동남구	신방동	계	30880	14123	16757	464	13659	0	5351	7131	525	355	0	114	133	50	0
충청남도	천안시동남구	청룡동	계	32459	16297	16162	373	15924	0	7521	7381	373	380	0	142	61	66	0
충청남도	천안시동남구	신안동	계	26544	12160	14384	184	11976	0	5963	5157	306	328	0	117	51	54	0
충청남도	천안시동남구	쌍용2동	계	29060	14160	14900	283	13877	0	5794	6942	490	391	0	108	117	35	0
충청남도	공주시	관외사전투표		6291	6288	3	138	6150	0	2524	3150	193	151	0	44	53	35	0
충청남도	공주시	거소우편투표		310	284	26	17	267	0	163	71	7	8	0	6	4	8	0
충청남도	공주시	유구읍	계	7198	4155	3043	197	3958	0	2695	992	74	59	0	29	62	47	0
충청남도	공주시	이인면	계	3271	1892	1379	100	1792	0	1089	596	33	18	0	16	23	17	0
충청남도	공주시	탄천면	계	2965	1694	1271	121	1573	0	942	513	35	33	0	14	21	15	0
충청남도	공주시	계룡면	계	5394	3146	2248	175	2971	0	1828	924	80	67	0	18	23	31	0
충청남도	공주시	반포면	계	4126	2205	1921	141	2064	0	1110	787	45	59	0	17	30	16	0
충청남도	공주시	의당면	계	4389	2331	2058	115	2216	0	1159	900	33	70	0	11	19	24	0
충청남도	공주시	정안면	계	4551	2579	1972	115	2464	0	1561	748	48	44	0	20	17	26	0
충청남도	공주시	우성면	계	4986	3204	1782	286	2918	0	1634	1077	65	55	0	25	30	32	0
충청남도	공주시	사곡면	계	2777	1824	953	113	1711	0	1020	501	58	53	0	16	43	20	0
충청남도	공주시	신풍면	계	2884	1833	1051	183	1650	0	1003	455	47	71	0	30	21	23	0
충청남도	공주시	중학동	계	5100	2784	2316	103	2681	0	1507	1026	46	53	0	21	12	16	0
충청남도	공주시	웅진동	계	7262	4063	3199	150	3913	0	2230	1477	83	68	0	10	16	29	0
충청남도	공주시	금학동	계	4646	2494	2152	96	2398	0	1179	1054	62	52	0	11	22	18	0
충청남도	공주시	옥룡동	계	8367	4533	3834	186	4347	0	2375	1713	85	84	0	28	28	34	0
충청남도	공주시	신관동	계	14640	7958	6682	182	7776	0	3660	3695	160	155	0	37	35	34	0
충청남도	공주시	월송동	계	7282	4317	2965	136	4181	0	1899	2055	99	86	0	21	10	11	0
충청남도	보령시	관외사전투표		6664	6660	4	185	6475	0	2970	3036	181	127	0	60	43	58	0
충청남도	보령시	거소우편투표		402	360	42	20	340	0	198	104	12	6	0	10	2	8	0
충청남도	보령시	웅천읍	계	5921	3778	2143	442	3336	0	2195	942	65	52	0	34	18	30	0
충청남도	보령시	주포면	계	1502	910	592	86	824	0	493	261	24	19	0	13	7	7	0
충청남도	보령시	주교면	계	4425	2669	1756	324	2345	0	1652	631	15	19	0	11	9	8	0
충청남도	보령시	오천면	계	4293	2630	1663	222	2408	0	1402	611	111	94	0	59	64	67	0
충청남도	보령시	천북면	계	3236	2291	945	227	2064	0	1224	602	118	46	0	36	14	24	0
충청남도	보령시	청소면	계	2560	1812	748	168	1644	0	1117	409	42	21	0	13	19	23	0
충청남도	보령시	청라면	계	3537	2365	1172	239	2126	0	1400	498	47	52	0	86	18	25	0
충청남도	보령시	남포면	계	4594	2850	1744	437	2413	0	1578	639	46	46	0	49	16	39	0
충청남도	보령시	주산면	계	2349	1697	652	223	1474	0	906	397	40	65	0	28	12	26	0
충청남도	보령시	미산면	계	1636	1131	505	182	949	0	643	200	21	44	0	14	8	19	0
충청남도	보령시	성주면	계	2285	1347	938	102	1245	0	778	369	32	21	0	24	9	12	0
충청남도	보령시	대천1동	계	11495	6740	4755	238	6502	0	3599	2476	167	139	0	65	17	39	0
충청남도	보령시	대천2동	계	5577	3284	2293	135	3149	0	1975	1012	52	42	0	35	9	24	0
충청남도	보령시	대천3동	계	10136	5760	4376	267	5493	0	3079	2052	156	98	0	50	16	42	0
충청남도	보령시	대천4동	계	10019	5890	4129	263	5627	0	3137	2063	164	126	0	51	31	55	0
충청남도	보령시	대천5동	계	5972	3178	2794	161	3017	0	2037	770	67	60	0	26	21	36	0
충청남도	아산시	관외사전투표		10330	10325	5	184	10141	0	4343	4952	290	301	0	104	89	62	0
충청남도	아산시	거소우편투표		388	368	20	30	338	0	189	108	7	10	0	9	7	8	0
충청남도	아산시	염치읍	계	6022	2860	3162	129	2731	0	1602	932	72	76	0	20	13	16	0
충청남도	아산시	배방읍	계	46023	22033	23990	349	21684	0	8454	11462	662	731	0	168	109	98	0
충청남도	아산시	송악면	계	3210	1982	1228	119	1863	0	1116	568	63	41	0	28	27	20	0
충청남도	아산시	탕정면	계	16187	7676	8511	110	7566	0	2714	4136	244	302	0	65	66	39	0
충청남도	아산시	음봉면	계	12256	5163	7093	126	5037	0	2517	2126	148	149	0	36	34	27	0
충청남도	아산시	둔포면	계	8869	4115	4754	148	3967	0	2527	1200	81	80	0	34	9	36	0
충청남도	아산시	영인면	계	5457	3176	2281	155	3021	0	1885	963	58	50	0	27	14	24	0
충청남도	아산시	인주면	계	6444	3067	3377	140	2927	0	1536	1096	107	80	0	66	10	32	0
충청남도	아산시	선장면	계	3253	1861	1392	113	1748	0	1201	438	35	30	0	14	7	23	0
충청남도	아산시	도고면	계	4234	2372	1862	140	2232	0	1594	530	34	32	0	25	4	13	0
충청남도	아산시	신창면	계	15400	6740	8660	195	6545	0	3536	2530	181	136	0	88	27	47	0
충청남도	아산시	온양1동	계	5334	2608	2726	61	2547	0	1686	747	45	30	0	19	6	14	0
충청남도	아산시	온양2동	계	6923	3331	3592	78	3253	0	2029	1046	88	39	0	27	11	13	0
충청남도	아산시	온양3동	계	23373	12119	11254	221	11898	0	6086	4915	388	266	0	140	49	54	0
충청남도	아산시	온양4동	계	14502	6791	7711	149	6642	0	3351	2814	231	107	0	78	29	32	0
충청남도	아산시	온양5동	계	15964	7567	8397	214	7353	0	3767	3062	194	175	0	72	53	30	0
충청남도	아산시	온양6동	계	18055	9233	8822	343	8890	0	4203	3948	297	207	0	103	66	66	0
충청남도	서산시	관외사전투표		7114	7108	6	153	6955	0	3030	3280	244	218	0	63	64	56	0
충청남도	서산시	거소우편투표		457	423	34	23	400	0	190	97	31	20	0	13	8	41	0
충청남도	서산시	대산읍	계	11965	5963	6002	167	5796	0	3065	2108	189	308	0	57	20	49	0
충청남도	서산시	인지면	계	5769	3186	2583	146	3040	0	1733	1092	78	59	0	34	20	24	0
충청남도	서산시	부석면	계	4950	2814	2136	157	2657	0	1761	725	54	61	0	19	5	32	0
충청남도	서산시	팔봉면	계	2912	1918	994	147	1771	0	1169	406	29	90	0	24	21	32	0
충청남도	서산시	지곡면	계	6694	3244	3450	136	3108	0	1654	1158	89	115	0	34	20	38	0
충청남도	서산시	성연면	계	2118	1243	875	72	1171	0	765	316	21	33	0	12	8	16	0
충청남도	서산시	음암면	계	8095	4100	3995	175	3925	0	2250	1364	109	96	0	49	20	37	0
충청남도	서산시	운산면	계	4815	2907	1908	192	2715	0	1828	665	88	52	0	36	20	26	0
충청남도	서산시	해미면	계	6695	3532	3163	135	3397	0	2299	861	82	60	0	34	22	39	0
충청남도	서산시	고북면	계	5958	3172	2786	175	2997	0	1769	1014	69	72	0	26	16	31	0
충청남도	서산시	부춘동	계	13975	6920	7055	196	6724	0	3504	2694	174	191	0	74	30	57	0
충청남도	서산시	동문1동	계	12675	6155	6520	148	6007	0	3243	2300	154	184	0	38	47	41	0
충청남도	서산시	동문2동	계	7603	3723	3880	91	3632	0	2204	1217	78	74	0	22	14	23	0
충청남도	서산시	수석동	계	11026	5501	5525	141	5360	0	2998	1941	160	136	0	49	38	38	0
충청남도	서산시	석남동	계	18085	8815	9270	243	8572	0	4140	3762	240	245	0	69	51	65	0
충청남도	태안군	관외사전투표		2857	2856	1	76	2780	0	1292	1263	84	71	0	19	25	26	0
충청남도	태안군	거소우편투표		303	262	41	19	243	0	134	81	9	5	0	7	2	5	0
충청남도	태안군	태안읍	계	20609	12880	7729	827	12053	0	7413	3693	283	318	0	121	60	165	0
충청남도	태안군	안면읍	계	7785	5089	2696	447	4642	0	2830	1347	95	126	0	124	29	91	0
충청남도	태안군	고남면	계	2189	1475	714	138	1337	0	800	378	43	30	0	46	10	30	0
충청남도	태안군	남면	계	3795	2512	1283	282	2230	0	1263	648	70	85	0	30	32	102	0
충청남도	태안군	근흥면	계	4928	3169	1759	292	2877	0	2005	605	65	94	0	30	23	55	0
충청남도	태안군	소원면	계	4834	3295	1539	301	2994	0	1850	626	96	250	0	51	45	76	0
충청남도	태안군	원북면	계	4017	2743	1274	270	2473	0	1416	673	74	120	0	102	27	61	0
충청남도	태안군	이원면	계	2014	1387	627	144	1243	0	800	265	44	56	0	50	3	25	0
충청남도	금산군	관외사전투표		2522	2520	2	57	2463	0	1068	1221	73	48	0	19	19	15	0
충청남도	금산군	거소우편투표		131	111	20	6	105	0	68	28	4	2	0	1	1	1	0
충청남도	금산군	금산읍	계	17807	10932	6875	397	10535	0	6008	3873	203	181	0	75	62	133	0
충청남도	금산군	금성면	계	3348	2095	1253	158	1937	0	1130	583	54	48	0	80	18	24	0
충청남도	금산군	제원면	계	2671	1697	974	136	1561	0	990	427	60	37	0	18	4	25	0
충청남도	금산군	부리면	계	2522	1562	960	112	1450	0	900	382	51	32	0	25	16	44	0
충청남도	금산군	군북면	계	2217	1399	818	103	1296	0	753	390	55	41	0	17	9	31	0
충청남도	금산군	남일면	계	2297	1495	802	76	1419	0	873	372	43	41	0	14	22	54	0
충청남도	금산군	남이면	계	1841	1176	665	71	1105	0	594	387	18	24	0	17	19	46	0
충청남도	금산군	진산면	계	2873	1928	945	145	1783	0	1066	556	48	48	0	18	15	32	0
충청남도	금산군	복수면	계	3031	1812	1219	90	1722	0	973	573	59	66	0	17	11	23	0
충청남도	금산군	추부면	계	5553	3304	2249	224	3080	0	1675	1098	91	123	0	36	20	37	0
충청남도	논산시	관외사전투표		6438	6436	2	123	6313	0	2633	3176	194	155	0	61	46	48	0
충청남도	논산시	거소우편투표		362	337	25	30	307	0	152	111	12	18	0	5	2	7	0
충청남도	논산시	강경읍	계	8402	4312	4090	255	4057	0	1938	1849	101	62	0	37	23	47	0
충청남도	논산시	연무읍	계	12372	6866	5506	364	6502	0	3405	2576	212	147	0	62	35	65	0
충청남도	논산시	성동면	계	4244	2602	1642	265	2337	0	1343	813	69	38	0	31	13	30	0
충청남도	논산시	광석면	계	4203	2527	1676	122	2405	0	1407	798	69	51	0	26	21	33	0
충청남도	논산시	노성면	계	3032	1897	1135	107	1790	0	1038	616	52	26	0	19	11	28	0
충청남도	논산시	상월면	계	3422	2063	1359	132	1931	0	1089	673	84	35	0	11	13	26	0
충청남도	논산시	부적면	계	3438	2038	1400	76	1962	0	1035	761	45	52	0	18	22	29	0
충청남도	논산시	연산면	계	5762	3464	2298	178	3286	0	1998	1039	80	76	0	29	21	43	0
충청남도	논산시	벌곡면	계	2393	1442	951	85	1357	0	774	475	30	29	0	8	12	29	0
충청남도	논산시	양촌면	계	5170	3218	1952	204	3014	0	1702	1021	81	56	0	37	37	80	0
충청남도	논산시	가야곡면	계	3504	2171	1333	131	2040	0	1160	657	92	56	0	27	19	29	0
충청남도	논산시	은진면	계	4235	2310	1925	159	2151	0	1175	789	76	48	0	22	15	26	0
충청남도	논산시	채운면	계	2307	1395	912	125	1270	0	669	513	30	23	0	6	10	19	0
충청남도	논산시	취암동	계	21571	11742	9829	340	11402	0	5600	5087	264	226	0	93	43	89	0
충청남도	논산시	부창동	계	13107	7200	5907	218	6982	0	3416	3082	185	155	0	52	28	64	0
충청남도	계룡시	관외사전투표		2149	2148	1	40	2108	0	1092	878	46	51	0	10	22	9	0
충청남도	계룡시	거소우편투표		99	94	5	4	90	0	57	27	2	2	0	0	2	0	0
충청남도	계룡시	두마면	계	5384	3390	1994	103	3287	0	1661	1429	75	82	0	11	15	14	0
충청남도	계룡시	엄사면	계	13418	8213	5205	296	7917	0	4195	3254	157	171	0	54	36	50	0
충청남도	계룡시	신도안면	계	2640	1735	905	56	1679	0	1124	505	15	19	0	1	9	6	0
충청남도	계룡시	금암동	계	6184	3977	2207	157	3820	0	2041	1530	95	113	0	16	9	16	0
충청남도	당진시	관외사전투표		6973	6973	0	131	6842	0	2991	3258	210	182	0	88	63	50	0
충청남도	당진시	거소우편투표		315	272	43	29	243	0	149	58	9	10	0	4	5	8	0
충청남도	당진시	당진1동	계	15902	7659	8243	201	7458	0	3646	3299	197	171	0	65	30	50	0
충청남도	당진시	당진2동	계	12866	6361	6505	182	6179	0	3119	2549	198	168	0	71	29	45	0
충청남도	당진시	당진3동	계	12461	6464	5997	143	6321	0	2576	3242	184	176	0	67	37	39	0
충청남도	당진시	합덕읍	계	8721	5096	3625	409	4687	0	2910	1401	149	106	0	51	17	53	0
충청남도	당진시	송악읍	계	19886	8489	11397	267	8222	0	4163	3402	227	220	0	95	26	89	0
충청남도	당진시	고대면	계	5043	3168	1875	281	2887	0	1653	1005	64	69	0	43	15	38	0
충청남도	당진시	석문면	계	6664	3730	2934	166	3564	0	2205	1097	103	58	0	41	17	43	0
충청남도	당진시	대호지면	계	2328	1433	895	88	1345	0	854	359	32	43	0	20	14	23	0
충청남도	당진시	정미면	계	3149	1831	1318	76	1755	0	1089	480	56	49	0	42	16	23	0
충청남도	당진시	면천면	계	3264	1784	1480	69	1715	0	1061	532	39	36	0	17	10	20	0
충청남도	당진시	순성면	계	4678	2753	1925	205	2548	0	1570	781	76	56	0	33	13	19	0
충청남도	당진시	우강면	계	4863	2769	2094	161	2608	0	1682	748	64	56	0	25	4	29	0
충청남도	당진시	신평면	계	12848	6490	6358	227	6263	0	3483	2356	147	110	0	70	40	57	0
충청남도	당진시	송산면	계	8675	4136	4539	156	3980	0	1960	1642	141	123	0	63	20	31	0
충청남도	부여군	관외사전투표		3299	3296	3	56	3240	0	1401	1585	95	76	0	33	28	22	0
충청남도	부여군	거소우편투표		364	339	25	64	275	0	156	59	12	17	0	8	9	14	0
충청남도	부여군	부여읍	계	18313	10898	7415	742	10156	0	6174	3395	245	176	0	66	33	67	0
충청남도	부여군	규암면	계	7766	4440	3326	316	4124	0	2570	1223	105	70	0	49	54	53	0
충청남도	부여군	은산면	계	3572	2255	1317	234	2021	0	1349	473	42	41	0	57	20	39	0
충청남도	부여군	외산면	계	2322	1670	652	242	1428	0	819	497	44	30	0	13	9	16	0
충청남도	부여군	내산면	계	1536	1024	512	128	896	0	590	230	24	22	0	6	12	12	0
충청남도	부여군	구룡면	계	2236	1485	751	182	1303	0	790	391	41	29	0	17	8	27	0
충청남도	부여군	홍산면	계	2684	1839	845	162	1677	0	1080	491	45	21	0	11	7	22	0
충청남도	부여군	옥산면	계	1320	871	449	112	759	0	485	205	22	19	0	8	9	11	0
충청남도	부여군	남면	계	1809	1187	622	107	1080	0	706	275	20	38	0	8	7	26	0
충청남도	부여군	충화면	계	1113	683	430	125	558	0	362	163	13	6	0	5	2	7	0
충청남도	부여군	양화면	계	1702	1023	679	110	913	0	655	205	17	13	0	3	13	7	0
충청남도	부여군	임천면	계	2775	1691	1084	124	1567	0	936	535	30	21	0	15	8	22	0
충청남도	부여군	장암면	계	2673	1577	1096	150	1427	0	1003	324	31	16	0	26	7	20	0
충청남도	부여군	세도면	계	3156	1889	1267	154	1735	0	1065	538	37	41	0	21	10	23	0
충청남도	부여군	석성면	계	2751	1541	1210	126	1415	0	939	402	29	15	0	6	7	17	0
충청남도	부여군	초촌면	계	2152	1201	951	90	1111	0	674	340	41	17	0	15	8	16	0
충청남도	서천군	관외사전투표		3126	3125	1	78	3047	0	1230	1569	89	77	0	24	34	24	0
충청남도	서천군	거소우편투표		337	264	73	16	248	0	130	83	6	8	0	8	8	5	0
충청남도	서천군	장항읍	계	10162	6013	4149	383	5630	0	3340	2005	101	61	0	46	30	47	0
충청남도	서천군	서천읍	계	10609	7202	3407	445	6757	0	3698	2631	142	112	0	69	46	59	0
충청남도	서천군	마서면	계	4829	2876	1953	353	2523	0	1287	1037	73	49	0	26	24	27	0
충청남도	서천군	화양면	계	2276	1484	792	128	1356	0	761	482	35	26	0	21	10	21	0
충청남도	서천군	기산면	계	1629	1140	489	106	1034	0	575	369	28	18	0	18	8	18	0
충청남도	서천군	한산면	계	2494	1722	772	130	1592	0	891	564	37	41	0	27	9	23	0
충청남도	서천군	마산면	계	1354	918	436	62	856	0	410	372	27	16	0	10	4	17	0
충청남도	서천군	시초면	계	1180	808	372	78	730	0	440	202	15	16	0	38	11	8	0
충청남도	서천군	문산면	계	1205	824	381	58	766	0	483	223	14	19	0	7	9	11	0
충청남도	서천군	판교면	계	2013	1431	582	168	1263	0	818	328	24	22	0	19	25	27	0
충청남도	서천군	종천면	계	2014	1315	699	117	1198	0	717	377	35	13	0	25	15	16	0
충청남도	서천군	비인면	계	2860	1810	1050	198	1612	0	936	545	52	31	0	25	7	16	0
충청남도	서천군	서면	계	4071	2488	1583	208	2280	0	1401	738	52	30	0	28	9	22	0
충청남도	홍성군	관외사전투표		3750	3749	1	81	3668	0	1523	1719	133	92	0	28	135	38	0
충청남도	홍성군	거소우편투표		282	243	39	16	227	0	146	45	14	4	0	7	7	4	0
충청남도	홍성군	홍성읍	계	32377	17441	14936	518	16923	0	9291	6042	418	345	0	120	594	113	0
충청남도	홍성군	광천읍	계	9044	5362	3682	260	5102	0	3575	1193	87	102	0	37	55	53	0
충청남도	홍성군	홍북면	계	5083	3063	2020	140	2923	0	1585	1073	58	77	0	16	80	34	0
충청남도	홍성군	금마면	계	3282	2007	1275	119	1888	0	1195	517	48	49	0	20	36	23	0
충청남도	홍성군	홍동면	계	3073	1783	1290	88	1695	0	930	446	36	61	0	23	171	28	0
충청남도	홍성군	장곡면	계	2891	1786	1105	136	1650	0	1091	338	26	71	0	18	71	35	0
충청남도	홍성군	은하면	계	2292	1489	803	64	1425	0	936	338	35	46	0	11	26	33	0
충청남도	홍성군	결성면	계	2131	1479	652	80	1399	0	949	317	24	44	0	13	17	35	0
충청남도	홍성군	서부면	계	3141	2056	1085	124	1932	0	1343	446	53	37	0	13	15	25	0
충청남도	홍성군	갈산면	계	3498	2205	1293	120	2085	0	1487	455	44	32	0	17	21	29	0
충청남도	홍성군	구항면	계	3620	1883	1737	90	1793	0	1141	500	50	41	0	18	21	22	0
충청남도	청양군	관외사전투표		1789	1789	0	56	1733	0	806	746	59	61	0	16	23	22	0
충청남도	청양군	거소우편투표		83	77	6	16	61	0	38	13	0	4	0	4	0	2	0
충청남도	청양군	청양읍	계	7786	5750	2036	343	5407	0	3245	1595	144	179	0	55	108	81	0
충청남도	청양군	운곡면	계	1882	1314	568	93	1221	0	819	235	42	43	0	24	32	26	0
충청남도	청양군	대치면	계	1860	1393	467	85	1308	0	852	277	39	61	0	20	28	31	0
충청남도	청양군	정산면	계	2957	2177	780	205	1972	0	1206	504	66	71	0	56	39	30	0
충청남도	청양군	목면	계	1276	937	339	73	864	0	481	236	32	46	0	25	19	25	0
충청남도	청양군	청남면	계	1710	1259	451	122	1137	0	713	258	41	45	0	25	25	30	0
충청남도	청양군	장평면	계	2161	1564	597	158	1406	0	757	384	69	71	0	35	62	28	0
충청남도	청양군	남양면	계	2417	1772	645	191	1581	0	886	391	50	84	0	21	45	104	0
충청남도	청양군	화성면	계	2008	1419	589	111	1308	0	831	269	62	59	0	23	39	25	0
충청남도	청양군	비봉면	계	1915	1401	514	109	1292	0	758	306	46	87	0	22	29	44	0
충청남도	예산군	관외사전투표		3944	3942	2	94	3848	0	1921	1579	133	108	0	38	43	26	0
충청남도	예산군	거소우편투표		199	182	17	24	158	0	98	39	5	6	0	5	1	4	0
충청남도	예산군	예산읍	계	28116	15728	12388	1082	14646	0	9862	3781	411	315	0	95	67	115	0
충청남도	예산군	삽교읍	계	6579	3590	2989	174	3416	0	2478	672	79	105	0	22	21	39	0
충청남도	예산군	대술면	계	2434	1685	749	134	1551	0	1082	294	39	95	0	15	9	17	0
충청남도	예산군	신양면	계	2922	2092	830	280	1812	0	1272	357	35	64	0	14	23	47	0
충청남도	예산군	광시면	계	3025	2239	786	265	1974	0	1346	391	51	39	0	41	44	62	0
충청남도	예산군	대흥면	계	1658	956	702	45	911	0	694	153	18	25	0	4	7	10	0
충청남도	예산군	응봉면	계	2326	1358	968	66	1292	0	962	248	23	18	0	14	14	13	0
충청남도	예산군	덕산면	계	6177	3495	2682	191	3304	0	2317	771	67	63	0	31	25	30	0
충청남도	예산군	봉산면	계	2343	1528	815	94	1434	0	1018	316	40	25	0	19	6	10	0
충청남도	예산군	고덕면	계	4422	2518	1904	143	2375	0	1624	560	63	59	0	24	16	29	0
충청남도	예산군	신암면	계	3583	2342	1241	230	2112	0	1342	603	70	50	0	12	13	22	0
충청남도	예산군	오가면	계	4419	2476	1943	122	2354	0	1702	495	49	53	0	21	13	21	0
전라북도	전주시완산구	관외사전투표		18611	18601	10	388	18213	51	3197	11646	1434	1324	0	226	335	0	0
전라북도	전주시완산구	거소우편투표		753	706	47	56	650	18	189	334	42	38	0	16	13	0	0
전라북도	전주시완산구	중앙동	계	8523	4309	4214	133	4176	24	1135	2402	256	264	0	30	65	0	0
전라북도	전주시완산구	풍남동	계	5259	2568	2691	122	2446	33	637	1359	166	171	0	26	54	0	0
전라북도	전주시완산구	노송동	계	11497	5872	5625	265	5607	59	1302	3251	417	407	0	88	83	0	0
전라북도	전주시완산구	완산동	계	5066	2476	2590	84	2392	33	555	1407	177	167	0	30	23	0	0
전라북도	전주시완산구	동서학동	계	6325	3490	2835	102	3388	30	745	2060	247	212	0	50	44	0	0
전라북도	전주시완산구	서서학동	계	8648	4494	4154	136	4358	50	823	2741	372	276	0	49	47	0	0
전라북도	전주시완산구	중화산1동	계	11713	6452	5261	215	6237	16	1319	3726	499	524	0	51	102	0	0
전라북도	전주시완산구	중화산2동	계	14361	7489	6872	216	7273	15	1423	4427	593	633	0	68	114	0	0
전라북도	전주시완산구	평화1동	계	11756	5759	5997	210	5549	61	1089	3423	451	381	0	77	67	0	0
전라북도	전주시완산구	평화2동	계	32741	17832	14909	291	17541	107	3187	11035	1523	1323	0	160	206	0	0
전라북도	전주시완산구	서신동	계	32372	17712	14660	368	17344	55	3265	10760	1397	1383	0	269	215	0	0
전라북도	전주시완산구	삼천1동	계	10174	5280	4894	129	5151	19	1079	3136	406	407	0	48	56	0	0
전라북도	전주시완산구	삼천2동	계	13103	6465	6638	138	6327	26	1287	3961	473	443	0	69	68	0	0
전라북도	전주시완산구	삼천3동	계	17372	9948	7424	273	9675	36	1771	5902	886	841	0	99	140	0	0
전라북도	전주시완산구	효자1동	계	10811	5802	5009	176	5626	27	1265	3357	406	443	0	53	75	0	0
전라북도	전주시완산구	효자2동	계	9662	4736	4926	138	4598	12	939	2818	359	363	0	44	63	0	0
전라북도	전주시완산구	효자3동	계	12537	7311	5226	192	7119	21	1471	4264	645	551	0	81	86	0	0
전라북도	전주시완산구	효자4동	계	42588	22390	20198	480	21910	52	3860	13418	2138	1914	0	192	336	0	0
전라북도	전주시덕진구	관외사전투표		13775	13768	7	305	13463	38	2424	8600	992	934	0	245	230	0	0
전라북도	전주시덕진구	거소우편투표		577	533	44	35	498	9	121	274	31	30	0	18	15	0	0
전라북도	전주시덕진구	진북동	계	13533	7317	6216	194	7123	32	1716	4203	498	509	0	76	89	0	0
전라북도	전주시덕진구	인후1동	계	14536	8331	6205	216	8115	48	1497	5016	713	637	0	99	105	0	0
전라북도	전주시덕진구	인후2동	계	9831	4759	5072	180	4579	34	997	2836	330	277	0	51	54	0	0
전라북도	전주시덕진구	인후3동	계	24898	12512	12386	255	12257	40	2081	7582	1103	978	0	335	138	0	0
전라북도	전주시덕진구	덕진동	계	14325	6950	7375	223	6727	30	1300	4172	480	524	0	113	108	0	0
전라북도	전주시덕진구	금암1동	계	6584	3063	3521	89	2974	18	612	1799	214	273	0	34	24	0	0
전라북도	전주시덕진구	금암2동	계	9232	4949	4283	156	4793	23	1060	2923	327	356	0	55	49	0	0
전라북도	전주시덕진구	팔복동	계	8527	3978	4549	229	3749	33	662	2389	292	262	0	74	37	0	0
전라북도	전주시덕진구	우아1동	계	9467	4242	5225	143	4099	18	911	2402	310	305	0	100	53	0	0
전라북도	전주시덕진구	우아2동	계	11742	5590	6152	167	5423	20	990	3282	476	383	0	209	63	0	0
전라북도	전주시덕진구	호성동	계	16767	9917	6850	285	9632	30	1653	5761	801	1112	0	160	115	0	0
전라북도	전주시덕진구	송천1동	계	25822	15035	10787	331	14704	53	2166	9176	1544	1227	0	375	163	0	0
전라북도	전주시덕진구	송천2동	계	20270	11287	8983	328	10959	56	1772	6894	1070	884	0	158	125	0	0
전라북도	전주시덕진구	조촌동	계	8124	3976	4148	268	3708	37	615	2407	364	199	0	50	36	0	0
전라북도	전주시덕진구	동산동	계	13506	6965	6541	250	6715	23	1209	4325	549	461	0	81	67	0	0
전라북도	군산시	관외사전투표		13042	13025	17	374	12651	36	2118	8745	781	646	0	172	153	0	0
전라북도	군산시	거소우편투표		730	673	57	27	646	9	145	401	31	27	0	22	11	0	0
전라북도	군산시	옥구읍	계	3054	1795	1259	160	1635	34	298	1014	104	99	0	44	42	0	0
전라북도	군산시	옥산면	계	2295	1450	845	104	1346	32	236	816	110	106	0	32	14	0	0
전라북도	군산시	회현면	계	2941	1870	1071	179	1691	25	293	1065	137	110	0	40	21	0	0
전라북도	군산시	임피면	계	2659	1637	1022	131	1506	20	232	1018	107	83	0	33	13	0	0
전라북도	군산시	서수면	계	2516	1417	1099	109	1308	14	229	822	105	85	0	27	26	0	0
전라북도	군산시	대야면	계	5002	3032	1970	245	2787	39	576	1675	223	192	0	52	30	0	0
전라북도	군산시	개정면	계	3036	1671	1365	98	1573	18	322	1026	105	73	0	19	10	0	0
전라북도	군산시	성산면	계	2743	1615	1128	142	1473	16	283	924	105	107	0	24	14	0	0
전라북도	군산시	나포면	계	2167	1308	859	135	1173	24	202	744	89	65	0	29	20	0	0
전라북도	군산시	옥도면	계	2544	1550	994	113	1437	30	257	956	91	71	0	16	16	0	0
전라북도	군산시	옥서면	계	3670	2261	1409	185	2076	23	395	1370	104	94	0	41	49	0	0
전라북도	군산시	해신동	계	1859	892	967	63	829	17	179	522	34	48	0	19	10	0	0
전라북도	군산시	월명동	계	6386	3121	3265	157	2964	26	692	1910	138	143	0	31	24	0	0
전라북도	군산시	삼학동	계	5876	2930	2946	140	2790	22	613	1837	137	134	0	35	12	0	0
전라북도	군산시	신풍동	계	6639	3274	3365	121	3153	25	627	2067	171	190	0	46	27	0	0
전라북도	군산시	중앙동	계	3458	1649	1809	74	1575	15	372	983	92	80	0	21	12	0	0
전라북도	군산시	흥남동	계	8842	4196	4646	130	4066	31	778	2705	244	216	0	57	35	0	0
전라북도	군산시	조촌동	계	12112	6117	5995	207	5910	37	1093	3968	359	317	0	86	50	0	0
전라북도	군산시	경암동	계	6966	3415	3551	162	3253	38	612	2192	165	161	0	54	31	0	0
전라북도	군산시	구암동	계	5161	2795	2366	121	2674	19	445	1851	149	134	0	59	17	0	0
전라북도	군산시	개정동	계	2634	1522	1112	58	1464	9	271	980	85	83	0	24	12	0	0
전라북도	군산시	수송동	계	29370	14597	14773	306	14291	50	2349	9708	1068	842	0	163	111	0	0
전라북도	군산시	나운1동	계	12881	5897	6984	200	5697	51	1011	3784	352	313	0	123	63	0	0
전라북도	군산시	나운2동	계	19627	10735	8892	346	10389	74	1760	6943	660	617	0	225	110	0	0
전라북도	군산시	나운3동	계	26264	12581	13683	340	12241	36	1979	8241	932	768	0	186	99	0	0
전라북도	군산시	소룡동	계	15063	6196	8867	312	5884	49	1024	3980	400	292	0	90	49	0	0
전라북도	군산시	미성동	계	11273	4475	6798	190	4285	39	658	3008	241	221	0	91	27	0	0
전라북도	익산시	관외사전투표		14011	14001	10	367	13634	26	2488	8660	963	1144	0	152	201	0	0
전라북도	익산시	거소우편투표		836	720	116	26	694	7	199	394	48	29	0	7	10	0	0
전라북도	익산시	함열읍	계	6398	3529	2869	224	3305	12	555	2201	235	170	0	46	86	0	0
전라북도	익산시	오산면	계	7042	3218	3824	151	3067	16	478	2019	185	303	0	39	27	0	0
전라북도	익산시	황등면	계	6959	3704	3255	299	3405	19	572	2273	246	203	0	55	37	0	0
전라북도	익산시	함라면	계	2086	1130	956	77	1053	8	199	650	85	74	0	17	20	0	0
전라북도	익산시	웅포면	계	1553	921	632	56	865	10	137	532	85	63	0	17	21	0	0
전라북도	익산시	성당면	계	1871	943	928	99	844	17	172	493	61	54	0	23	24	0	0
전라북도	익산시	용안면	계	2549	1547	1002	145	1402	20	300	808	94	125	0	21	34	0	0
전라북도	익산시	낭산면	계	2902	1751	1151	137	1614	21	300	912	188	129	0	47	17	0	0
전라북도	익산시	망성면	계	3006	1521	1485	117	1404	31	366	692	186	74	0	34	21	0	0
전라북도	익산시	여산면	계	3134	1829	1305	93	1736	35	362	935	194	94	0	38	78	0	0
전라북도	익산시	금마면	계	4250	2407	1843	171	2236	26	554	1254	208	117	0	59	18	0	0
전라북도	익산시	왕궁면	계	4458	2699	1759	155	2544	33	541	1615	173	120	0	48	14	0	0
전라북도	익산시	춘포면	계	4259	2433	1826	166	2267	21	332	1489	236	136	0	33	20	0	0
전라북도	익산시	삼기면	계	2493	1309	1184	90	1219	11	223	747	104	73	0	45	16	0	0
전라북도	익산시	용동면	계	1590	907	683	67	840	25	169	511	76	44	0	7	8	0	0
전라북도	익산시	중앙동	계	3744	1792	1952	91	1701	11	434	996	108	124	0	18	10	0	0
전라북도	익산시	평화동	계	4309	2111	2198	118	1993	14	358	1263	148	162	0	29	19	0	0
전라북도	익산시	인화동	계	6146	2960	3186	203	2757	17	538	1776	182	210	0	22	12	0	0
전라북도	익산시	동산동	계	18736	8322	10414	265	8057	27	1166	5112	560	1021	0	113	58	0	0
전라북도	익산시	마동	계	8921	4076	4845	204	3872	20	702	2481	241	347	0	50	31	0	0
전라북도	익산시	남중동	계	11292	5468	5824	256	5212	19	1140	3227	336	391	0	44	55	0	0
전라북도	익산시	모현동	계	26772	14114	12658	443	13671	45	2116	8713	942	1623	0	146	86	0	0
전라북도	익산시	송학동	계	6360	3352	3008	108	3244	16	511	2119	236	297	0	38	27	0	0
전라북도	익산시	신동	계	11978	5428	6550	268	5160	21	1024	3261	361	372	0	62	59	0	0
전라북도	익산시	영등1동	계	20115	9965	10150	240	9725	24	1591	5985	756	1198	0	90	81	0	0
전라북도	익산시	영등2동	계	10836	5608	5228	132	5476	10	689	3591	417	627	0	71	71	0	0
전라북도	익산시	어양동	계	16194	7223	8971	143	7080	16	1030	4560	524	811	0	79	60	0	0
전라북도	익산시	팔봉동	계	5314	2618	2696	178	2440	16	398	1518	191	245	0	51	21	0	0
전라북도	익산시	삼성동	계	24008	11799	12209	400	11399	42	1604	7159	897	1344	0	209	144	0	0
전라북도	정읍시	관외사전투표		6936	6935	1	197	6738	19	967	4663	645	255	0	74	115	0	0
전라북도	정읍시	거소우편투표		516	461	55	77	384	8	89	224	32	17	0	7	7	0	0
전라북도	정읍시	신태인읍	계	5419	3413	2006	350	3063	57	664	1756	364	146	0	44	32	0	0
전라북도	정읍시	북면	계	4018	2283	1735	208	2075	56	299	1365	202	77	0	44	32	0	0
전라북도	정읍시	입암면	계	2850	1724	1126	150	1574	31	205	1095	136	52	0	34	21	0	0
전라북도	정읍시	소성면	계	2078	1273	805	88	1185	29	142	791	151	38	0	21	13	0	0
전라북도	정읍시	고부면	계	2800	1794	1006	186	1608	52	235	896	248	110	0	47	20	0	0
전라북도	정읍시	영원면	계	1765	1305	460	148	1157	25	217	549	290	44	0	20	12	0	0
전라북도	정읍시	덕천면	계	1747	1203	544	123	1080	19	136	567	273	37	0	29	19	0	0
전라북도	정읍시	이평면	계	2180	1419	761	121	1298	22	171	767	238	41	0	47	12	0	0
전라북도	정읍시	정우면	계	2551	1526	1025	176	1350	35	209	858	134	63	0	30	21	0	0
전라북도	정읍시	태인면	계	3556	2235	1321	236	1999	46	295	1261	199	87	0	77	34	0	0
전라북도	정읍시	감곡면	계	2723	1671	1052	163	1508	37	345	860	158	66	0	29	13	0	0
전라북도	정읍시	옹동면	계	1656	1088	568	134	954	28	127	558	130	69	0	26	16	0	0
전라북도	정읍시	칠보면	계	2206	1501	705	145	1356	26	181	887	153	52	0	34	23	0	0
전라북도	정읍시	산내면	계	1217	820	397	114	706	17	114	455	70	27	0	7	16	0	0
전라북도	정읍시	산외면	계	2067	1358	709	121	1237	28	193	769	131	46	0	35	35	0	0
전라북도	정읍시	수성동	계	12968	7307	5661	413	6894	36	1009	4723	710	241	0	100	75	0	0
전라북도	정읍시	장명동	계	2745	1562	1183	138	1424	9	250	973	115	40	0	21	16	0	0
전라북도	정읍시	내장상동	계	14545	8656	5889	317	8339	51	1251	5686	844	286	0	118	103	0	0
전라북도	정읍시	시기동	계	3350	2094	1256	100	1994	21	363	1359	152	48	0	21	30	0	0
전라북도	정읍시	초산동	계	6001	3717	2284	194	3523	26	580	2385	346	91	0	42	53	0	0
전라북도	정읍시	연지동	계	4043	2383	1660	113	2270	29	396	1570	179	52	0	29	15	0	0
전라북도	정읍시	농소동	계	3691	2041	1650	158	1883	16	293	1287	195	55	0	20	17	0	0
전라북도	정읍시	상교동	계	3332	1964	1368	176	1788	35	276	1176	165	63	0	44	29	0	0
전라북도	남원시	관외사전투표		5325	5324	1	153	5171	19	672	3604	588	169	0	48	71	0	0
전라북도	남원시	거소우편투표		360	330	30	24	306	11	52	158	45	17	0	10	13	0	0
전라북도	남원시	운봉읍	계	3386	2056	1330	97	1959	69	250	1327	186	81	0	18	28	0	0
전라북도	남원시	주천면	계	2069	1526	543	111	1415	39	190	877	155	120	0	18	16	0	0
전라북도	남원시	수지면	계	1059	710	349	45	665	25	100	413	62	38	0	17	10	0	0
전라북도	남원시	송동면	계	1947	1328	619	98	1230	43	155	789	121	54	0	42	26	0	0
전라북도	남원시	주생면	계	1691	1134	557	66	1068	48	149	588	159	57	0	45	22	0	0
전라북도	남원시	금지면	계	2207	1596	611	109	1487	54	214	981	119	62	0	35	22	0	0
전라북도	남원시	대강면	계	1590	1038	552	75	963	45	126	548	125	46	0	41	32	0	0
전라북도	남원시	대산면	계	1478	1020	458	108	912	67	128	549	90	42	0	27	9	0	0
전라북도	남원시	사매면	계	1433	998	435	77	921	27	107	608	100	42	0	21	16	0	0
전라북도	남원시	덕과면	계	858	645	213	49	596	23	79	327	84	65	0	11	7	0	0
전라북도	남원시	보절면	계	1418	1016	402	104	912	30	117	530	121	60	0	34	20	0	0
전라북도	남원시	산동면	계	1609	1265	344	93	1172	27	115	839	101	50	0	26	14	0	0
전라북도	남원시	이백면	계	1973	1451	522	121	1330	71	170	823	155	76	0	22	13	0	0
전라북도	남원시	인월면	계	2362	1413	949	45	1368	19	238	925	113	45	0	13	15	0	0
전라북도	남원시	아영면	계	1745	1050	695	37	1013	22	116	704	85	58	0	13	15	0	0
전라북도	남원시	산내면	계	1776	1115	661	32	1083	19	171	602	113	59	0	22	97	0	0
전라북도	남원시	동충동	계	2888	1826	1062	64	1762	15	300	1155	179	60	0	22	31	0	0
전라북도	남원시	죽항동	계	3358	2014	1344	79	1935	15	341	1258	181	76	0	25	39	0	0
전라북도	남원시	노암동	계	3864	2440	1424	123	2317	38	340	1477	290	94	0	41	37	0	0
전라북도	남원시	금동	계	5061	3130	1931	121	3009	30	425	2023	338	108	0	32	53	0	0
전라북도	남원시	왕정동	계	3458	2319	1139	121	2198	21	360	1396	239	80	0	73	29	0	0
전라북도	남원시	향교동	계	6326	3715	2611	146	3569	43	548	2338	413	142	0	51	34	0	0
전라북도	남원시	도통동	계	11170	7043	4127	166	6877	40	813	4734	979	195	0	64	52	0	0
전라북도	김제시	관외사전투표		5635	5634	1	175	5459	23	912	3696	295	378	0	78	77	0	0
전라북도	김제시	거소우편투표		541	477	64	32	445	8	98	232	36	52	0	12	7	0	0
전라북도	김제시	만경읍	계	2726	1863	863	170	1693	32	314	1050	99	103	0	65	30	0	0
전라북도	김제시	죽산면	계	2562	1749	813	178	1571	19	231	1095	82	74	0	42	28	0	0
전라북도	김제시	백산면	계	2415	1667	748	135	1532	14	210	1020	81	129	0	62	16	0	0
전라북도	김제시	용지면	계	3717	2383	1334	155	2228	23	357	1415	136	190	0	80	27	0	0
전라북도	김제시	백구면	계	3787	2303	1484	205	2098	17	333	1308	129	144	0	151	16	0	0
전라북도	김제시	부량면	계	1324	912	412	67	845	22	162	525	43	51	0	31	11	0	0
전라북도	김제시	공덕면	계	2507	1733	774	166	1567	56	248	1021	90	78	0	46	28	0	0
전라북도	김제시	청하면	계	1802	1307	495	127	1180	18	173	753	61	117	0	39	19	0	0
전라북도	김제시	성덕면	계	1791	1136	655	92	1044	12	181	649	77	75	0	36	14	0	0
전라북도	김제시	진봉면	계	2681	1895	786	176	1719	28	287	1112	112	103	0	55	22	0	0
전라북도	김제시	금구면	계	4146	2642	1504	166	2476	30	425	1552	175	158	0	81	55	0	0
전라북도	김제시	봉남면	계	2328	1537	791	99	1438	14	225	915	77	112	0	58	37	0	0
전라북도	김제시	황산면	계	1807	1163	644	76	1087	22	173	668	72	84	0	48	20	0	0
전라북도	김제시	금산면	계	4403	2885	1518	242	2643	29	463	1620	205	186	0	80	60	0	0
전라북도	김제시	광활면	계	1338	975	363	84	891	23	134	570	60	53	0	39	12	0	0
전라북도	김제시	요촌동	계	8237	4800	3437	240	4560	27	878	3039	213	302	0	66	35	0	0
전라북도	김제시	신풍동	계	10340	6458	3882	298	6160	69	1195	3985	274	457	0	123	57	0	0
전라북도	김제시	검산동	계	7508	4697	2811	265	4432	56	736	2828	236	387	0	107	82	0	0
전라북도	김제시	교월동	계	5741	3278	2463	228	3050	19	529	1993	147	251	0	77	34	0	0
전라북도	완주군	관외사전투표		4355	4352	3	135	4217	16	736	2729	366	228	0	66	76	0	0
전라북도	완주군	거소우편투표		233	222	11	9	213	4	49	122	14	13	0	6	5	0	0
전라북도	완주군	삼례읍	계	11895	6654	5241	413	6241	107	1094	3987	522	329	0	100	102	0	0
전라북도	완주군	봉동읍	계	17920	10368	7552	430	9938	85	1604	5714	1454	709	0	239	133	0	0
전라북도	완주군	용진면	계	5798	3335	2463	182	3153	55	579	1905	283	196	0	83	52	0	0
전라북도	완주군	상관면	계	3725	2222	1503	99	2123	68	422	1287	153	125	0	29	39	0	0
전라북도	완주군	이서면	계	5548	3293	2255	143	3150	21	512	2006	280	224	0	55	52	0	0
전라북도	완주군	소양면	계	5251	3140	2111	244	2896	35	521	1861	214	161	0	59	45	0	0
전라북도	완주군	구이면	계	4606	3094	1512	181	2913	35	547	1686	240	290	0	53	62	0	0
전라북도	완주군	고산면	계	3867	2767	1100	180	2587	33	376	1712	205	150	0	51	60	0	0
전라북도	완주군	비봉면	계	1655	1183	472	80	1103	32	181	663	116	61	0	22	28	0	0
전라북도	완주군	운주면	계	1766	1208	558	60	1148	19	268	678	58	80	0	22	23	0	0
전라북도	완주군	화산면	계	2298	1647	651	128	1519	24	264	904	130	123	0	43	31	0	0
전라북도	완주군	동상면	계	872	599	273	33	566	6	110	366	41	23	0	11	9	0	0
전라북도	완주군	경천면	계	877	654	223	49	605	7	110	386	40	44	0	10	8	0	0
전라북도	진안군	관외사전투표		2711	2710	1	85	2625	8	424	1774	199	137	0	33	50	0	0
전라북도	진안군	거소우편투표		171	154	17	26	128	2	29	64	16	7	0	5	5	0	0
전라북도	진안군	진안읍	계	7858	5938	1920	351	5587	137	1205	3248	390	305	0	140	162	0	0
전라북도	진안군	용담면	계	683	549	134	77	472	18	94	271	37	34	0	8	10	0	0
전라북도	진안군	안천면	계	885	692	193	62	630	18	143	367	37	36	0	10	19	0	0
전라북도	진안군	동향면	계	1226	976	250	78	898	18	140	509	84	74	0	30	43	0	0
전라북도	진안군	상전면	계	687	527	160	47	480	19	107	259	29	37	0	9	20	0	0
전라북도	진안군	백운면	계	1605	1216	389	109	1107	49	204	599	109	73	0	34	39	0	0
전라북도	진안군	성수면	계	1474	1093	381	77	1016	50	163	568	89	88	0	31	27	0	0
전라북도	진안군	마령면	계	1628	1212	416	65	1147	40	230	653	81	69	0	38	36	0	0
전라북도	진안군	부귀면	계	2154	1614	540	134	1480	53	268	840	92	77	0	58	92	0	0
전라북도	진안군	정천면	계	868	701	167	47	654	15	142	365	36	51	0	19	26	0	0
전라북도	진안군	주천면	계	1339	1051	288	103	948	70	226	472	79	59	0	23	19	0	0
전라북도	무주군	관외사전투표		1852	1851	1	86	1765	5	290	1277	102	57	0	21	13	0	0
전라북도	무주군	거소우편투표		441	402	39	50	352	9	68	209	26	20	0	4	16	0	0
전라북도	무주군	무주읍	계	6881	5465	1416	392	5073	79	1036	3272	319	226	0	80	61	0	0
전라북도	무주군	무풍면	계	1939	1588	351	225	1363	48	369	689	92	51	0	70	44	0	0
전라북도	무주군	설천면	계	3430	2617	813	185	2432	51	537	1457	160	114	0	73	40	0	0
전라북도	무주군	적상면	계	2216	1782	434	173	1609	38	303	964	100	109	0	53	42	0	0
전라북도	무주군	안성면	계	3764	2904	860	246	2658	68	396	1632	253	199	0	58	52	0	0
전라북도	무주군	부남면	계	1263	1004	259	81	923	28	165	568	50	62	0	21	29	0	0
전라북도	장수군	관외사전투표		1734	1734	0	43	1691	3	253	1161	136	81	0	24	33	0	0
전라북도	장수군	거소우편투표		170	160	10	15	145	2	26	95	12	3	0	4	3	0	0
전라북도	장수군	장수읍	계	5484	4258	1226	280	3978	110	780	2458	287	169	0	84	90	0	0
전라북도	장수군	산서면	계	1971	1533	438	76	1457	55	176	927	118	98	0	41	42	0	0
전라북도	장수군	번암면	계	2089	1606	483	118	1488	44	206	881	159	120	0	44	34	0	0
전라북도	장수군	장계면	계	3557	2751	806	165	2586	82	514	1482	219	164	0	70	55	0	0
전라북도	장수군	천천면	계	1897	1478	419	127	1351	48	250	769	123	88	0	33	40	0	0
전라북도	장수군	계남면	계	1823	1411	412	91	1320	48	215	764	122	94	0	34	43	0	0
전라북도	장수군	계북면	계	1362	1073	289	62	1011	32	161	565	103	84	0	34	32	0	0
전라북도	임실군	관외사전투표		2593	2593	0	91	2502	9	530	1580	178	124	0	39	42	0	0
전라북도	임실군	거소우편투표		201	183	18	10	173	4	33	95	16	8	0	10	7	0	0
전라북도	임실군	임실읍	계	5232	3806	1426	257	3549	64	1117	1666	315	203	0	74	110	0	0
전라북도	임실군	청웅면	계	1246	931	315	88	843	34	168	414	82	48	0	58	39	0	0
전라북도	임실군	운암면	계	1385	925	460	67	858	18	222	421	72	70	0	23	32	0	0
전라북도	임실군	신평면	계	1339	955	384	93	862	32	241	397	82	62	0	21	27	0	0
전라북도	임실군	성수면	계	1458	1071	387	95	976	33	202	487	108	57	0	42	47	0	0
전라북도	임실군	오수면	계	3552	2647	905	270	2377	56	466	1462	168	97	0	55	73	0	0
전라북도	임실군	신덕면	계	1152	835	317	82	753	24	147	391	75	58	0	28	30	0	0
전라북도	임실군	삼계면	계	1365	1019	346	100	919	27	152	536	85	53	0	30	36	0	0
전라북도	임실군	관촌면	계	3026	2180	846	179	2001	58	572	1033	160	104	0	27	47	0	0
전라북도	임실군	강진면	계	1419	1042	377	103	939	45	240	442	65	52	0	56	39	0	0
전라북도	임실군	덕치면	계	1024	767	257	76	691	33	119	360	59	41	0	45	34	0	0
전라북도	임실군	지사면	계	1111	864	247	76	788	25	110	439	87	58	0	20	49	0	0
전라북도	순창군	관외사전투표		2493	2492	1	70	2422	11	243	1772	263	85	0	23	25	0	0
전라북도	순창군	거소우편투표		259	247	12	34	213	1	31	141	18	8	0	4	10	0	0
전라북도	순창군	순창읍	계	7112	5202	1910	278	4924	62	696	3236	550	208	0	104	68	0	0
전라북도	순창군	인계면	계	1365	1054	311	71	983	19	114	639	91	45	0	55	20	0	0
전라북도	순창군	동계면	계	1838	1379	459	126	1253	31	124	837	129	41	0	33	58	0	0
전라북도	순창군	적성면	계	1141	873	268	79	794	19	100	497	69	79	0	21	9	0	0
전라북도	순창군	유등면	계	1042	795	247	49	746	25	78	453	76	45	0	50	19	0	0
전라북도	순창군	풍산면	계	1518	1100	418	57	1043	44	119	617	151	62	0	27	23	0	0
전라북도	순창군	금과면	계	1479	1079	400	82	997	32	106	627	119	46	0	30	37	0	0
전라북도	순창군	팔덕면	계	1337	1018	319	70	948	30	117	601	108	42	0	20	30	0	0
전라북도	순창군	복흥면	계	1918	1442	476	97	1345	51	159	848	173	72	0	28	14	0	0
전라북도	순창군	쌍치면	계	1826	1377	449	121	1256	22	176	756	191	50	0	39	22	0	0
전라북도	순창군	구림면	계	2169	1655	514	167	1488	44	178	894	194	102	0	30	46	0	0
전라북도	고창군	관외사전투표		4104	4100	4	123	3977	7	437	2894	397	157	0	36	49	0	0
전라북도	고창군	거소우편투표		328	309	19	27	282	5	43	176	40	8	0	5	5	0	0
전라북도	고창군	고창읍	계	14882	10563	4319	865	9698	90	1099	6783	1136	379	0	88	123	0	0
전라북도	고창군	고수면	계	2087	1515	572	154	1361	18	141	948	111	103	0	20	20	0	0
전라북도	고창군	아산면	계	2567	1845	722	275	1570	15	186	947	276	94	0	30	22	0	0
전라북도	고창군	무장면	계	2714	1959	755	273	1686	29	208	1030	200	109	0	88	22	0	0
전라북도	고창군	공음면	계	2385	1877	508	205	1672	33	139	1029	209	197	0	41	24	0	0
전라북도	고창군	상하면	계	2304	1665	639	230	1435	23	130	961	180	87	0	38	16	0	0
전라북도	고창군	해리면	계	2707	1923	784	215	1708	51	200	1092	135	150	0	54	26	0	0
전라북도	고창군	성송면	계	1731	1270	461	119	1151	36	128	743	94	113	0	23	14	0	0
전라북도	고창군	대산면	계	3412	2432	980	203	2229	74	185	1567	168	172	0	34	29	0	0
전라북도	고창군	심원면	계	2403	1680	723	141	1539	16	168	1011	123	181	0	24	16	0	0
전라북도	고창군	흥덕면	계	2986	2200	786	164	2036	29	215	1302	239	177	0	43	31	0	0
전라북도	고창군	성내면	계	1900	1410	490	113	1297	21	172	780	207	79	0	23	15	0	0
전라북도	고창군	신림면	계	2032	1465	567	227	1238	17	119	815	148	79	0	28	32	0	0
전라북도	고창군	부안면	계	2646	1874	772	184	1690	24	180	1134	175	128	0	27	22	0	0
전라북도	부안군	관외사전투표		4285	4281	4	192	4089	14	633	2876	264	181	0	51	70	0	0
전라북도	부안군	거소우편투표		303	273	30	29	244	1	71	133	17	12	0	3	7	0	0
전라북도	부안군	부안읍	계	14900	9820	5080	582	9238	76	1698	6152	619	410	0	148	135	0	0
전라북도	부안군	주산면	계	1969	1256	713	130	1126	31	178	715	80	67	0	24	31	0	0
전라북도	부안군	동진면	계	2932	1913	1019	166	1747	32	266	1151	122	104	0	43	29	0	0
전라북도	부안군	행안면	계	2010	1407	603	135	1272	21	264	823	83	50	0	15	16	0	0
전라북도	부안군	계화면	계	3606	2479	1127	235	2244	60	340	1499	161	102	0	60	22	0	0
전라북도	부안군	보안면	계	2413	1631	782	152	1479	34	296	823	132	138	0	33	23	0	0
전라북도	부안군	변산면	계	4017	2598	1419	207	2391	25	473	1551	132	100	0	54	56	0	0
전라북도	부안군	진서면	계	2158	1447	711	87	1360	37	250	847	89	86	0	24	27	0	0
전라북도	부안군	백산면	계	2639	1743	896	143	1600	31	297	989	117	108	0	34	24	0	0
전라북도	부안군	상서면	계	2043	1357	686	99	1258	36	198	770	112	79	0	34	29	0	0
전라북도	부안군	하서면	계	2688	1781	907	186	1595	27	229	1033	121	130	0	31	24	0	0
전라북도	부안군	줄포면	계	2615	1729	886	153	1576	32	280	1005	102	106	0	29	22	0	0
전라북도	부안군	위도면	계	1021	704	317	142	562	20	91	346	40	40	0	10	15	0	0
전라남도	목포시	관외사전투표		12773	12766	7	404	12362	0	1312	8253	1044	1254	0	338	161	0	0
전라남도	목포시	거소우편투표		915	862	53	40	822	0	168	525	52	51	0	15	11	0	0
전라남도	목포시	용당1동	계	10337	5256	5081	249	5007	0	578	3422	419	385	0	146	57	0	0
전라남도	목포시	용당2동	계	5295	2633	2662	138	2495	0	248	1713	215	221	0	69	29	0	0
전라남도	목포시	연동	계	4957	2559	2398	193	2366	0	228	1648	171	201	0	75	43	0	0
전라남도	목포시	산정동	계	6314	3542	2772	137	3405	0	341	2303	304	310	0	110	37	0	0
전라남도	목포시	연산동	계	3874	2182	1692	49	2133	0	206	1454	196	210	0	55	12	0	0
전라남도	목포시	원산동	계	11285	5902	5383	173	5729	0	432	3834	524	750	0	146	43	0	0
전라남도	목포시	대성동	계	2626	1294	1332	58	1236	0	116	872	101	80	0	52	15	0	0
전라남도	목포시	목원동	계	8292	4430	3862	228	4202	0	516	2775	352	314	0	184	61	0	0
전라남도	목포시	동명동	계	5733	3104	2629	170	2934	0	287	1953	225	280	0	149	40	0	0
전라남도	목포시	삼학동	계	5207	2860	2347	139	2721	0	211	1923	197	297	0	70	23	0	0
전라남도	목포시	만호동	계	3309	1622	1687	97	1525	0	146	1043	108	142	0	65	21	0	0
전라남도	목포시	유달동	계	5312	2700	2612	249	2451	0	294	1584	174	185	0	166	48	0	0
전라남도	목포시	죽교동	계	3454	1702	1752	90	1612	0	173	1101	134	132	0	53	19	0	0
전라남도	목포시	북항동	계	7240	3815	3425	146	3669	0	328	2475	346	374	0	113	33	0	0
전라남도	목포시	용해동	계	11449	5884	5565	195	5689	0	509	3675	529	778	0	147	51	0	0
전라남도	목포시	이로동	계	7976	4419	3557	146	4273	0	381	2822	477	457	0	100	36	0	0
전라남도	목포시	상동	계	13351	7040	6311	278	6762	0	648	4508	593	722	0	235	56	0	0
전라남도	목포시	하당동	계	9157	4062	5095	113	3949	0	350	2542	415	504	0	105	33	0	0
전라남도	목포시	신흥동	계	12670	6899	5771	150	6749	0	575	4424	572	960	0	163	55	0	0
전라남도	목포시	삼향동	계	4176	2080	2096	97	1983	0	169	1284	214	203	0	86	27	0	0
전라남도	목포시	옥암동	계	7823	4222	3601	109	4113	0	353	2750	394	440	0	143	33	0	0
전라남도	목포시	부흥동	계	8832	4282	4550	103	4179	0	347	2700	364	615	0	122	31	0	0
전라남도	목포시	부주동	계	13213	7033	6180	126	6907	0	626	4331	684	980	0	230	56	0	0
전라남도	여수시	관외사전투표		15462	15455	7	302	15153	0	1470	10864	1919	516	0	238	146	0	0
전라남도	여수시	거소우편투표		882	825	57	84	741	0	113	501	69	23	0	16	19	0	0
전라남도	여수시	돌산읍	계	11574	6614	4960	340	6274	0	652	4420	546	379	0	208	69	0	0
전라남도	여수시	소라면	계	11765	6045	5720	211	5834	0	558	3908	924	272	0	111	61	0	0
전라남도	여수시	율촌면	계	6035	3373	2662	189	3184	0	376	2330	300	99	0	55	24	0	0
전라남도	여수시	화양면	계	6006	3393	2613	189	3204	0	329	2075	449	246	0	67	38	0	0
전라남도	여수시	남면	계	2763	1771	992	69	1702	0	187	1123	123	172	0	76	21	0	0
전라남도	여수시	화정면	계	2075	1360	715	65	1295	0	104	942	113	75	0	41	20	0	0
전라남도	여수시	삼산면	계	1992	1122	870	55	1067	0	111	777	63	62	0	40	14	0	0
전라남도	여수시	동문동	계	4417	2253	2164	60	2193	0	280	1572	193	83	0	46	19	0	0
전라남도	여수시	한려동	계	3120	1591	1529	45	1546	0	197	1137	125	42	0	35	10	0	0
전라남도	여수시	중앙동	계	4751	2673	2078	78	2595	0	334	1898	222	86	0	36	19	0	0
전라남도	여수시	충무동	계	4195	2120	2075	79	2041	0	213	1496	190	58	0	71	13	0	0
전라남도	여수시	광림동	계	6321	3374	2947	120	3254	0	355	2331	325	117	0	100	26	0	0
전라남도	여수시	서강동	계	3798	2073	1725	72	2001	0	221	1492	172	53	0	39	24	0	0
전라남도	여수시	대교동	계	5968	2910	3058	96	2814	0	291	2136	219	103	0	46	19	0	0
전라남도	여수시	국동	계	9815	4786	5029	131	4655	0	399	3571	458	144	0	53	30	0	0
전라남도	여수시	월호동	계	6193	3518	2675	85	3433	0	341	2586	321	114	0	53	18	0	0
전라남도	여수시	여서동	계	16609	9468	7141	194	9274	0	772	7038	1022	267	0	122	53	0	0
전라남도	여수시	문수동	계	16742	9146	7596	191	8955	0	793	6679	991	316	0	137	39	0	0
전라남도	여수시	미평동	계	10078	5545	4533	161	5384	0	491	3938	662	139	0	103	51	0	0
전라남도	여수시	둔덕동	계	7990	4583	3407	73	4510	0	420	3236	624	146	0	66	18	0	0
전라남도	여수시	만덕동	계	6530	3770	2760	126	3644	0	345	2705	383	134	0	61	16	0	0
전라남도	여수시	쌍봉동	계	25461	14309	11152	322	13987	0	1395	9487	2288	521	0	189	107	0	0
전라남도	여수시	시전동	계	16591	9309	7282	260	9049	0	793	6415	1335	300	0	138	68	0	0
전라남도	여수시	여천동	계	16623	8372	8251	216	8156	0	768	5667	1229	278	0	157	57	0	0
전라남도	여수시	주삼동	계	5428	3332	2096	77	3255	0	268	2311	503	100	0	51	22	0	0
전라남도	여수시	삼일동	계	2431	1494	937	91	1403	0	125	892	264	55	0	34	33	0	0
전라남도	여수시	묘도동	계	1020	785	235	60	725	0	43	415	179	34	0	24	30	0	0
전라남도	순천시	관외사전투표		14665	14659	6	315	14344	0	1541	9996	1876	457	0	221	253	0	0
전라남도	순천시	거소우편투표		691	605	86	51	554	0	102	355	50	22	0	12	13	0	0
전라남도	순천시	승주읍	계	2636	1918	718	281	1637	0	145	998	170	75	0	59	190	0	0
전라남도	순천시	주암면	계	3170	2202	968	215	1987	0	210	1057	424	113	0	148	35	0	0
전라남도	순천시	송광면	계	1500	923	577	58	865	0	99	571	95	49	0	39	12	0	0
전라남도	순천시	외서면	계	884	579	305	65	514	0	44	360	56	24	0	16	14	0	0
전라남도	순천시	낙안면	계	3105	1955	1150	187	1768	0	139	1286	172	78	0	56	37	0	0
전라남도	순천시	별량면	계	5240	3182	2058	262	2920	0	294	2012	325	160	0	91	38	0	0
전라남도	순천시	상사면	계	2413	1470	943	128	1342	0	140	947	120	69	0	37	29	0	0
전라남도	순천시	해룡면	계	23172	12214	10958	367	11847	0	835	8288	1967	433	0	173	151	0	0
전라남도	순천시	서면	계	9625	5344	4281	269	5075	0	403	3659	717	166	0	81	49	0	0
전라남도	순천시	황전면	계	3019	2049	970	214	1835	0	185	1042	429	94	0	53	32	0	0
전라남도	순천시	월등면	계	1675	1159	516	103	1056	0	113	678	172	55	0	21	17	0	0
전라남도	순천시	향동	계	3938	2181	1757	88	2093	0	241	1453	255	75	0	43	26	0	0
전라남도	순천시	매곡동	계	5312	2853	2459	105	2748	0	332	1948	285	81	0	52	50	0	0
전라남도	순천시	삼산동	계	17063	10006	7057	244	9762	0	934	6981	1310	298	0	113	126	0	0
전라남도	순천시	조곡동	계	5813	3066	2747	68	2998	0	290	2151	403	87	0	39	28	0	0
전라남도	순천시	덕연동	계	34478	18478	16000	270	18208	0	1572	13146	2613	509	0	179	189	0	0
전라남도	순천시	풍덕동	계	7377	4118	3259	132	3986	0	385	2912	447	117	0	83	42	0	0
전라남도	순천시	남제동	계	8712	4618	4094	212	4406	0	422	3228	474	128	0	94	60	0	0
전라남도	순천시	저전동	계	2809	1618	1191	53	1565	0	165	1123	187	49	0	23	18	0	0
전라남도	순천시	장천동	계	2724	1312	1412	57	1255	0	197	860	130	31	0	20	17	0	0
전라남도	순천시	중앙동	계	3397	1690	1707	75	1615	0	194	1149	186	46	0	20	20	0	0
전라남도	순천시	도사동	계	7258	4066	3192	190	3876	0	421	2732	419	126	0	122	56	0	0
전라남도	순천시	왕조1동	계	29230	15143	14087	326	14817	0	1384	10351	2253	477	0	165	187	0	0
전라남도	순천시	왕조2동	계	14983	8886	6097	134	8752	0	692	6141	1472	261	0	95	91	0	0
전라남도	나주시	관외사전투표		6256	6255	1	165	6090	0	565	4210	977	159	0	98	81	0	0
전라남도	나주시	거소우편투표		681	633	48	124	509	0	96	271	85	25	0	11	21	0	0
전라남도	나주시	남평읍	계	6508	3980	2528	248	3732	0	251	2834	319	114	0	79	135	0	0
전라남도	나주시	세지면	계	2660	1750	910	183	1567	0	144	959	264	65	0	78	57	0	0
전라남도	나주시	왕곡면	계	2933	1916	1017	136	1780	0	197	1091	314	88	0	58	32	0	0
전라남도	나주시	반남면	계	1500	1077	423	123	954	0	76	638	139	46	0	25	30	0	0
전라남도	나주시	공산면	계	2295	1691	604	129	1562	0	124	889	316	111	0	63	59	0	0
전라남도	나주시	동강면	계	2610	1918	692	162	1756	0	116	1009	423	93	0	66	49	0	0
전라남도	나주시	다시면	계	3623	2568	1055	188	2380	0	239	1568	291	82	0	81	119	0	0
전라남도	나주시	문평면	계	1960	1369	591	107	1262	0	137	799	168	49	0	39	70	0	0
전라남도	나주시	노안면	계	4685	2953	1732	191	2762	0	230	1942	339	76	0	79	96	0	0
전라남도	나주시	금천면	계	4351	2738	1613	179	2559	0	191	1764	299	90	0	143	72	0	0
전라남도	나주시	산포면	계	3497	2329	1168	154	2175	0	148	1500	268	156	0	65	38	0	0
전라남도	나주시	다도면	계	1725	1143	582	113	1030	0	81	646	120	67	0	40	76	0	0
전라남도	나주시	봉황면	계	4188	2778	1410	263	2515	0	197	1486	445	156	0	117	114	0	0
전라남도	나주시	송월동	계	4865	2952	1913	133	2819	0	252	1907	491	61	0	60	48	0	0
전라남도	나주시	영강동	계	2786	1681	1105	91	1590	0	168	1037	269	56	0	37	23	0	0
전라남도	나주시	금남동	계	4978	3035	1943	125	2910	0	341	1891	478	73	0	68	59	0	0
전라남도	나주시	성북동	계	6979	4476	2503	184	4292	0	491	2814	769	110	0	57	51	0	0
전라남도	나주시	영산동	계	3295	1968	1327	165	1803	0	216	1133	268	84	0	60	42	0	0
전라남도	나주시	이창동	계	3270	2065	1205	143	1922	0	233	1223	284	69	0	75	38	0	0
전라남도	나주시	빛가람동	계	477	224	253	4	220	0	29	150	33	7	0	1	0	0	0
전라남도	광양시	관외사전투표		7462	7457	5	185	7272	0	952	4819	1076	219	0	116	90	0	0
전라남도	광양시	거소우편투표		296	283	13	11	272	0	58	146	43	7	0	9	9	0	0
전라남도	광양시	광양읍	계	35133	21063	14070	789	20274	0	1968	13340	3542	561	0	519	344	0	0
전라남도	광양시	봉강면	계	1728	1164	564	82	1082	0	95	660	165	34	0	81	47	0	0
전라남도	광양시	옥룡면	계	2556	1767	789	203	1564	0	185	1027	169	54	0	54	75	0	0
전라남도	광양시	옥곡면	계	2860	2114	746	143	1971	0	189	1322	223	94	0	98	45	0	0
전라남도	광양시	진상면	계	2749	1908	841	147	1761	0	85	1298	198	67	0	81	32	0	0
전라남도	광양시	진월면	계	2911	2055	856	178	1877	0	208	1078	284	181	0	84	42	0	0
전라남도	광양시	다압면	계	1592	1189	403	69	1120	0	149	717	126	64	0	39	25	0	0
전라남도	광양시	골약동	계	2054	1409	645	112	1297	0	150	792	185	63	0	64	43	0	0
전라남도	광양시	중마동	계	34515	19402	15113	537	18865	0	2717	11543	3582	506	0	299	218	0	0
전라남도	광양시	광영동	계	9764	5537	4227	200	5337	0	824	3451	760	148	0	108	46	0	0
전라남도	광양시	태인동	계	1899	1279	620	78	1201	0	119	851	138	59	0	24	10	0	0
전라남도	광양시	금호동	계	10244	6768	3476	137	6631	0	1908	3798	646	168	0	57	54	0	0
전라남도	담양군	관외사전투표		3333	3330	3	76	3254	0	450	2297	301	108	0	56	42	0	0
전라남도	담양군	거소우편투표		117	101	16	7	94	0	16	61	6	5	0	3	3	0	0
전라남도	담양군	담양읍	계	10664	7682	2982	414	7268	0	1074	4861	700	234	0	274	125	0	0
전라남도	담양군	봉산면	계	2481	1600	881	65	1535	0	154	1055	131	69	0	92	34	0	0
전라남도	담양군	고서면	계	2894	1943	951	93	1850	0	177	1217	219	111	0	98	28	0	0
전라남도	담양군	남면	계	1132	796	336	39	757	0	95	474	83	52	0	38	15	0	0
전라남도	담양군	창평면	계	3305	2145	1160	112	2033	0	224	1340	262	81	0	92	34	0	0
전라남도	담양군	대덕면	계	1575	1024	551	40	984	0	102	618	162	51	0	39	12	0	0
전라남도	담양군	무정면	계	2276	1537	739	85	1452	0	205	988	123	51	0	59	26	0	0
전라남도	담양군	금성면	계	2312	1622	690	119	1503	0	185	969	103	138	0	73	35	0	0
전라남도	담양군	용면	계	1616	1213	403	62	1151	0	153	775	104	49	0	48	22	0	0
전라남도	담양군	월산면	계	2245	1527	718	74	1453	0	161	943	143	87	0	87	32	0	0
전라남도	담양군	수북면	계	3516	2331	1185	102	2229	0	209	1516	222	99	0	140	43	0	0
전라남도	담양군	대전면	계	3580	2235	1345	165	2070	0	178	1454	217	68	0	126	27	0	0
전라남도	장성군	관외사전투표		3463	3461	2	109	3352	0	473	2336	306	130	0	65	42	0	0
전라남도	장성군	거소우편투표		171	151	20	11	140	0	19	91	13	7	0	5	5	0	0
전라남도	장성군	장성읍	계	10281	7132	3149	430	6702	0	913	4420	665	373	0	215	116	0	0
전라남도	장성군	진원면	계	2641	1852	789	81	1771	0	172	1168	187	140	0	56	48	0	0
전라남도	장성군	남면	계	2956	1948	1008	115	1833	0	166	1207	198	156	0	61	45	0	0
전라남도	장성군	동화면	계	1667	1193	474	81	1112	0	147	687	108	97	0	53	20	0	0
전라남도	장성군	삼서면	계	2726	1910	816	126	1784	0	180	1144	210	151	0	70	29	0	0
전라남도	장성군	삼계면	계	4659	3036	1623	170	2866	0	642	1718	223	160	0	73	50	0	0
전라남도	장성군	황룡면	계	3403	2389	1014	154	2235	0	295	1423	254	149	0	71	43	0	0
전라남도	장성군	서삼면	계	1300	940	360	59	881	0	122	577	87	41	0	36	18	0	0
전라남도	장성군	북일면	계	1269	947	322	61	886	0	99	597	70	64	0	32	24	0	0
전라남도	장성군	북이면	계	2580	1895	685	173	1722	0	177	1194	148	119	0	57	27	0	0
전라남도	장성군	북하면	계	2050	1447	603	89	1358	0	176	873	133	90	0	60	26	0	0
전라남도	곡성군	관외사전투표		2454	2453	1	70	2383	0	230	1648	344	90	0	42	29	0	0
전라남도	곡성군	거소우편투표		111	101	10	8	93	0	15	58	12	3	0	4	1	0	0
전라남도	곡성군	곡성읍	계	6358	4877	1481	316	4561	0	638	2646	813	224	0	145	95	0	0
전라남도	곡성군	오곡면	계	1723	1337	386	106	1231	0	172	747	165	71	0	52	24	0	0
전라남도	곡성군	삼기면	계	1506	1150	356	82	1068	0	128	613	143	101	0	67	16	0	0
전라남도	곡성군	석곡면	계	2147	1654	493	168	1486	0	145	949	213	98	0	58	23	0	0
전라남도	곡성군	목사동면	계	1264	927	337	81	846	0	97	550	92	60	0	32	15	0	0
전라남도	곡성군	죽곡면	계	1636	1243	393	99	1144	0	122	729	142	72	0	50	29	0	0
전라남도	곡성군	고달면	계	1079	818	261	40	778	0	60	525	103	37	0	36	17	0	0
전라남도	곡성군	옥과면	계	3585	2325	1260	149	2176	0	191	1422	332	93	0	106	32	0	0
전라남도	곡성군	입면	계	2162	1676	486	143	1533	0	125	806	306	170	0	97	29	0	0
전라남도	곡성군	겸면	계	1552	1185	367	113	1072	0	104	587	194	83	0	69	35	0	0
전라남도	곡성군	오산면	계	1295	876	419	60	816	0	81	497	110	62	0	45	21	0	0
전라남도	구례군	관외사전투표		2439	2438	1	70	2368	0	282	1622	280	77	0	53	54	0	0
전라남도	구례군	거소우편투표		142	135	7	39	96	0	17	48	6	12	0	8	5	0	0
전라남도	구례군	구례읍	계	8254	6519	1735	392	6127	0	955	3944	627	249	0	196	156	0	0
전라남도	구례군	문척면	계	997	793	204	61	732	0	85	470	68	41	0	35	33	0	0
전라남도	구례군	간전면	계	1271	1028	243	73	955	0	138	581	111	56	0	33	36	0	0
전라남도	구례군	토지면	계	2111	1694	417	153	1541	0	219	918	183	100	0	75	46	0	0
전라남도	구례군	마산면	계	2243	1732	511	130	1602	0	239	902	193	92	0	92	84	0	0
전라남도	구례군	광의면	계	2054	1630	424	142	1488	0	179	869	160	83	0	149	48	0	0
전라남도	구례군	용방면	계	1270	1035	235	83	952	0	135	537	110	55	0	77	38	0	0
전라남도	구례군	산동면	계	2582	2036	546	153	1883	0	235	1201	175	115	0	100	57	0	0
전라남도	고흥군	관외사전투표		4121	4121	0	130	3991	0	319	2896	520	122	0	72	62	0	0
전라남도	고흥군	거소우편투표		696	638	58	43	595	0	72	421	53	23	0	15	11	0	0
전라남도	고흥군	고흥읍	계	8908	6415	2493	369	6046	0	650	3943	921	241	0	218	73	0	0
전라남도	고흥군	도양읍	계	9034	6470	2564	442	6028	0	712	4266	545	178	0	188	139	0	0
전라남도	고흥군	풍양면	계	3154	2535	619	207	2328	0	179	1615	263	143	0	91	37	0	0
전라남도	고흥군	도덕면	계	2797	2207	590	334	1873	0	132	1229	201	192	0	63	56	0	0
전라남도	고흥군	금산면	계	4152	3174	978	401	2773	0	290	2008	188	167	0	79	41	0	0
전라남도	고흥군	도화면	계	3749	2804	945	220	2584	0	263	1663	387	89	0	136	46	0	0
전라남도	고흥군	포두면	계	4721	3516	1205	370	3146	0	256	1946	456	240	0	174	74	0	0
전라남도	고흥군	봉래면	계	1791	1289	502	91	1198	0	186	733	112	55	0	80	32	0	0
전라남도	고흥군	동일면	계	1351	1021	330	80	941	0	87	648	82	54	0	53	17	0	0
전라남도	고흥군	점암면	계	2596	1973	623	213	1760	0	169	1128	194	77	0	143	49	0	0
전라남도	고흥군	영남면	계	1264	971	293	93	878	0	72	579	88	38	0	68	33	0	0
전라남도	고흥군	과역면	계	3133	2368	765	211	2157	0	229	1581	177	53	0	85	32	0	0
전라남도	고흥군	남양면	계	2209	1645	564	177	1468	0	133	907	164	128	0	96	40	0	0
전라남도	고흥군	동강면	계	2961	2172	789	248	1924	0	175	1256	240	83	0	106	64	0	0
전라남도	고흥군	대서면	계	2219	1698	521	266	1432	0	133	843	192	70	0	157	37	0	0
전라남도	고흥군	두원면	계	2947	2210	737	280	1930	0	210	1257	240	97	0	92	34	0	0
전라남도	보성군	관외사전투표		3207	3207	0	89	3118	0	264	2309	314	96	0	57	78	0	0
전라남도	보성군	거소우편투표		148	136	12	6	130	0	24	84	12	3	0	3	4	0	0
전라남도	보성군	보성읍	계	7087	5250	1837	224	5026	0	634	3343	575	202	0	130	142	0	0
전라남도	보성군	벌교읍	계	11445	7717	3728	470	7247	0	798	4801	486	484	0	243	435	0	0
전라남도	보성군	노동면	계	963	733	230	51	682	0	77	335	126	60	0	44	40	0	0
전라남도	보성군	미력면	계	1276	990	286	80	910	0	101	586	113	44	0	41	25	0	0
전라남도	보성군	겸백면	계	1148	903	245	100	803	0	78	467	90	71	0	64	33	0	0
전라남도	보성군	율어면	계	1161	880	281	94	786	0	68	470	86	77	0	55	30	0	0
전라남도	보성군	복내면	계	1502	1174	328	135	1039	0	94	613	110	118	0	68	36	0	0
전라남도	보성군	문덕면	계	784	624	160	56	568	0	70	336	60	53	0	25	24	0	0
전라남도	보성군	조성면	계	3521	2645	876	253	2392	0	276	1475	231	151	0	93	166	0	0
전라남도	보성군	득량면	계	3827	2778	1049	273	2505	0	263	1652	322	119	0	95	54	0	0
전라남도	보성군	회천면	계	2772	2031	741	115	1916	0	201	1175	223	117	0	69	131	0	0
전라남도	보성군	웅치면	계	1022	820	202	65	755	0	78	449	105	62	0	38	23	0	0
전라남도	화순군	관외사전투표		4123	4120	3	114	4006	0	383	2798	532	151	0	93	49	0	0
전라남도	화순군	거소우편투표		194	171	23	21	150	0	22	95	14	9	0	5	5	0	0
전라남도	화순군	화순읍	계	29137	19773	9364	716	19057	0	1669	12751	3151	734	0	514	238	0	0
전라남도	화순군	한천면	계	1251	894	357	59	835	0	84	513	93	58	0	63	24	0	0
전라남도	화순군	춘양면	계	1759	1211	548	83	1128	0	103	673	154	71	0	105	22	0	0
전라남도	화순군	청풍면	계	1009	746	263	61	685	0	60	379	104	66	0	50	26	0	0
전라남도	화순군	이양면	계	1705	1209	496	113	1096	0	70	706	132	78	0	75	35	0	0
전라남도	화순군	능주면	계	2934	2063	871	129	1934	0	196	1264	261	98	0	75	40	0	0
전라남도	화순군	도곡면	계	2545	1795	750	101	1694	0	145	1107	200	143	0	58	41	0	0
전라남도	화순군	도암면	계	1336	969	367	103	866	0	85	497	90	139	0	35	20	0	0
전라남도	화순군	이서면	계	825	616	209	70	546	0	42	322	84	58	0	20	20	0	0
전라남도	화순군	북면	계	1540	1095	445	88	1007	0	61	658	129	72	0	59	28	0	0
전라남도	화순군	동복면	계	1541	1079	462	90	989	0	102	579	120	82	0	69	37	0	0
전라남도	화순군	남면	계	2083	1458	625	127	1331	0	124	752	196	110	0	84	65	0	0
전라남도	화순군	동면	계	2955	1982	973	176	1806	0	161	1096	322	97	0	90	40	0	0
전라남도	장흥군	관외사전투표		3539	3535	4	112	3423	0	308	2379	499	118	0	72	47	0	0
전라남도	장흥군	거소우편투표		269	251	18	12	239	0	33	158	27	7	0	9	5	0	0
전라남도	장흥군	장흥읍	계	10969	8024	2945	390	7634	0	866	4818	1169	348	0	292	141	0	0
전라남도	장흥군	관산읍	계	4780	3588	1192	337	3251	0	269	1923	603	174	0	215	67	0	0
전라남도	장흥군	대덕읍	계	3269	2555	714	231	2324	0	314	1467	258	130	0	97	58	0	0
전라남도	장흥군	용산면	계	2091	1620	471	135	1485	0	126	754	319	118	0	104	64	0	0
전라남도	장흥군	안양면	계	2532	1940	592	137	1803	0	164	1097	257	135	0	103	47	0	0
전라남도	장흥군	장동면	계	1122	851	271	47	804	0	89	456	123	65	0	53	18	0	0
전라남도	장흥군	장평면	계	2058	1517	541	76	1441	0	123	724	329	125	0	103	37	0	0
전라남도	장흥군	유치면	계	979	701	278	46	655	0	89	381	89	50	0	33	13	0	0
전라남도	장흥군	부산면	계	1305	942	363	63	879	0	57	497	163	66	0	59	37	0	0
전라남도	장흥군	회진면	계	2580	2037	543	199	1838	0	169	1094	315	106	0	102	52	0	0
전라남도	강진군	관외사전투표		3063	3062	1	61	3001	0	302	2139	382	84	0	47	47	0	0
전라남도	강진군	거소우편투표		120	114	6	13	101	0	12	66	9	2	0	7	5	0	0
전라남도	강진군	강진읍	계	11011	7393	3618	290	7103	0	932	4623	973	248	0	151	176	0	0
전라남도	강진군	군동면	계	3390	2363	1027	149	2214	0	314	1436	230	120	0	52	62	0	0
전라남도	강진군	칠량면	계	2246	1611	635	153	1458	0	176	900	155	111	0	49	67	0	0
전라남도	강진군	대구면	계	1140	815	325	36	779	0	81	526	66	42	0	28	36	0	0
전라남도	강진군	마량면	계	1708	1175	533	63	1112	0	106	776	92	65	0	37	36	0	0
전라남도	강진군	도암면	계	2451	1778	673	135	1643	0	194	972	246	120	0	56	55	0	0
전라남도	강진군	신전면	계	1716	1298	418	103	1195	0	119	802	162	45	0	37	30	0	0
전라남도	강진군	성전면	계	2623	1935	688	117	1818	0	192	1212	246	62	0	43	63	0	0
전라남도	강진군	작천면	계	1831	1310	521	98	1212	0	132	838	129	50	0	36	27	0	0
전라남도	강진군	병영면	계	1668	1213	455	96	1117	0	128	749	91	42	0	77	30	0	0
전라남도	강진군	옴천면	계	646	495	151	35	460	0	41	317	37	22	0	33	10	0	0
전라남도	완도군	관외사전투표		3029	3028	1	100	2928	0	237	2270	248	96	0	46	31	0	0
전라남도	완도군	거소우편투표		1175	1093	82	69	1024	0	74	882	30	14	0	11	13	0	0
전라남도	완도군	완도읍	계	14184	9995	4189	483	9512	0	1038	6813	876	410	0	260	115	0	0
전라남도	완도군	금일읍	계	2979	2276	703	216	2060	0	237	1422	150	164	0	40	47	0	0
전라남도	완도군	노화읍	계	4390	3288	1102	329	2959	0	186	2120	254	226	0	100	73	0	0
전라남도	완도군	군외면	계	2763	2010	753	161	1849	0	254	1264	147	72	0	87	25	0	0
전라남도	완도군	신지면	계	3022	2218	804	142	2076	0	155	1558	132	98	0	49	84	0	0
전라남도	완도군	고금면	계	3661	2717	944	180	2537	0	216	1869	228	116	0	76	32	0	0
전라남도	완도군	약산면	계	2068	1659	409	204	1455	0	151	1023	121	92	0	40	28	0	0
전라남도	완도군	청산면	계	2086	1502	584	89	1413	0	153	973	97	104	0	55	31	0	0
전라남도	완도군	소안면	계	2130	1641	489	157	1484	0	107	1037	115	162	0	45	18	0	0
전라남도	완도군	금당면	계	888	705	183	78	627	0	61	407	58	60	0	26	15	0	0
전라남도	완도군	보길면	계	2280	1807	473	178	1629	0	116	1141	118	108	0	67	79	0	0
전라남도	완도군	생일면	계	645	474	171	27	447	0	56	315	30	35	0	5	6	0	0
전라남도	해남군	관외사전투표		4353	4352	1	92	4260	0	404	3001	567	149	0	71	68	0	0
전라남도	해남군	거소우편투표		372	344	28	40	304	0	61	192	26	13	0	8	4	0	0
전라남도	해남군	해남읍	계	17491	10406	7085	340	10066	0	1282	6368	1812	298	0	222	84	0	0
전라남도	해남군	삼산면	계	2755	1675	1080	102	1573	0	196	964	259	57	0	73	24	0	0
전라남도	해남군	화산면	계	3202	2061	1141	164	1897	0	190	1240	282	67	0	82	36	0	0
전라남도	해남군	현산면	계	2891	1955	936	159	1796	0	165	1183	249	76	0	53	70	0	0
전라남도	해남군	송지면	계	5711	3729	1982	316	3413	0	329	2118	612	146	0	146	62	0	0
전라남도	해남군	북평면	계	2582	2013	569	209	1804	0	133	1321	228	46	0	48	28	0	0
전라남도	해남군	북일면	계	1955	1299	656	84	1215	0	91	783	245	39	0	36	21	0	0
전라남도	해남군	옥천면	계	2946	1826	1120	150	1676	0	218	962	319	98	0	52	27	0	0
전라남도	해남군	계곡면	계	2148	1382	766	127	1255	0	142	848	150	66	0	33	16	0	0
전라남도	해남군	마산면	계	2334	1532	802	122	1410	0	144	989	174	41	0	47	15	0	0
전라남도	해남군	황산면	계	4915	3345	1570	254	3091	0	270	2134	324	205	0	113	45	0	0
전라남도	해남군	산이면	계	3784	2085	1699	119	1966	0	171	1400	245	68	0	59	23	0	0
전라남도	해남군	문내면	계	3868	2653	1215	303	2350	0	220	1518	244	102	0	213	53	0	0
전라남도	해남군	화원면	계	3499	2192	1307	167	2025	0	205	1211	290	55	0	108	156	0	0
전라남도	진도군	관외사전투표		2195	2193	2	82	2111	0	206	1573	194	64	0	44	30	0	0
전라남도	진도군	거소우편투표		186	175	11	6	169	0	18	133	12	2	0	3	1	0	0
전라남도	진도군	진도읍	계	7698	5544	2154	283	5261	0	657	3612	491	227	0	166	108	0	0
전라남도	진도군	군내면	계	2752	1916	836	118	1798	0	220	1131	212	96	0	69	70	0	0
전라남도	진도군	고군면	계	3162	2250	912	184	2066	0	220	1436	188	119	0	52	51	0	0
전라남도	진도군	의신면	계	3168	2315	853	148	2167	0	267	1439	188	118	0	95	60	0	0
전라남도	진도군	임회면	계	3158	2366	792	228	2138	0	280	1405	206	96	0	76	75	0	0
전라남도	진도군	지산면	계	3099	2299	800	187	2112	0	248	1334	224	139	0	112	55	0	0
전라남도	진도군	조도면	계	2533	1781	752	209	1572	0	171	988	119	85	0	57	152	0	0
전라남도	영암군	관외사전투표		3669	3664	5	113	3551	0	326	2517	382	228	0	57	41	0	0
전라남도	영암군	거소우편투표		299	281	18	25	256	0	68	125	25	20	0	8	10	0	0
전라남도	영암군	영암읍	계	6433	4619	1814	219	4400	0	595	2950	517	198	0	107	33	0	0
전라남도	영암군	삼호읍	계	15773	8522	7251	310	8212	0	783	5192	973	884	0	301	79	0	0
전라남도	영암군	덕진면	계	1706	1286	420	83	1203	0	119	835	110	82	0	42	15	0	0
전라남도	영암군	금정면	계	1860	1362	498	102	1260	0	130	817	147	110	0	40	16	0	0
전라남도	영암군	신북면	계	3556	2510	1046	127	2383	0	199	1718	278	98	0	60	30	0	0
전라남도	영암군	시종면	계	3548	2356	1192	187	2169	0	161	1537	233	128	0	83	27	0	0
전라남도	영암군	도포면	계	2156	1549	607	81	1468	0	151	985	168	103	0	39	22	0	0
전라남도	영암군	군서면	계	2909	2165	744	196	1969	0	217	1306	202	175	0	42	27	0	0
전라남도	영암군	서호면	계	1824	1380	444	151	1229	0	147	762	136	123	0	39	22	0	0
전라남도	영암군	학산면	계	2721	2003	718	142	1861	0	248	1232	180	132	0	49	20	0	0
전라남도	영암군	미암면	계	2026	1421	605	84	1337	0	156	901	119	93	0	51	17	0	0
전라남도	무안군	관외사전투표		4279	4275	4	112	4163	0	435	2939	352	288	0	91	58	0	0
전라남도	무안군	거소우편투표		1005	882	123	191	691	0	101	419	47	39	0	57	28	0	0
전라남도	무안군	무안읍	계	8420	5536	2884	271	5265	0	510	3889	464	186	0	149	67	0	0
전라남도	무안군	일로읍	계	6073	3804	2269	169	3635	0	244	2639	258	259	0	168	67	0	0
전라남도	무안군	삼향읍	계	20888	10872	10016	256	10616	0	788	6932	1162	1075	0	536	123	0	0
전라남도	무안군	몽탄면	계	3021	2084	937	108	1976	0	146	1344	143	131	0	101	111	0	0
전라남도	무안군	청계면	계	5666	3554	2112	179	3375	0	311	2450	234	180	0	143	57	0	0
전라남도	무안군	현경면	계	4586	2964	1622	171	2793	0	305	1863	260	182	0	110	73	0	0
전라남도	무안군	망운면	계	1934	1334	600	93	1241	0	107	904	90	69	0	25	46	0	0
전라남도	무안군	해제면	계	4911	3540	1371	247	3293	0	339	2407	241	172	0	84	50	0	0
전라남도	무안군	운남면	계	2864	1907	957	174	1733	0	140	1315	123	72	0	55	28	0	0
전라남도	영광군	관외사전투표		4618	4615	3	168	4447	0	363	3223	566	162	0	69	64	0	0
전라남도	영광군	거소우편투표		356	334	22	39	295	0	45	171	35	21	0	7	16	0	0
전라남도	영광군	영광읍	계	15440	11051	4389	454	10597	0	1211	6815	1672	441	0	261	197	0	0
전라남도	영광군	백수읍	계	4343	3224	1119	294	2930	0	270	1675	433	233	0	129	190	0	0
전라남도	영광군	홍농읍	계	5501	3894	1607	262	3632	0	330	2141	716	286	0	89	70	0	0
전라남도	영광군	대마면	계	1463	1051	412	78	973	0	68	519	238	81	0	47	20	0	0
전라남도	영광군	묘량면	계	1548	1192	356	98	1094	0	123	604	151	99	0	73	44	0	0
전라남도	영광군	불갑면	계	1172	889	283	56	833	0	81	512	107	75	0	30	28	0	0
전라남도	영광군	군서면	계	2046	1516	530	92	1424	0	148	823	207	144	0	59	43	0	0
전라남도	영광군	군남면	계	2246	1745	501	138	1607	0	161	886	251	180	0	66	63	0	0
전라남도	영광군	염산면	계	3821	2806	1015	198	2608	0	241	1380	662	192	0	88	45	0	0
전라남도	영광군	법성면	계	4904	3423	1481	282	3141	0	295	2118	359	190	0	117	62	0	0
전라남도	영광군	낙월면	계	448	258	190	16	242	0	21	150	20	23	0	17	11	0	0
전라남도	함평군	관외사전투표		2238	2237	1	47	2190	0	171	1610	271	84	0	40	14	0	0
전라남도	함평군	거소우편투표		226	197	29	27	170	0	27	86	32	8	0	9	8	0	0
전라남도	함평군	함평읍	계	6913	4619	2294	258	4361	0	492	2848	589	155	0	208	69	0	0
전라남도	함평군	손불면	계	3241	2197	1044	206	1991	0	193	1341	195	108	0	104	50	0	0
전라남도	함평군	신광면	계	1637	1178	459	108	1070	0	99	673	138	74	0	63	23	0	0
전라남도	함평군	학교면	계	3615	2359	1256	138	2221	0	200	1471	266	97	0	148	39	0	0
전라남도	함평군	엄다면	계	1825	1317	508	88	1229	0	106	836	135	68	0	64	20	0	0
전라남도	함평군	대동면	계	2532	1697	835	90	1607	0	158	1023	195	81	0	104	46	0	0
전라남도	함평군	나산면	계	2599	1789	810	120	1669	0	174	1158	186	47	0	80	24	0	0
전라남도	함평군	해보면	계	2515	1728	787	119	1609	0	111	1186	165	63	0	62	22	0	0
전라남도	함평군	월야면	계	3386	2318	1068	255	2063	0	164	1376	210	72	0	184	57	0	0
전라남도	신안군	관외사전투표		5315	5311	4	214	5097	0	493	3768	394	265	0	117	60	0	0
전라남도	신안군	거소우편투표		442	416	26	56	360	0	30	269	20	22	0	10	9	0	0
전라남도	신안군	지도읍	계	4017	3026	991	310	2716	0	282	1786	232	180	0	134	102	0	0
전라남도	신안군	압해읍	계	5265	4029	1236	373	3656	0	406	2274	343	198	0	281	154	0	0
전라남도	신안군	증도면	계	1686	1235	451	110	1125	0	113	763	83	69	0	55	42	0	0
전라남도	신안군	임자면	계	2695	1937	758	219	1718	0	164	1151	149	95	0	97	62	0	0
전라남도	신안군	자은면	계	1941	1496	445	197	1299	0	129	859	104	79	0	68	60	0	0
전라남도	신안군	비금면	계	2986	2284	702	247	2037	0	211	1419	140	88	0	104	75	0	0
전라남도	신안군	도초면	계	2342	1674	668	179	1495	0	153	968	121	80	0	86	87	0	0
전라남도	신안군	흑산면	계	3078	2080	998	169	1911	0	217	1241	146	118	0	69	120	0	0
전라남도	신안군	하의면	계	1574	1078	496	90	988	0	72	637	54	54	0	100	71	0	0
전라남도	신안군	신의면	계	1395	1040	355	108	932	0	79	533	87	91	0	102	40	0	0
전라남도	신안군	장산면	계	1373	1061	312	140	921	0	137	497	91	49	0	64	83	0	0
전라남도	신안군	안좌면	계	2700	1870	830	161	1709	0	229	1045	119	101	0	117	98	0	0
전라남도	신안군	팔금면	계	933	704	229	37	667	0	48	440	60	48	0	37	34	0	0
전라남도	신안군	암태면	계	1746	1328	418	132	1196	0	119	803	104	81	0	36	53	0	0
경상북도	포항시북구	관외사전투표		10069	10071	-2	208	9863	0	6212	2629	318	414	0	145	0	145	0
경상북도	포항시북구	거소우편투표		817	735	82	39	696	0	452	146	21	32	0	15	0	30	0
경상북도	포항시북구	흥해읍	계	26775	14704	12071	399	14305	0	11328	1879	322	429	0	169	0	178	0
경상북도	포항시북구	신광면	계	2732	1468	1264	52	1416	0	1215	126	21	18	0	10	0	26	0
경상북도	포항시북구	청하면	계	4601	2460	2141	61	2399	0	2076	204	24	47	0	17	0	31	0
경상북도	포항시북구	송라면	계	2487	1314	1173	46	1268	0	1118	91	16	27	0	6	0	10	0
경상북도	포항시북구	기계면	계	4800	2552	2248	65	2487	0	2116	211	29	54	0	47	0	30	0
경상북도	포항시북구	죽장면	계	2535	1530	1005	63	1467	0	1247	114	33	31	0	17	0	25	0
경상북도	포항시북구	기북면	계	1160	776	384	31	745	0	619	60	13	26	0	10	0	17	0
경상북도	포항시북구	중앙동	계	15147	6966	8181	149	6817	0	5636	844	82	144	0	57	0	54	0
경상북도	포항시북구	양학동	계	14291	7493	6798	158	7335	0	5361	1487	146	203	0	83	0	55	0
경상북도	포항시북구	죽도동	계	18467	7776	10691	126	7650	0	6355	933	82	163	0	66	0	51	0
경상북도	포항시북구	용흥동	계	19369	10118	9251	222	9896	0	7662	1602	165	271	0	99	0	97	0
경상북도	포항시북구	우창동	계	21699	10259	11440	238	10021	0	7383	1897	212	331	0	112	0	86	0
경상북도	포항시북구	두호동	계	18820	9320	9500	169	9151	0	6876	1678	142	304	0	96	0	55	0
경상북도	포항시북구	장량동	계	44049	20294	23755	284	20010	0	13485	5046	372	744	0	210	0	153	0
경상북도	포항시북구	환여동	계	8382	4597	3785	75	4522	0	3242	972	74	141	0	46	0	47	0
경상북도	포항시남구	관외사전투표		8379	8377	2	186	8191	0	5137	2192	279	323	0	154	0	106	0
경상북도	포항시남구	거소우편투표		564	518	46	26	492	0	353	90	17	8	0	10	0	14	0
경상북도	포항시남구	구룡포읍	계	8311	4967	3344	222	4745	0	4013	326	100	76	0	76	0	154	0
경상북도	포항시남구	연일읍	계	25138	12244	12894	237	12007	0	8809	2369	244	322	0	164	0	99	0
경상북도	포항시남구	오천읍	계	38116	16477	21639	425	16052	0	11498	3238	382	468	0	273	0	193	0
경상북도	포항시남구	대송면	계	4116	2378	1738	91	2287	0	1841	257	25	87	0	40	0	37	0
경상북도	포항시남구	동해면	계	8638	4921	3717	156	4765	0	3805	633	67	137	0	72	0	51	0
경상북도	포항시남구	장기면	계	4362	2668	1694	135	2533	0	2242	164	26	37	0	22	0	42	0
경상북도	포항시남구	호미곶면	계	2014	1292	722	73	1219	0	1064	70	10	19	0	23	0	33	0
경상북도	포항시남구	상대동	계	23359	10616	12743	195	10421	0	8471	1384	179	230	0	98	0	59	0
경상북도	포항시남구	해도동	계	18148	8055	10093	170	7885	0	6544	912	129	142	0	102	0	56	0
경상북도	포항시남구	송도동	계	14046	6752	7294	129	6623	0	5563	658	76	163	0	73	0	90	0
경상북도	포항시남구	청림동	계	5244	2719	2525	66	2653	0	2151	343	40	52	0	29	0	38	0
경상북도	포항시남구	제철동	계	2554	1264	1290	28	1236	0	823	323	28	38	0	15	0	9	0
경상북도	포항시남구	효곡동	계	22571	12289	10282	159	12130	0	7598	3599	239	456	0	116	0	122	0
경상북도	포항시남구	대이동	계	15560	7399	8161	103	7296	0	4996	1805	156	227	0	57	0	55	0
경상북도	울릉군	관외사전투표		1468	1467	1	66	1401	0	1022	286	41	20	0	14	0	18	0
경상북도	울릉군	거소우편투표		106	96	10	23	73	0	60	9	0	0	0	2	0	2	0
경상북도	울릉군	울릉읍	계	5556	4112	1444	157	3955	0	3197	531	70	74	0	48	0	35	0
경상북도	울릉군	서면	계	1137	933	204	47	886	0	733	104	13	18	0	7	0	11	0
경상북도	울릉군	북면	계	1077	882	195	31	851	0	684	129	11	10	0	8	0	9	0
경상북도	경주시	관외사전투표		11166	11151	15	262	10889	0	7021	2740	515	340	0	193	0	80	0
경상북도	경주시	거소우편투표		1019	949	70	35	914	0	652	120	48	38	0	25	0	31	0
경상북도	경주시	감포읍	계	5398	3341	2057	195	3146	0	2557	339	63	60	0	42	0	85	0
경상북도	경주시	안강읍	계	23686	13002	10684	608	12394	0	9767	1543	474	286	0	214	0	110	0
경상북도	경주시	건천읍	계	9123	5340	3783	351	4989	0	4005	491	161	117	0	99	0	116	0
경상북도	경주시	외동읍	계	13908	6894	7014	255	6639	0	5206	876	220	139	0	122	0	76	0
경상북도	경주시	양북면	계	3386	2196	1190	153	2043	0	1653	184	64	54	0	38	0	50	0
경상북도	경주시	양남면	계	5502	3330	2172	128	3202	0	2111	660	172	92	0	130	0	37	0
경상북도	경주시	내남면	계	4384	2441	1943	102	2339	0	1875	251	69	70	0	32	0	42	0
경상북도	경주시	산내면	계	2915	1753	1162	164	1589	0	1271	167	44	40	0	35	0	32	0
경상북도	경주시	서면	계	3206	2050	1156	147	1903	0	1499	194	55	75	0	44	0	36	0
경상북도	경주시	현곡면	계	11468	6849	4619	215	6634	0	4543	1346	330	232	0	125	0	58	0
경상북도	경주시	강동면	계	6108	3180	2928	153	3027	0	2407	386	68	94	0	47	0	25	0
경상북도	경주시	천북면	계	4489	2639	1850	118	2521	0	2075	230	61	88	0	35	0	32	0
경상북도	경주시	중부동	계	5080	2685	2395	79	2606	0	2155	286	64	50	0	20	0	31	0
경상북도	경주시	황오동	계	7042	3907	3135	101	3806	0	3109	420	94	86	0	36	0	61	0
경상북도	경주시	성건동	계	14270	7292	6978	260	7032	0	5574	1005	203	140	0	74	0	36	0
경상북도	경주시	황남동	계	5992	3472	2520	218	3254	0	2738	300	60	78	0	52	0	26	0
경상북도	경주시	월성동	계	5612	2996	2616	71	2925	0	2270	401	99	77	0	38	0	40	0
경상북도	경주시	선도동	계	10680	6380	4300	218	6162	0	4459	1124	261	185	0	79	0	54	0
경상북도	경주시	용강동	계	13177	7281	5896	206	7075	0	4929	1354	358	238	0	140	0	56	0
경상북도	경주시	황성동	계	20265	11186	9079	299	10887	0	7307	2212	695	355	0	248	0	70	0
경상북도	경주시	동천동	계	19886	10781	9105	238	10543	0	7893	1705	438	232	0	179	0	96	0
경상북도	경주시	불국동	계	7382	4075	3307	155	3920	0	3066	510	118	89	0	85	0	52	0
경상북도	경주시	보덕동	계	1778	1053	725	45	1008	0	803	115	24	30	0	20	0	16	0
경상북도	김천시	관외사전투표		6914	6910	4	154	6756	0	4383	1889	181	158	0	83	0	62	0
경상북도	김천시	거소우편투표		774	651	123	49	602	0	471	87	9	12	0	13	0	10	0
경상북도	김천시	아포읍	계	6682	3988	2694	181	3807	0	3045	469	78	61	0	58	0	96	0
경상북도	김천시	농소면	계	2707	1864	843	82	1782	0	1505	188	19	27	0	18	0	25	0
경상북도	김천시	남면	계	2931	1924	1007	145	1779	0	1498	150	31	45	0	20	0	35	0
경상북도	김천시	개령면	계	2411	1536	875	79	1457	0	1218	153	25	32	0	11	0	18	0
경상북도	김천시	감문면	계	3247	2342	905	121	2221	0	1893	170	56	51	0	19	0	32	0
경상북도	김천시	어모면	계	4024	2509	1515	143	2366	0	1951	267	31	53	0	25	0	39	0
경상북도	김천시	봉산면	계	2957	2059	898	140	1919	0	1589	228	26	31	0	23	0	22	0
경상북도	김천시	대항면	계	3391	2140	1251	112	2028	0	1576	290	59	40	0	34	0	29	0
경상북도	김천시	감천면	계	1862	1329	533	91	1238	0	955	144	27	68	0	30	0	14	0
경상북도	김천시	조마면	계	2115	1468	647	112	1356	0	988	193	38	79	0	26	0	32	0
경상북도	김천시	구성면	계	2851	1850	1001	132	1718	0	1295	207	55	76	0	37	0	48	0
경상북도	김천시	지례면	계	1580	1133	447	83	1050	0	818	117	20	45	0	15	0	35	0
경상북도	김천시	부항면	계	1128	848	280	59	789	0	580	111	21	42	0	12	0	23	0
경상북도	김천시	대덕면	계	2024	1390	634	134	1256	0	912	149	39	75	0	34	0	47	0
경상북도	김천시	증산면	계	1038	774	264	82	692	0	512	87	17	43	0	12	0	21	0
경상북도	김천시	자산동	계	7337	4268	3069	166	4102	0	3292	576	63	95	0	43	0	33	0
경상북도	김천시	평화남산동	계	8311	4660	3651	206	4454	0	3551	644	51	89	0	55	0	64	0
경상북도	김천시	양금동	계	4178	2691	1487	147	2544	0	2008	378	32	57	0	25	0	44	0
경상북도	김천시	대신동	계	17692	9577	8115	256	9321	0	6612	2080	208	216	0	121	0	84	0
경상북도	김천시	대곡동	계	16734	9441	7293	326	9115	0	6863	1652	204	187	0	106	0	103	0
경상북도	김천시	지좌동	계	7789	4341	3448	123	4218	0	3347	650	76	63	0	52	0	30	0
경상북도	김천시	율곡동	계	875	535	340	7	528	0	292	191	14	22	0	8	0	1	0
경상북도	안동시	관외사전투표		8995	8992	3	216	8776	0	5439	2625	252	255	0	120	0	85	0
경상북도	안동시	거소우편투표		1403	1260	143	220	1040	0	764	118	47	47	0	30	0	34	0
경상북도	안동시	풍산읍	계	6104	4148	1956	258	3890	0	3060	434	83	185	0	70	0	58	0
경상북도	안동시	와룡면	계	3780	2584	1196	207	2377	0	1890	270	58	93	0	29	0	37	0
경상북도	안동시	북후면	계	2913	1899	1014	132	1767	0	1387	166	54	100	0	24	0	36	0
경상북도	안동시	서후면	계	3217	1910	1307	103	1807	0	1455	204	34	64	0	27	0	23	0
경상북도	안동시	풍천면	계	3531	2405	1126	135	2270	0	1853	201	41	67	0	71	0	37	0
경상북도	안동시	일직면	계	2831	1954	877	146	1808	0	1480	174	43	30	0	43	0	38	0
경상북도	안동시	남후면	계	1700	1237	463	99	1138	0	962	96	21	25	0	19	0	15	0
경상북도	안동시	남선면	계	2086	1378	708	80	1298	0	989	178	35	36	0	36	0	24	0
경상북도	안동시	임하면	계	2641	1740	901	84	1656	0	1345	147	34	48	0	55	0	27	0
경상북도	안동시	길안면	계	2782	1887	895	101	1786	0	1430	182	29	61	0	43	0	41	0
경상북도	안동시	임동면	계	1778	1246	532	90	1156	0	961	89	28	40	0	12	0	26	0
경상북도	안동시	예안면	계	1798	1298	500	99	1199	0	905	148	32	66	0	28	0	20	0
경상북도	안동시	도산면	계	1685	1237	448	67	1170	0	900	142	35	55	0	18	0	20	0
경상북도	안동시	녹전면	계	1755	1296	459	92	1204	0	933	120	35	56	0	33	0	27	0
경상북도	안동시	중구동	계	4593	2782	1811	91	2691	0	2180	356	45	66	0	20	0	24	0
경상북도	안동시	명륜동	계	4599	2872	1727	78	2794	0	2094	517	60	80	0	24	0	19	0
경상북도	안동시	용상동	계	17067	10380	6687	302	10078	0	7418	1953	212	256	0	123	0	116	0
경상북도	안동시	서구동	계	6659	4062	2597	186	3876	0	3126	531	54	92	0	41	0	32	0
경상북도	안동시	태화동	계	11108	6554	4554	248	6306	0	4986	935	109	143	0	72	0	61	0
경상북도	안동시	평화동	계	6006	3622	2384	93	3529	0	2778	557	71	67	0	36	0	20	0
경상북도	안동시	안기동	계	5764	3583	2181	106	3477	0	2681	605	73	70	0	33	0	15	0
경상북도	안동시	옥동	계	15292	9034	6258	277	8757	0	6108	1904	234	260	0	132	0	119	0
경상북도	안동시	송하동	계	10891	6362	4529	214	6148	0	4282	1384	155	181	0	105	0	41	0
경상북도	안동시	강남동	계	6737	4358	2379	95	4263	0	2842	1067	124	112	0	70	0	48	0
경상북도	구미시	관외사전투표		15870	15852	18	320	15532	0	10100	4061	458	445	0	238	0	230	0
경상북도	구미시	거소우편투표		738	691	47	31	660	0	515	73	17	22	0	19	0	14	0
경상북도	구미시	선산읍	계	12006	6248	5758	118	6130	0	5264	574	80	71	0	83	0	58	0
경상북도	구미시	고아읍	계	22831	12888	9943	335	12553	0	9764	1973	185	295	0	191	0	145	0
경상북도	구미시	무을면	계	1887	1167	720	37	1130	0	999	84	14	4	0	15	0	14	0
경상북도	구미시	옥성면	계	1714	1090	624	43	1047	0	937	70	10	9	0	10	0	11	0
경상북도	구미시	도개면	계	2159	1314	845	65	1249	0	1054	111	23	40	0	11	0	10	0
경상북도	구미시	해평면	계	4577	2522	2055	134	2388	0	1999	209	48	49	0	51	0	32	0
경상북도	구미시	산동면	계	3129	1565	1564	61	1504	0	1214	195	22	31	0	21	0	21	0
경상북도	구미시	장천면	계	3070	1890	1180	105	1785	0	1536	164	25	27	0	16	0	17	0
경상북도	구미시	송정동	계	15004	7325	7679	214	7111	0	5230	1374	130	179	0	112	0	86	0
경상북도	구미시	원평1동	계	4383	1605	2778	75	1530	0	1269	180	22	27	0	19	0	13	0
경상북도	구미시	원평2동	계	3954	1869	2085	108	1761	0	1486	192	20	26	0	24	0	13	0
경상북도	구미시	지산동	계	2468	1458	1010	101	1357	0	1122	133	26	33	0	29	0	14	0
경상북도	구미시	도량동	계	23372	11759	11613	343	11416	0	8249	2288	209	297	0	230	0	143	0
경상북도	구미시	선주원남동	계	31956	16237	15719	603	15634	0	10867	3635	286	438	0	223	0	185	0
경상북도	구미시	형곡1동	계	11790	6408	5382	291	6117	0	4400	1268	105	157	0	113	0	74	0
경상북도	구미시	형곡2동	계	16008	8009	7999	330	7679	0	5677	1464	113	180	0	132	0	113	0
경상북도	구미시	신평1동	계	3985	2059	1926	67	1992	0	1491	344	43	39	0	51	0	24	0
경상북도	구미시	신평2동	계	2682	1463	1219	47	1416	0	1110	195	19	26	0	39	0	27	0
경상북도	구미시	비산동	계	3548	1709	1839	48	1661	0	1211	297	40	44	0	43	0	26	0
경상북도	구미시	공단1동	계	4630	2279	2351	45	2234	0	1601	441	39	63	0	52	0	38	0
경상북도	구미시	공단2동	계	3716	1583	2133	23	1560	0	953	459	41	40	0	43	0	24	0
경상북도	구미시	광평동	계	3694	1866	1828	28	1838	0	1345	360	26	38	0	47	0	22	0
경상북도	구미시	상모사곡동	계	21551	9804	11747	339	9465	0	6839	1855	154	224	0	279	0	114	0
경상북도	구미시	임오동	계	12370	5931	6439	217	5714	0	4093	1150	118	105	0	168	0	80	0
경상북도	구미시	인동동	계	40451	15779	24672	286	15493	0	10280	3898	392	435	0	278	0	210	0
경상북도	구미시	진미동	계	18772	4915	13857	121	4794	0	2718	1477	177	191	0	145	0	86	0
경상북도	구미시	양포동	계	28781	12872	15909	250	12622	0	7724	3852	285	381	0	194	0	186	0
경상북도	영주시	관외사전투표		5923	5923	0	149	5774	0	3392	1837	175	221	0	93	0	56	0
경상북도	영주시	거소우편투표		419	388	31	32	356	0	264	41	10	14	0	16	0	11	0
경상북도	영주시	풍기읍	계	10165	6214	3951	228	5986	0	4814	830	114	115	0	41	0	72	0
경상북도	영주시	이산면	계	2323	1484	839	59	1425	0	1090	186	31	62	0	26	0	30	0
경상북도	영주시	평은면	계	1412	881	531	41	840	0	698	80	9	28	0	12	0	13	0
경상북도	영주시	문수면	계	1802	1261	541	109	1152	0	836	153	39	79	0	21	0	24	0
경상북도	영주시	장수면	계	2107	1412	695	63	1349	0	1085	126	28	60	0	23	0	27	0
경상북도	영주시	안정면	계	2894	1981	913	173	1808	0	1420	240	41	51	0	22	0	34	0
경상북도	영주시	봉현면	계	2669	1784	885	67	1717	0	1420	190	26	42	0	17	0	22	0
경상북도	영주시	순흥면	계	1992	1538	454	91	1447	0	1185	162	28	39	0	17	0	16	0
경상북도	영주시	단산면	계	1876	1393	483	59	1334	0	1045	143	41	45	0	29	0	31	0
경상북도	영주시	부석면	계	3038	2277	761	152	2125	0	1661	265	44	66	0	50	0	39	0
경상북도	영주시	상망동	계	6586	4324	2262	180	4144	0	2986	825	87	116	0	70	0	60	0
경상북도	영주시	하망동	계	5669	3794	1875	127	3667	0	2719	676	74	104	0	59	0	35	0
경상북도	영주시	영주1동	계	4194	2713	1481	96	2617	0	2113	326	49	70	0	29	0	30	0
경상북도	영주시	영주2동	계	3543	2341	1202	67	2274	0	1734	401	37	52	0	28	0	22	0
경상북도	영주시	휴천1동	계	5213	3314	1899	135	3179	0	2247	673	73	93	0	50	0	43	0
경상북도	영주시	휴천2동	계	7806	4910	2896	142	4768	0	3469	985	94	123	0	57	0	40	0
경상북도	영주시	휴천3동	계	6974	4439	2535	144	4295	0	3062	933	79	126	0	47	0	48	0
경상북도	영주시	가흥1동	계	9782	5960	3822	225	5735	0	4126	1211	124	136	0	72	0	66	0
경상북도	영주시	가흥2동	계	6109	3799	2310	158	3641	0	2626	728	74	112	0	62	0	39	0
경상북도	영천시	관외사전투표		5051	5051	0	104	4947	0	3150	1350	131	219	0	61	0	36	0
경상북도	영천시	거소우편투표		531	501	30	52	449	0	319	51	32	15	0	8	0	24	0
경상북도	영천시	금호읍	계	10109	5697	4412	236	5461	0	4294	690	130	183	0	98	0	66	0
경상북도	영천시	청통면	계	3872	2433	1439	113	2320	0	1910	265	34	56	0	31	0	24	0
경상북도	영천시	신녕면	계	3735	2452	1283	157	2295	0	1900	231	46	63	0	27	0	28	0
경상북도	영천시	화산면	계	2985	1863	1122	122	1741	0	1394	187	47	55	0	33	0	25	0
경상북도	영천시	화북면	계	1912	1243	669	97	1146	0	913	137	21	42	0	10	0	23	0
경상북도	영천시	화남면	계	2787	1927	860	124	1803	0	1483	196	30	48	0	22	0	24	0
경상북도	영천시	자양면	계	1005	698	307	71	627	0	496	69	14	28	0	5	0	15	0
경상북도	영천시	임고면	계	3776	2516	1260	213	2303	0	1830	246	41	93	0	42	0	51	0
경상북도	영천시	고경면	계	4920	3114	1806	196	2918	0	2279	375	72	111	0	32	0	49	0
경상북도	영천시	북안면	계	3975	2580	1395	110	2470	0	2006	269	45	67	0	33	0	50	0
경상북도	영천시	대창면	계	2807	1676	1131	68	1608	0	1270	184	40	47	0	42	0	25	0
경상북도	영천시	동부동	계	19547	11234	8313	463	10771	0	7923	1793	266	513	0	153	0	123	0
경상북도	영천시	중앙동	계	7399	4485	2914	205	4280	0	3168	706	111	200	0	57	0	38	0
경상북도	영천시	서부동	계	4605	2962	1643	131	2831	0	2184	412	60	105	0	28	0	42	0
경상북도	영천시	완산동	계	3889	2362	1527	115	2247	0	1763	344	35	72	0	19	0	14	0
경상북도	영천시	남부동	계	3093	1846	1247	95	1751	0	1369	245	31	50	0	31	0	25	0
경상북도	상주시	관외사전투표		6498	6495	3	195	6300	0	4232	1557	174	164	0	112	0	61	0
경상북도	상주시	거소우편투표		892	834	58	76	758	0	531	98	32	42	0	32	0	23	0
경상북도	상주시	함창읍	계	5656	3741	1915	185	3556	0	2903	338	65	112	0	86	0	52	0
경상북도	상주시	사벌면	계	3511	2635	876	201	2434	0	1917	221	64	74	0	107	0	51	0
경상북도	상주시	중동면	계	1392	1010	382	111	899	0	723	88	12	35	0	24	0	17	0
경상북도	상주시	낙동면	계	3783	2661	1122	256	2405	0	1931	258	53	63	0	58	0	42	0
경상북도	상주시	청리면	계	2608	1951	657	136	1815	0	1463	174	41	52	0	56	0	29	0
경상북도	상주시	공성면	계	3859	2826	1033	175	2651	0	2183	239	31	107	0	49	0	42	0
경상북도	상주시	외남면	계	1608	1249	359	87	1162	0	880	129	15	42	0	57	0	39	0
경상북도	상주시	내서면	계	1738	1288	450	65	1223	0	903	134	75	59	0	34	0	18	0
경상북도	상주시	모동면	계	2331	1739	592	114	1625	0	1193	231	45	39	0	93	0	24	0
경상북도	상주시	모서면	계	2374	1709	665	113	1596	0	1202	191	50	65	0	56	0	32	0
경상북도	상주시	화동면	계	1819	1388	431	65	1323	0	1043	164	29	43	0	32	0	12	0
경상북도	상주시	화서면	계	2446	1726	720	104	1622	0	1305	154	43	47	0	40	0	33	0
경상북도	상주시	화북면	계	1402	1029	373	39	990	0	774	114	34	35	0	26	0	7	0
경상북도	상주시	외서면	계	2162	1566	596	111	1455	0	1038	181	46	118	0	38	0	34	0
경상북도	상주시	은척면	계	1463	1137	326	61	1076	0	831	92	24	40	0	70	0	19	0
경상북도	상주시	공검면	계	2106	1507	599	65	1442	0	1164	127	32	38	0	54	0	27	0
경상북도	상주시	이안면	계	1893	1530	363	103	1427	0	1189	114	24	42	0	28	0	30	0
경상북도	상주시	화남면	계	725	537	188	29	508	0	407	46	15	19	0	10	0	11	0
경상북도	상주시	남원동	계	9044	5760	3284	163	5597	0	4287	957	108	114	0	79	0	52	0
경상북도	상주시	북문동	계	5924	3833	2091	139	3694	0	2803	632	75	75	0	58	0	51	0
경상북도	상주시	계림동	계	6142	3827	2315	196	3631	0	2819	546	67	97	0	55	0	47	0
경상북도	상주시	동문동	계	6766	4260	2506	166	4094	0	3222	629	65	86	0	50	0	42	0
경상북도	상주시	동성동	계	3277	2075	1202	75	2000	0	1615	252	34	46	0	32	0	21	0
경상북도	상주시	신흥동	계	6584	4169	2415	132	4037	0	2925	833	93	86	0	54	0	46	0
경상북도	문경시	관외사전투표		4685	4683	2	149	4534	0	3159	1015	138	104	0	79	0	39	0
경상북도	문경시	거소우편투표		823	786	37	97	689	0	512	79	29	16	0	31	0	22	0
경상북도	문경시	문경읍	계	6185	4267	1918	200	4067	0	3405	342	78	101	0	110	0	31	0
경상북도	문경시	가은읍	계	3451	2633	818	257	2376	0	1847	214	45	71	0	139	0	60	0
경상북도	문경시	영순면	계	2113	1603	510	120	1483	0	1273	99	29	29	0	24	0	29	0
경상북도	문경시	산양면	계	2889	2187	702	125	2062	0	1702	163	40	34	0	66	0	57	0
경상북도	문경시	호계면	계	2244	1435	809	48	1387	0	1174	100	24	21	0	40	0	28	0
경상북도	문경시	산북면	계	2508	1928	580	157	1771	0	1377	168	42	58	0	63	0	63	0
경상북도	문경시	동로면	계	1622	1230	392	59	1171	0	936	113	31	23	0	32	0	36	0
경상북도	문경시	마성면	계	3208	2326	882	143	2183	0	1765	196	34	72	0	85	0	31	0
경상북도	문경시	농암면	계	2214	1661	553	111	1550	0	1235	120	33	48	0	86	0	28	0
경상북도	문경시	점촌1동	계	4840	3204	1636	104	3100	0	2623	300	53	60	0	45	0	19	0
경상북도	문경시	점촌2동	계	6413	4224	2189	152	4072	0	3462	394	60	58	0	63	0	35	0
경상북도	문경시	점촌3동	계	7469	4890	2579	171	4719	0	3896	555	80	77	0	71	0	40	0
경상북도	문경시	점촌4동	계	2964	2004	960	98	1906	0	1586	144	51	43	0	58	0	24	0
경상북도	문경시	점촌5동	계	10177	6882	3295	179	6703	0	5131	1142	166	111	0	84	0	69	0
경상북도	예천군	관외사전투표		2359	2356	3	54	2302	0	1543	580	80	46	0	34	0	19	0
경상북도	예천군	거소우편투표		346	314	32	21	293	0	226	28	9	11	0	5	0	14	0
경상북도	예천군	예천읍	계	13375	9120	4255	338	8782	0	6976	1153	198	230	0	100	0	125	0
경상북도	예천군	용문면	계	2261	1649	612	53	1596	0	1331	151	24	42	0	23	0	25	0
경상북도	예천군	상리면	계	1022	791	231	40	751	0	615	77	16	17	0	14	0	12	0
경상북도	예천군	하리면	계	1248	996	252	40	956	0	819	70	15	16	0	15	0	21	0
경상북도	예천군	감천면	계	2580	1996	584	135	1861	0	1421	196	51	59	0	75	0	59	0
경상북도	예천군	보문면	계	1597	1186	411	61	1125	0	891	95	28	33	0	40	0	38	0
경상북도	예천군	호명면	계	2206	1644	562	89	1555	0	1290	130	34	54	0	15	0	32	0
경상북도	예천군	유천면	계	2490	1588	902	77	1511	0	1230	170	33	30	0	24	0	24	0
경상북도	예천군	용궁면	계	2573	1792	781	91	1701	0	1472	121	20	34	0	19	0	35	0
경상북도	예천군	개포면	계	1609	1108	501	37	1071	0	879	96	24	31	0	12	0	29	0
경상북도	예천군	지보면	계	2823	2115	708	126	1989	0	1615	181	39	84	0	27	0	43	0
경상북도	예천군	풍양면	계	3271	2419	852	141	2278	0	1859	171	51	113	0	29	0	55	0
경상북도	경산시	관외사전투표		8474	8464	10	193	8271	0	5258	2089	333	387	0	125	0	79	0
경상북도	경산시	거소우편투표		424	378	46	15	363	0	255	58	12	16	0	10	0	12	0
경상북도	경산시	하양읍	계	20399	10623	9776	346	10277	0	7840	1621	277	344	0	120	0	75	0
경상북도	경산시	진량읍	계	28887	14385	14502	365	14020	0	10541	2162	431	526	0	231	0	129	0
경상북도	경산시	와촌면	계	5215	2929	2286	154	2775	0	2318	267	61	71	0	31	0	27	0
경상북도	경산시	자인면	계	5406	2942	2464	151	2791	0	2320	271	87	59	0	29	0	25	0
경상북도	경산시	용성면	계	3153	1804	1349	144	1660	0	1315	128	116	55	0	33	0	13	0
경상북도	경산시	남산면	계	3239	1968	1271	102	1866	0	1573	181	45	29	0	24	0	14	0
경상북도	경산시	압량면	계	12390	5394	6996	206	5188	0	3887	875	158	168	0	47	0	53	0
경상북도	경산시	남천면	계	2971	1733	1238	60	1673	0	1366	151	61	56	0	15	0	24	0
경상북도	경산시	중앙동	계	5823	2850	2973	114	2736	0	2136	380	73	94	0	34	0	19	0
경상북도	경산시	동부동	계	27097	12801	14296	372	12429	0	8919	2250	505	531	0	137	0	87	0
경상북도	경산시	서부1동	계	29705	14080	15625	346	13734	0	9809	2465	404	844	0	116	0	96	0
경상북도	경산시	서부2동	계	15800	8327	7473	235	8092	0	5835	1625	223	286	0	60	0	63	0
경상북도	경산시	남부동	계	13082	6342	6740	235	6107	0	4542	943	190	312	0	72	0	48	0
경상북도	경산시	북부동	계	10600	4102	6498	110	3992	0	2749	893	114	172	0	35	0	29	0
경상북도	경산시	중방동	계	9025	4735	4290	173	4562	0	3389	816	100	170	0	52	0	35	0
경상북도	청도군	관외사전투표		2617	2615	2	78	2537	0	1661	637	107	65	0	35	0	32	0
경상북도	청도군	거소우편투표		435	399	36	51	348	0	269	46	12	3	0	6	0	12	0
경상북도	청도군	청도읍	계	10405	7289	3116	355	6934	0	5448	842	162	247	0	114	0	121	0
경상북도	청도군	화양읍	계	6041	4103	1938	159	3944	0	3089	501	100	137	0	50	0	67	0
경상북도	청도군	각남면	계	1890	1427	463	50	1377	0	1110	140	28	49	0	20	0	30	0
경상북도	청도군	풍각면	계	3496	2428	1068	90	2338	0	1875	231	62	83	0	42	0	45	0
경상북도	청도군	각북면	계	1826	1237	589	52	1185	0	956	116	25	42	0	15	0	31	0
경상북도	청도군	이서면	계	3914	2675	1239	100	2575	0	2079	253	44	102	0	44	0	53	0
경상북도	청도군	운문면	계	1992	1356	636	82	1274	0	1014	144	34	36	0	27	0	19	0
경상북도	청도군	금천면	계	3023	2102	921	133	1969	0	1601	163	44	48	0	63	0	50	0
경상북도	청도군	매전면	계	3415	2448	967	111	2337	0	1852	221	66	117	0	35	0	46	0
경상북도	고령군	관외사전투표		1459	1459	0	30	1429	0	942	361	50	39	0	21	0	16	0
경상북도	고령군	거소우편투표		255	180	75	10	170	0	111	23	8	10	0	7	0	11	0
경상북도	고령군	고령읍	계	8522	5019	3503	243	4776	0	3709	625	148	86	0	100	0	108	0
경상북도	고령군	덕곡면	계	1289	924	365	33	891	0	684	80	35	16	0	53	0	23	0
경상북도	고령군	운수면	계	1770	1132	638	75	1057	0	821	110	20	39	0	29	0	38	0
경상북도	고령군	성산면	계	2416	1491	925	58	1433	0	1122	139	33	38	0	52	0	49	0
경상북도	고령군	다산면	계	7541	3914	3627	164	3750	0	2974	524	79	88	0	52	0	33	0
경상북도	고령군	개진면	계	1984	1131	853	56	1075	0	863	95	30	29	0	28	0	30	0
경상북도	고령군	우곡면	계	1637	1022	615	77	945	0	703	87	41	38	0	39	0	37	0
경상북도	고령군	쌍림면	계	3272	2117	1155	124	1993	0	1524	245	46	47	0	45	0	86	0
경상북도	성주군	관외사전투표		2294	2294	0	44	2250	0	1525	546	60	58	0	32	0	29	0
경상북도	성주군	거소우편투표		349	302	47	20	282	0	209	29	13	14	0	14	0	3	0
경상북도	성주군	성주읍	계	10344	5946	4398	219	5727	0	4470	777	153	106	0	114	0	107	0
경상북도	성주군	선남면	계	5645	3115	2530	95	3020	0	2452	316	67	77	0	57	0	51	0
경상북도	성주군	용암면	계	3316	2153	1163	109	2044	0	1654	223	55	51	0	35	0	26	0
경상북도	성주군	수륜면	계	2622	1790	832	90	1700	0	1329	186	32	80	0	31	0	42	0
경상북도	성주군	가천면	계	1756	1225	531	70	1155	0	951	121	22	27	0	17	0	17	0
경상북도	성주군	금수면	계	993	652	341	25	627	0	477	85	21	19	0	14	0	11	0
경상북도	성주군	대가면	계	2098	1535	563	74	1461	0	1206	137	35	37	0	26	0	20	0
경상북도	성주군	벽진면	계	3006	1846	1160	62	1784	0	1408	190	37	75	0	45	0	29	0
경상북도	성주군	초전면	계	4185	2432	1753	80	2352	0	1970	241	31	39	0	37	0	34	0
경상북도	성주군	월항면	계	2933	1878	1055	64	1814	0	1543	138	27	31	0	45	0	30	0
경상북도	칠곡군	관외사전투표		3396	3393	3	76	3317	0	2196	838	96	98	0	56	0	33	0
경상북도	칠곡군	거소우편투표		460	423	37	27	396	0	259	60	16	27	0	17	0	17	0
경상북도	칠곡군	왜관읍	계	24958	13880	11078	500	13380	0	10349	2131	256	320	0	176	0	148	0
경상북도	칠곡군	북삼읍	계	18523	8264	10259	195	8069	0	6208	1316	168	146	0	144	0	87	0
경상북도	칠곡군	석적읍	계	23022	8737	14285	190	8547	0	5042	2492	408	255	0	215	0	135	0
경상북도	칠곡군	지천면	계	4303	2613	1690	82	2531	0	2074	239	46	101	0	30	0	41	0
경상북도	칠곡군	동명면	계	5164	2851	2313	86	2765	0	2293	316	34	75	0	22	0	25	0
경상북도	칠곡군	가산면	계	3309	1781	1528	49	1732	0	1439	157	24	60	0	20	0	32	0
경상북도	칠곡군	약목면	계	9857	5395	4462	223	5172	0	4176	621	87	117	0	116	0	55	0
경상북도	칠곡군	기산면	계	2981	1709	1272	75	1634	0	1290	220	37	54	0	12	0	21	0
경상북도	군위군	관외사전투표		2155	2154	1	62	2092	0	1450	443	65	82	0	27	0	25	0
경상북도	군위군	거소우편투표		185	160	25	17	143	0	126	11	1	4	0	0	0	1	0
경상북도	군위군	군위읍	계	6356	4961	1395	276	4685	0	3618	548	120	246	0	67	0	86	0
경상북도	군위군	소보면	계	2102	1657	445	133	1524	0	1189	119	31	107	0	22	0	56	0
경상북도	군위군	효령면	계	3278	2517	761	144	2373	0	1944	216	43	95	0	37	0	38	0
경상북도	군위군	부계면	계	1757	1374	383	72	1302	0	1047	151	21	44	0	18	0	21	0
경상북도	군위군	우보면	계	1816	1469	347	98	1371	0	1080	113	29	67	0	35	0	47	0
경상북도	군위군	의흥면	계	2331	1920	411	189	1731	0	1361	142	40	69	0	68	0	51	0
경상북도	군위군	산성면	계	1141	933	208	58	875	0	703	51	18	39	0	32	0	32	0
경상북도	군위군	고로면	계	1145	895	250	34	861	0	677	93	12	38	0	15	0	26	0
경상북도	의성군	관외사전투표		2869	2868	1	84	2784	0	1794	758	80	86	0	37	0	29	0
경상북도	의성군	거소우편투표		502	470	32	26	444	0	297	74	24	18	0	12	0	19	0
경상북도	의성군	의성읍	계	11416	7408	4008	375	7033	0	5253	1320	146	121	0	91	0	102	0
경상북도	의성군	단촌면	계	1888	1316	572	66	1250	0	1003	131	30	23	0	27	0	36	0
경상북도	의성군	점곡면	계	1639	1121	518	60	1061	0	817	143	30	30	0	19	0	22	0
경상북도	의성군	옥산면	계	1762	1293	469	75	1218	0	932	145	42	47	0	28	0	24	0
경상북도	의성군	사곡면	계	1509	1034	475	62	972	0	826	89	12	19	0	16	0	10	0
경상북도	의성군	춘산면	계	1436	1028	408	61	967	0	810	96	19	26	0	7	0	9	0
경상북도	의성군	가음면	계	1348	939	409	43	896	0	750	96	16	15	0	7	0	12	0
경상북도	의성군	금성면	계	4118	2842	1276	119	2723	0	2266	288	67	46	0	21	0	35	0
경상북도	의성군	봉양면	계	3448	2435	1013	103	2332	0	1934	249	36	59	0	23	0	31	0
경상북도	의성군	비안면	계	2241	1683	558	109	1574	0	1311	160	38	30	0	18	0	17	0
경상북도	의성군	구천면	계	1722	1203	519	68	1135	0	943	110	20	32	0	11	0	19	0
경상북도	의성군	단밀면	계	1700	1323	377	61	1262	0	1060	88	24	23	0	18	0	49	0
경상북도	의성군	단북면	계	1746	1404	342	123	1281	0	1050	94	22	83	0	12	0	20	0
경상북도	의성군	안계면	계	3922	2942	980	183	2759	0	2291	303	38	62	0	29	0	36	0
경상북도	의성군	다인면	계	3689	2809	880	205	2604	0	2148	259	40	82	0	34	0	41	0
경상북도	의성군	신평면	계	763	617	146	31	586	0	469	62	7	22	0	8	0	18	0
경상북도	의성군	안평면	계	2017	1464	553	110	1354	0	1060	152	34	63	0	23	0	22	0
경상북도	의성군	안사면	계	797	593	204	41	552	0	447	54	14	16	0	3	0	18	0
경상북도	청송군	관외사전투표		1702	1700	2	56	1644	0	1052	412	70	62	0	25	0	23	0
경상북도	청송군	거소우편투표		197	184	13	18	166	0	121	15	12	10	0	3	0	5	0
경상북도	청송군	청송읍	계	4270	3301	969	203	3098	0	2320	504	78	108	0	48	0	40	0
경상북도	청송군	부동면	계	1698	1351	347	94	1257	0	927	128	44	47	0	64	0	47	0
경상북도	청송군	부남면	계	2251	1745	506	125	1620	0	1172	199	51	67	0	95	0	36	0
경상북도	청송군	현동면	계	1840	1423	417	121	1302	0	1023	118	45	58	0	38	0	20	0
경상북도	청송군	현서면	계	2265	1755	510	108	1647	0	1252	206	57	46	0	50	0	36	0
경상북도	청송군	안덕면	계	2285	1801	484	140	1661	0	1244	187	55	68	0	44	0	63	0
경상북도	청송군	파천면	계	1616	1229	387	102	1127	0	824	121	55	55	0	37	0	35	0
경상북도	청송군	진보면	계	5579	3906	1673	220	3686	0	2808	514	112	122	0	73	0	57	0
경상북도	영양군	관외사전투표		1270	1270	0	33	1237	0	738	363	62	32	0	24	0	18	0
경상북도	영양군	거소우편투표		189	145	44	38	107	0	78	13	4	5	0	1	0	6	0
경상북도	영양군	영양읍	계	6029	4667	1362	238	4429	0	3224	719	108	168	0	110	0	100	0
경상북도	영양군	입암면	계	1917	1575	342	113	1462	0	1103	194	58	50	0	22	0	35	0
경상북도	영양군	청기면	계	1654	1276	378	68	1208	0	906	115	38	75	0	32	0	42	0
경상북도	영양군	일월면	계	1596	1190	406	59	1131	0	821	151	35	52	0	24	0	48	0
경상북도	영양군	수비면	계	1544	1204	340	81	1123	0	792	146	45	68	0	42	0	30	0
경상북도	영양군	석보면	계	1968	1548	420	69	1479	0	1095	193	31	56	0	51	0	53	0
경상북도	영덕군	관외사전투표		2160	2158	2	69	2089	0	1467	435	55	63	0	34	0	35	0
경상북도	영덕군	거소우편투표		183	164	19	8	156	0	133	13	3	0	0	5	0	2	0
경상북도	영덕군	영덕읍	계	8717	6332	2385	348	5984	0	4779	751	95	139	0	117	0	103	0
경상북도	영덕군	강구면	계	5956	4011	1945	258	3753	0	3200	277	48	70	0	93	0	65	0
경상북도	영덕군	남정면	계	2364	1670	694	96	1574	0	1291	119	25	46	0	64	0	29	0
경상북도	영덕군	달산면	계	1134	846	288	84	762	0	616	74	8	29	0	20	0	15	0
경상북도	영덕군	지품면	계	1984	1467	517	78	1389	0	1054	156	39	47	0	57	0	36	0
경상북도	영덕군	축산면	계	2690	1936	754	79	1857	0	1591	143	23	32	0	37	0	31	0
경상북도	영덕군	영해면	계	5679	4009	1670	214	3795	0	3196	348	63	80	0	54	0	54	0
경상북도	영덕군	병곡면	계	2703	1911	792	136	1775	0	1449	110	40	43	0	81	0	52	0
경상북도	영덕군	창수면	계	1696	1208	488	68	1140	0	923	105	23	24	0	35	0	30	0
경상북도	봉화군	관외사전투표		2012	2012	0	62	1950	0	1216	550	60	55	0	42	0	27	0
경상북도	봉화군	거소우편투표		262	250	12	25	225	0	174	26	7	11	0	2	0	5	0
경상북도	봉화군	봉화읍	계	8154	5463	2691	291	5172	0	3837	837	125	140	0	129	0	104	0
경상북도	봉화군	물야면	계	2841	2077	764	137	1940	0	1482	217	52	63	0	47	0	79	0
경상북도	봉화군	봉성면	계	1927	1416	511	178	1238	0	933	147	47	43	0	36	0	32	0
경상북도	봉화군	법전면	계	1851	1373	478	101	1272	0	953	179	41	49	0	25	0	25	0
경상북도	봉화군	춘양면	계	4012	2974	1038	287	2687	0	2127	286	73	87	0	60	0	54	0
경상북도	봉화군	소천면	계	2045	1436	609	145	1291	0	941	184	36	45	0	24	0	61	0
경상북도	봉화군	석포면	계	1730	1186	544	50	1136	0	842	179	22	36	0	34	0	23	0
경상북도	봉화군	재산면	계	1391	1115	276	62	1053	0	757	143	36	36	0	53	0	28	0
경상북도	봉화군	명호면	계	1892	1445	447	74	1371	0	1062	166	26	51	0	36	0	30	0
경상북도	봉화군	상운면	계	1642	1300	342	98	1202	0	907	163	31	35	0	21	0	45	0
경상북도	울진군	관외사전투표		2866	2864	2	101	2763	0	1751	719	127	78	0	39	0	49	0
경상북도	울진군	거소우편투표		742	703	39	40	663	0	577	58	5	7	0	8	0	8	0
경상북도	울진군	울진읍	계	10244	7453	2791	412	7041	0	5086	1353	189	149	0	98	0	166	0
경상북도	울진군	평해읍	계	2605	1998	607	124	1874	0	1551	174	32	36	0	16	0	65	0
경상북도	울진군	북면	계	5295	3666	1629	226	3440	0	2143	876	109	81	0	64	0	167	0
경상북도	울진군	서면	계	1304	1002	302	34	968	0	804	79	14	31	0	15	0	25	0
경상북도	울진군	근남면	계	2405	1748	657	95	1653	0	1283	174	47	41	0	57	0	51	0
경상북도	울진군	원남면	계	1880	1407	473	83	1324	0	1038	133	28	23	0	53	0	49	0
경상북도	울진군	기성면	계	2327	1710	617	117	1593	0	1316	148	33	30	0	23	0	43	0
경상북도	울진군	온정면	계	1658	1291	367	78	1213	0	1003	98	31	26	0	20	0	35	0
경상북도	울진군	죽변면	계	5854	3899	1955	231	3668	0	2813	511	68	77	0	95	0	104	0
경상북도	울진군	후포면	계	6447	4547	1900	204	4343	0	3586	413	85	109	0	47	0	103	0
경상남도	창원시의창구	관외사전투표		9799	9798	1	210	9588	0	4408	3785	684	286	0	262	163	0	0
경상남도	창원시의창구	거소우편투표		615	596	19	39	557	0	349	121	31	16	0	22	18	0	0
경상남도	창원시의창구	동읍	계	17718	10141	7577	316	9825	0	5498	3202	496	244	0	247	138	0	0
경상남도	창원시의창구	북면	계	12361	6633	5728	240	6393	0	3994	1778	266	139	0	140	76	0	0
경상남도	창원시의창구	대산면	계	6292	3406	2886	175	3231	0	2047	796	126	93	0	114	55	0	0
경상남도	창원시의창구	의창동	계	29820	16039	13781	390	15649	0	9259	4609	792	312	0	500	177	0	0
경상남도	창원시의창구	팔용동	계	32077	18317	13760	315	18002	0	9225	5874	1519	374	0	820	190	0	0
경상남도	창원시의창구	명곡동	계	40685	21425	19260	424	21001	0	11727	6384	1490	454	0	711	235	0	0
경상남도	창원시의창구	봉림동	계	29662	14815	14847	261	14554	0	7847	4700	1088	302	0	444	173	0	0
경상남도	창원시의창구	용지동	계	25494	13600	11894	223	13377	0	6843	4603	946	326	0	476	183	0	0
경상남도	창원시성산구	관외사전투표		9792	9789	3	186	9603	0	4176	3881	818	284	0	333	111	0	0
경상남도	창원시성산구	거소우편투표		573	557	16	40	517	0	287	139	37	13	0	30	11	0	0
경상남도	창원시성산구	반송동	계	34902	21689	13213	366	21323	0	10610	7289	2018	599	0	679	128	0	0
경상남도	창원시성산구	중앙동	계	18040	8263	9777	116	8147	0	3993	2732	746	218	0	410	48	0	0
경상남도	창원시성산구	상남동	계	23478	13668	9810	201	13467	0	6616	4783	819	387	0	768	94	0	0
경상남도	창원시성산구	사파동	계	40246	23316	16930	407	22909	0	10373	8002	1893	668	0	1787	186	0	0
경상남도	창원시성산구	가음정동	계	30511	17717	12794	247	17470	0	7977	5757	1947	710	0	952	127	0	0
경상남도	창원시성산구	성주동	계	20533	12221	8312	158	12063	0	5329	4202	1198	665	0	583	86	0	0
경상남도	창원시성산구	웅남동	계	7648	4584	3064	54	4530	0	2382	1325	464	145	0	187	27	0	0
경상남도	창원시마산합포구	관외사전투표		7345	7344	1	139	7205	0	3843	2515	381	178	0	171	117	0	0
경상남도	창원시마산합포구	거소우편투표		493	469	24	29	440	0	281	92	17	12	0	17	21	0	0
경상남도	창원시마산합포구	구산면	계	4350	2559	1791	94	2465	0	1871	385	73	39	0	52	45	0	0
경상남도	창원시마산합포구	진동면	계	8859	4993	3866	129	4864	0	3251	1156	171	103	0	107	76	0	0
경상남도	창원시마산합포구	진북면	계	3581	1996	1585	58	1938	0	1416	331	58	29	0	58	46	0	0
경상남도	창원시마산합포구	진전면	계	3819	2295	1524	82	2213	0	1675	315	63	58	0	56	46	0	0
경상남도	창원시마산합포구	현동	계	1842	1070	772	26	1044	0	835	139	31	14	0	16	9	0	0
경상남도	창원시마산합포구	가포동	계	1221	675	546	14	661	0	473	141	21	7	0	15	4	0	0
경상남도	창원시마산합포구	월영동	계	24157	13579	10578	227	13352	0	8149	3816	561	313	0	355	158	0	0
경상남도	창원시마산합포구	문화동	계	10806	6021	4785	112	5909	0	4043	1375	187	118	0	104	82	0	0
경상남도	창원시마산합포구	반월동	계	7013	4146	2867	73	4073	0	2691	1030	155	75	0	78	44	0	0
경상남도	창원시마산합포구	중앙동	계	7070	4176	2894	74	4102	0	2664	1035	159	95	0	96	53	0	0
경상남도	창원시마산합포구	완월동	계	9192	5047	4145	162	4885	0	3267	1153	227	81	0	103	54	0	0
경상남도	창원시마산합포구	자산동	계	10804	6073	4731	151	5922	0	4060	1339	232	110	0	101	80	0	0
경상남도	창원시마산합포구	동서동	계	9269	5016	4253	102	4914	0	3444	1066	175	104	0	75	50	0	0
경상남도	창원시마산합포구	성호동	계	3911	2020	1891	64	1956	0	1430	366	61	32	0	43	24	0	0
경상남도	창원시마산합포구	교방동	계	8888	4961	3927	89	4872	0	3239	1181	169	109	0	103	71	0	0
경상남도	창원시마산합포구	노산동	계	6284	3547	2737	67	3480	0	2465	718	107	69	0	72	49	0	0
경상남도	창원시마산합포구	오동동	계	4425	2043	2382	33	2010	0	1502	354	82	27	0	25	20	0	0
경상남도	창원시마산합포구	합포동	계	6670	3545	3125	69	3476	0	2553	679	89	71	0	46	38	0	0
경상남도	창원시마산합포구	산호동	계	11801	6141	5660	128	6013	0	4109	1346	249	90	0	122	97	0	0
경상남도	창원시마산회원구	관외사전투표		7423	7419	4	126	7293	0	3653	2716	457	183	0	193	91	0	0
경상남도	창원시마산회원구	거소우편투표		499	477	22	17	460	0	284	123	22	10	0	12	9	0	0
경상남도	창원시마산회원구	내서읍	계	51704	30347	21357	519	29828	0	17272	9033	1992	617	0	733	181	0	0
경상남도	창원시마산회원구	회원1동	계	10593	5787	4806	117	5670	0	4055	1229	154	80	0	103	49	0	0
경상남도	창원시마산회원구	회원2동	계	11749	6178	5571	110	6068	0	4273	1375	168	99	0	112	41	0	0
경상남도	창원시마산회원구	석전1동	계	6745	3735	3010	92	3643	0	2514	857	108	68	0	72	24	0	0
경상남도	창원시마산회원구	석전2동	계	8197	4428	3769	83	4345	0	2920	1081	136	71	0	106	31	0	0
경상남도	창원시마산회원구	회성동	계	6727	3759	2968	79	3680	0	2610	784	114	77	0	74	21	0	0
경상남도	창원시마산회원구	양덕1동	계	10879	5814	5065	116	5698	0	3670	1461	271	86	0	160	50	0	0
경상남도	창원시마산회원구	양덕2동	계	21988	13095	8893	194	12901	0	7808	3653	634	280	0	444	82	0	0
경상남도	창원시마산회원구	합성1동	계	8433	4435	3998	81	4354	0	2888	1130	141	82	0	85	28	0	0
경상남도	창원시마산회원구	합성2동	계	8634	4431	4203	86	4345	0	2916	1037	183	60	0	126	23	0	0
경상남도	창원시마산회원구	구암1동	계	9475	5234	4241	111	5123	0	3225	1326	257	75	0	193	47	0	0
경상남도	창원시마산회원구	구암2동	계	9163	5229	3934	98	5131	0	3117	1489	228	83	0	191	23	0	0
경상남도	창원시마산회원구	봉암동	계	3709	1799	1910	27	1772	0	1173	412	92	33	0	53	9	0	0
경상남도	창원시진해구	관외사전투표		6151	6150	1	100	6050	0	3165	2192	319	146	0	146	82	0	0
경상남도	창원시진해구	거소우편투표		2788	2745	43	191	2554	0	1655	633	85	56	0	58	67	0	0
경상남도	창원시진해구	중앙동	계	5287	2892	2395	49	2843	0	1825	821	82	64	0	36	15	0	0
경상남도	창원시진해구	태평동	계	5227	2883	2344	57	2826	0	1934	685	94	44	0	45	24	0	0
경상남도	창원시진해구	충무동	계	3609	1870	1739	34	1836	0	1378	360	45	20	0	26	7	0	0
경상남도	창원시진해구	여좌동	계	9510	5294	4216	114	5180	0	3653	1135	161	100	0	95	36	0	0
경상남도	창원시진해구	태백동	계	5637	2970	2667	64	2906	0	2136	565	99	37	0	52	17	0	0
경상남도	창원시진해구	경화동	계	8491	4724	3767	94	4630	0	2907	1261	198	116	0	118	30	0	0
경상남도	창원시진해구	병암동	계	6801	3601	3200	59	3542	0	2188	961	162	92	0	108	31	0	0
경상남도	창원시진해구	석동	계	13640	7691	5949	115	7576	0	3916	2687	412	267	0	230	64	0	0
경상남도	창원시진해구	이동	계	9327	4528	4799	91	4437	0	2828	1176	199	96	0	104	34	0	0
경상남도	창원시진해구	자은동	계	8979	4944	4035	108	4836	0	2772	1484	296	118	0	127	39	0	0
경상남도	창원시진해구	덕산동	계	7633	3972	3661	69	3903	0	2431	1083	201	69	0	93	26	0	0
경상남도	창원시진해구	풍호동	계	12811	7768	5043	116	7652	0	4415	2450	404	172	0	161	50	0	0
경상남도	창원시진해구	웅천동	계	3706	2255	1451	114	2141	0	1623	314	68	35	0	79	22	0	0
경상남도	창원시진해구	웅동1동	계	6145	3079	3066	66	3013	0	1755	908	184	70	0	59	37	0	0
경상남도	창원시진해구	웅동2동	계	23544	10545	12999	189	10356	0	5091	4023	530	341	0	293	78	0	0
경상남도	진주시	관외사전투표		15896	15878	18	315	15563	0	7908	5333	1308	437	0	282	295	0	0
경상남도	진주시	거소우편투표		825	743	82	39	704	0	429	166	56	17	0	20	16	0	0
경상남도	진주시	문산읍	계	7169	4164	3005	111	4053	0	2627	939	253	129	0	54	51	0	0
경상남도	진주시	내동면	계	3143	2095	1048	42	2053	0	1283	500	126	74	0	29	41	0	0
경상남도	진주시	정촌면	계	2588	1727	861	53	1674	0	1191	287	81	50	0	29	36	0	0
경상남도	진주시	금곡면	계	2217	1498	719	59	1439	0	1023	210	97	54	0	42	13	0	0
경상남도	진주시	진성면	계	1907	1250	657	62	1188	0	851	175	77	26	0	35	24	0	0
경상남도	진주시	일반성면	계	2527	1739	788	84	1655	0	1116	296	94	31	0	82	36	0	0
경상남도	진주시	이반성면	계	1551	1105	446	73	1032	0	694	154	60	59	0	44	21	0	0
경상남도	진주시	사봉면	계	1469	945	524	38	907	0	637	136	49	26	0	42	17	0	0
경상남도	진주시	지수면	계	1460	893	567	36	857	0	598	122	79	14	0	18	26	0	0
경상남도	진주시	대곡면	계	3426	1932	1494	82	1850	0	1298	254	168	51	0	48	31	0	0
경상남도	진주시	금산면	계	15959	9753	6206	216	9537	0	5379	2741	906	240	0	110	161	0	0
경상남도	진주시	집현면	계	4096	2366	1730	78	2288	0	1512	462	165	35	0	74	40	0	0
경상남도	진주시	미천면	계	1631	988	643	40	948	0	677	117	80	18	0	27	29	0	0
경상남도	진주시	명석면	계	3846	2297	1549	69	2228	0	1665	339	113	40	0	35	36	0	0
경상남도	진주시	대평면	계	1044	694	350	32	662	0	497	107	21	14	0	12	11	0	0
경상남도	진주시	수곡면	계	2099	1313	786	51	1262	0	911	191	67	20	0	38	35	0	0
경상남도	진주시	천전동	계	25109	15414	9695	411	15003	0	9992	3403	838	347	0	183	240	0	0
경상남도	진주시	성북동	계	10522	5487	5035	112	5375	0	3924	1007	246	79	0	58	61	0	0
경상남도	진주시	중앙동	계	12255	6703	5552	314	6389	0	4875	984	262	95	0	89	84	0	0
경상남도	진주시	상봉동	계	13733	7616	6117	218	7398	0	5294	1398	362	138	0	104	102	0	0
경상남도	진주시	상대1동	계	11037	6007	5030	163	5844	0	3953	1243	369	118	0	90	71	0	0
경상남도	진주시	상대2동	계	9141	5043	4098	112	4931	0	3314	1047	303	111	0	83	73	0	0
경상남도	진주시	하대1동	계	11157	6276	4881	128	6148	0	3903	1533	391	147	0	104	70	0	0
경상남도	진주시	하대2동	계	9383	5570	3813	118	5452	0	3552	1252	348	120	0	97	83	0	0
경상남도	진주시	상평동	계	10762	6176	4586	128	6048	0	4087	1301	341	161	0	85	73	0	0
경상남도	진주시	초장동	계	10593	7072	3521	180	6892	0	4154	1794	550	144	0	115	135	0	0
경상남도	진주시	평거동	계	20045	12083	7962	218	11865	0	6932	3552	718	296	0	166	201	0	0
경상남도	진주시	신안동	계	10843	6536	4307	135	6401	0	4204	1546	329	154	0	66	102	0	0
경상남도	진주시	이현동	계	11093	6502	4591	128	6374	0	4176	1518	330	141	0	87	122	0	0
경상남도	진주시	판문동	계	10688	6386	4302	138	6248	0	3716	1830	381	137	0	83	101	0	0
경상남도	진주시	가호동	계	16336	9481	6855	220	9261	0	5245	2698	779	256	0	138	145	0	0
경상남도	진주시	충무공동	계	2477	1531	946	13	1518	0	678	563	187	51	0	14	25	0	0
경상남도	통영시	관외사전투표		6574	6569	5	122	6447	0	3479	2288	345	129	0	134	72	0	0
경상남도	통영시	거소우편투표		614	531	83	26	505	0	274	142	30	20	0	18	21	0	0
경상남도	통영시	산양읍	계	4486	2706	1780	121	2585	0	2000	351	50	75	0	43	66	0	0
경상남도	통영시	용남면	계	8408	4870	3538	123	4747	0	3246	1057	207	80	0	94	63	0	0
경상남도	통영시	도산면	계	2763	1874	889	90	1784	0	1338	256	68	44	0	32	46	0	0
경상남도	통영시	광도면	계	18541	10334	8207	280	10054	0	5911	3044	583	159	0	250	107	0	0
경상남도	통영시	욕지면	계	1701	1157	544	58	1099	0	901	109	30	26	0	10	23	0	0
경상남도	통영시	한산면	계	1879	1296	583	64	1232	0	1040	83	21	40	0	12	36	0	0
경상남도	통영시	사량면	계	1379	917	462	52	865	0	660	120	22	20	0	9	34	0	0
경상남도	통영시	도천동	계	8969	5063	3906	137	4926	0	3580	949	161	81	0	95	60	0	0
경상남도	통영시	명정동	계	3488	2039	1449	75	1964	0	1547	289	42	23	0	43	20	0	0
경상남도	통영시	중앙동	계	4858	2791	2067	91	2700	0	2058	431	81	44	0	43	43	0	0
경상남도	통영시	정량동	계	8681	4823	3858	121	4702	0	3489	843	138	78	0	94	60	0	0
경상남도	통영시	북신동	계	8542	5119	3423	146	4973	0	3742	925	129	62	0	78	37	0	0
경상남도	통영시	무전동	계	10730	6335	4395	153	6182	0	4047	1619	270	79	0	118	49	0	0
경상남도	통영시	미수동	계	9496	5434	4062	135	5299	0	3506	1332	224	74	0	110	53	0	0
경상남도	통영시	봉평동	계	10452	5592	4860	154	5438	0	3730	1161	229	88	0	149	81	0	0
경상남도	고성군	관외사전투표		2786	2786	0	75	2711	0	1386	1036	128	77	0	47	37	0	0
경상남도	고성군	거소우편투표		334	318	16	31	287	0	200	63	7	7	0	5	5	0	0
경상남도	고성군	고성읍	계	19746	12545	7201	601	11944	0	7308	3474	432	232	0	351	147	0	0
경상남도	고성군	삼산면	계	1576	1018	558	65	953	0	644	197	26	21	0	47	18	0	0
경상남도	고성군	하일면	계	1702	1172	530	74	1098	0	835	158	33	31	0	20	21	0	0
경상남도	고성군	하이면	계	2367	1634	733	65	1569	0	1162	255	50	27	0	44	31	0	0
경상남도	고성군	상리면	계	1482	1007	475	34	973	0	675	178	44	34	0	26	16	0	0
경상남도	고성군	대가면	계	1457	1027	430	44	983	0	652	185	43	50	0	27	26	0	0
경상남도	고성군	영현면	계	833	583	250	20	563	0	380	97	28	25	0	19	14	0	0
경상남도	고성군	영오면	계	1331	951	380	40	911	0	604	165	36	62	0	25	19	0	0
경상남도	고성군	개천면	계	1040	780	260	36	744	0	486	164	36	27	0	20	11	0	0
경상남도	고성군	구만면	계	957	635	322	34	601	0	342	154	25	33	0	31	16	0	0
경상남도	고성군	회화면	계	3329	2091	1238	103	1988	0	1459	356	48	45	0	53	27	0	0
경상남도	고성군	마암면	계	1609	1026	583	74	952	0	601	171	72	51	0	26	31	0	0
경상남도	고성군	동해면	계	3130	1919	1211	98	1821	0	1280	332	80	51	0	43	35	0	0
경상남도	고성군	거류면	계	4208	2528	1680	102	2426	0	1703	497	85	57	0	47	37	0	0
경상남도	사천시	관외사전투표		6267	6264	3	142	6122	0	3222	2030	454	213	0	115	88	0	0
경상남도	사천시	거소우편투표		528	491	37	22	469	0	309	98	22	20	0	10	10	0	0
경상남도	사천시	사천읍	계	13836	8128	5708	247	7881	0	4873	1976	517	284	0	164	67	0	0
경상남도	사천시	정동면	계	7674	4837	2837	196	4641	0	2692	1234	380	163	0	125	47	0	0
경상남도	사천시	사남면	계	9617	6185	3432	203	5982	0	3255	1866	464	214	0	126	57	0	0
경상남도	사천시	용현면	계	6188	3668	2520	191	3477	0	2249	775	216	142	0	57	38	0	0
경상남도	사천시	축동면	계	1711	1173	538	44	1129	0	861	161	40	32	0	16	19	0	0
경상남도	사천시	곤양면	계	3363	2407	956	123	2284	0	1570	367	112	112	0	50	73	0	0
경상남도	사천시	곤명면	계	2710	1921	789	108	1813	0	1289	257	76	57	0	97	37	0	0
경상남도	사천시	서포면	계	3474	2468	1006	145	2323	0	1704	292	109	71	0	41	106	0	0
경상남도	사천시	동서동	계	6870	4482	2388	191	4291	0	3431	535	147	99	0	46	33	0	0
경상남도	사천시	선구동	계	4892	3164	1728	118	3046	0	2217	531	148	81	0	45	24	0	0
경상남도	사천시	동서금동	계	4780	3070	1710	143	2927	0	2289	420	120	48	0	22	28	0	0
경상남도	사천시	벌용동	계	12310	8231	4079	318	7913	0	5418	1554	544	185	0	133	79	0	0
경상남도	사천시	향촌동	계	5431	3664	1767	175	3489	0	2493	602	211	91	0	63	29	0	0
경상남도	사천시	남양동	계	4599	3149	1450	133	3016	0	2108	516	186	103	0	71	32	0	0
경상남도	김해시	관외사전투표		17477	17459	18	301	17158	0	7398	7761	968	497	0	324	210	0	0
경상남도	김해시	거소우편투표		1108	1046	62	51	995	0	565	305	61	26	0	30	8	0	0
경상남도	김해시	진영읍	계	30562	15803	14759	295	15508	0	6906	7217	658	375	0	232	120	0	0
경상남도	김해시	주촌면	계	3000	1526	1474	49	1477	0	939	450	52	19	0	10	7	0	0
경상남도	김해시	진례면	계	6433	3411	3022	114	3297	0	2098	979	114	45	0	40	21	0	0
경상남도	김해시	한림면	계	7832	3976	3856	180	3796	0	2151	1348	166	53	0	48	30	0	0
경상남도	김해시	생림면	계	3691	2055	1636	142	1913	0	1231	561	63	23	0	18	17	0	0
경상남도	김해시	상동면	계	2952	1567	1385	92	1475	0	867	515	42	30	0	14	7	0	0
경상남도	김해시	대동면	계	6506	3644	2862	99	3545	0	2308	1012	113	51	0	42	19	0	0
경상남도	김해시	동상동	계	8072	4089	3983	91	3998	0	2402	1299	152	82	0	38	25	0	0
경상남도	김해시	회현동	계	7182	3733	3449	73	3660	0	2215	1178	128	74	0	37	28	0	0
경상남도	김해시	부원동	계	6520	3027	3493	53	2974	0	1801	980	98	41	0	37	17	0	0
경상남도	김해시	내외동	계	62097	31272	30825	552	30720	0	14981	12773	1752	685	0	355	174	0	0
경상남도	김해시	북부동	계	58722	31546	27176	875	30671	0	14260	13449	1709	753	0	320	180	0	0
경상남도	김해시	칠산서부동	계	7909	4018	3891	100	3918	0	2190	1394	195	74	0	47	18	0	0
경상남도	김해시	활천동	계	34921	16547	18374	275	16272	0	8566	6501	588	347	0	176	94	0	0
경상남도	김해시	삼안동	계	32103	15523	16580	242	15281	0	8154	5988	568	300	0	183	88	0	0
경상남도	김해시	불암동	계	6645	3504	3141	68	3436	0	1858	1325	137	51	0	42	23	0	0
경상남도	김해시	장유1동	계	36993	19491	17502	489	19002	0	8680	8278	1062	519	0	327	136	0	0
경상남도	김해시	장유2동	계	23405	12701	10704	318	12383	0	5454	5470	738	419	0	236	66	0	0
경상남도	김해시	장유3동	계	34163	19187	14976	212	18975	0	7630	9130	1102	644	0	355	114	0	0
경상남도	밀양시	관외사전투표		5326	5324	2	140	5184	0	2636	1976	293	94	0	84	101	0	0
경상남도	밀양시	거소우편투표		479	455	24	42	413	0	255	85	20	14	0	16	23	0	0
경상남도	밀양시	삼랑진읍	계	6280	3754	2526	173	3581	0	2506	703	105	101	0	58	108	0	0
경상남도	밀양시	하남읍	계	6918	4258	2660	174	4084	0	2935	791	102	97	0	87	72	0	0
경상남도	밀양시	부북면	계	5105	3053	2052	99	2954	0	2119	557	76	96	0	49	57	0	0
경상남도	밀양시	상동면	계	2670	1600	1070	60	1540	0	1004	340	46	60	0	31	59	0	0
경상남도	밀양시	산외면	계	2483	1572	911	62	1510	0	1087	287	52	43	0	23	18	0	0
경상남도	밀양시	산내면	계	3328	2034	1294	100	1934	0	1469	315	57	42	0	26	25	0	0
경상남도	밀양시	단장면	계	3682	2290	1392	113	2177	0	1502	408	101	73	0	42	51	0	0
경상남도	밀양시	상남면	계	8022	4859	3163	243	4616	0	3037	1111	170	152	0	71	75	0	0
경상남도	밀양시	초동면	계	3063	1949	1114	77	1872	0	1372	308	50	53	0	53	36	0	0
경상남도	밀양시	무안면	계	4833	3014	1819	151	2863	0	2048	517	87	106	0	51	54	0	0
경상남도	밀양시	청도면	계	1634	1172	462	60	1112	0	792	186	33	42	0	40	19	0	0
경상남도	밀양시	내일동	계	3051	1779	1272	56	1723	0	1310	293	51	31	0	21	17	0	0
경상남도	밀양시	내이동	계	9472	5367	4105	157	5210	0	3494	1302	181	93	0	59	81	0	0
경상남도	밀양시	교동	계	4967	2920	2047	76	2844	0	1840	762	112	47	0	47	36	0	0
경상남도	밀양시	삼문동	계	13780	8614	5166	210	8404	0	5217	2458	388	116	0	96	129	0	0
경상남도	밀양시	가곡동	계	6491	3939	2552	105	3834	0	2579	901	128	105	0	61	60	0	0
경상남도	거제시	관외사전투표		8304	8304	0	171	8133	0	3640	3093	472	211	0	611	106	0	0
경상남도	거제시	거소우편투표		678	644	34	25	619	0	370	139	30	13	0	50	17	0	0
경상남도	거제시	일운면	계	5861	3032	2829	92	2940	0	1910	614	108	77	0	197	34	0	0
경상남도	거제시	동부면	계	3060	1888	1172	72	1816	0	1388	253	37	39	0	70	29	0	0
경상남도	거제시	남부면	계	1546	954	592	48	906	0	687	133	19	25	0	30	12	0	0
경상남도	거제시	거제면	계	5769	3512	2257	181	3331	0	2343	579	131	110	0	125	43	0	0
경상남도	거제시	둔덕면	계	2909	1710	1199	88	1622	0	1236	234	44	30	0	54	24	0	0
경상남도	거제시	사등면	계	8619	4622	3997	200	4422	0	3083	897	132	90	0	169	51	0	0
경상남도	거제시	연초면	계	8355	3766	4589	109	3657	0	2187	972	164	68	0	241	25	0	0
경상남도	거제시	하청면	계	4169	2432	1737	132	2300	0	1700	360	83	41	0	91	25	0	0
경상남도	거제시	장목면	계	4439	2558	1881	138	2420	0	1873	300	65	49	0	103	30	0	0
경상남도	거제시	장승포동	계	3280	1613	1667	86	1527	0	900	374	60	50	0	129	14	0	0
경상남도	거제시	마전동	계	4173	1892	2281	34	1858	0	631	677	140	39	0	358	13	0	0
경상남도	거제시	능포동	계	9635	5133	4502	115	5018	0	2179	1586	305	138	0	774	36	0	0
경상남도	거제시	아주동	계	11779	5797	5982	71	5726	0	1841	2239	446	183	0	991	26	0	0
경상남도	거제시	옥포1동	계	6602	3047	3555	53	2994	0	1417	904	130	68	0	462	13	0	0
경상남도	거제시	옥포2동	계	20654	9894	10760	159	9735	0	4312	2893	453	194	0	1846	37	0	0
경상남도	거제시	장평동	계	19699	9145	10554	174	8971	0	4419	3228	533	156	0	561	74	0	0
경상남도	거제시	고현동	계	28514	14938	13576	336	14602	0	7732	4661	832	281	0	967	129	0	0
경상남도	거제시	상문동	계	15168	8318	6850	165	8153	0	3527	3221	580	128	0	632	65	0	0
경상남도	거제시	수양동	계	11359	6744	4615	112	6632	0	3008	2524	357	148	0	556	39	0	0
경상남도	의령군	관외사전투표		2393	2392	1	77	2315	0	1259	733	158	58	0	75	32	0	0
경상남도	의령군	거소우편투표		302	252	50	9	243	0	176	38	14	3	0	10	2	0	0
경상남도	의령군	의령읍	계	7044	5175	1869	230	4945	0	3113	1131	271	144	0	190	96	0	0
경상남도	의령군	가례면	계	1633	1165	468	111	1054	0	677	157	52	34	0	89	45	0	0
경상남도	의령군	칠곡면	계	1000	766	234	46	720	0	466	131	28	31	0	47	17	0	0
경상남도	의령군	대의면	계	933	765	168	56	709	0	469	96	34	35	0	56	19	0	0
경상남도	의령군	화정면	계	1402	1114	288	69	1045	0	742	153	30	33	0	54	33	0	0
경상남도	의령군	용덕면	계	1509	1113	396	70	1043	0	657	140	65	77	0	67	37	0	0
경상남도	의령군	정곡면	계	1340	928	412	49	879	0	581	139	38	40	0	57	24	0	0
경상남도	의령군	지정면	계	1742	1287	455	67	1220	0	889	139	72	33	0	65	22	0	0
경상남도	의령군	낙서면	계	727	584	143	41	543	0	363	62	23	36	0	35	24	0	0
경상남도	의령군	부림면	계	2736	2151	585	155	1996	0	1367	242	124	84	0	127	52	0	0
경상남도	의령군	봉수면	계	937	722	215	50	672	0	454	72	43	36	0	48	19	0	0
경상남도	의령군	궁류면	계	1141	825	316	53	772	0	542	90	30	31	0	52	27	0	0
경상남도	의령군	유곡면	계	1142	872	270	45	827	0	585	101	22	35	0	54	30	0	0
경상남도	함안군	관외사전투표		3262	3260	2	81	3179	0	1653	1096	228	61	0	86	55	0	0
경상남도	함안군	거소우편투표		301	284	17	12	272	0	181	46	12	14	0	15	4	0	0
경상남도	함안군	가야읍	계	14005	8989	5016	333	8656	0	5555	1923	609	164	0	249	156	0	0
경상남도	함안군	함안면	계	2288	1510	778	67	1443	0	1042	210	67	47	0	47	30	0	0
경상남도	함안군	군북면	계	5425	3620	1805	189	3431	0	2434	471	156	131	0	115	124	0	0
경상남도	함안군	법수면	계	2802	1891	911	93	1798	0	1239	292	86	53	0	78	50	0	0
경상남도	함안군	대산면	계	3457	2283	1174	121	2162	0	1496	315	153	87	0	71	40	0	0
경상남도	함안군	칠서면	계	4818	3028	1790	125	2903	0	2012	575	140	73	0	64	39	0	0
경상남도	함안군	칠북면	계	1870	1415	455	67	1348	0	1045	199	33	33	0	21	17	0	0
경상남도	함안군	칠원면	계	14271	9240	5031	220	9020	0	5530	2638	360	182	0	199	111	0	0
경상남도	함안군	산인면	계	2479	1525	954	58	1467	0	985	292	78	47	0	37	28	0	0
경상남도	함안군	여항면	계	727	531	196	46	485	0	337	69	47	12	0	12	8	0	0
경상남도	창녕군	관외사전투표		2940	2940	0	48	2892	0	1585	1057	115	60	0	43	32	0	0
경상남도	창녕군	거소우편투표		317	295	22	34	261	0	163	59	14	9	0	10	6	0	0
경상남도	창녕군	창녕읍	계	13073	7343	5730	253	7090	0	4815	1744	184	107	0	159	81	0	0
경상남도	창녕군	남지읍	계	9740	6114	3626	251	5863	0	4254	1160	156	102	0	133	58	0	0
경상남도	창녕군	고암면	계	1818	1014	804	35	979	0	759	151	21	10	0	23	15	0	0
경상남도	창녕군	성산면	계	1428	835	593	34	801	0	643	110	16	3	0	17	12	0	0
경상남도	창녕군	대합면	계	3514	1850	1664	65	1785	0	1386	279	44	21	0	18	37	0	0
경상남도	창녕군	이방면	계	2269	1277	992	46	1231	0	992	170	25	10	0	21	13	0	0
경상남도	창녕군	유어면	계	1702	1038	664	51	987	0	711	176	33	20	0	34	13	0	0
경상남도	창녕군	대지면	계	2082	1206	876	46	1160	0	858	218	30	20	0	21	13	0	0
경상남도	창녕군	계성면	계	2189	1226	963	47	1179	0	887	198	32	31	0	23	8	0	0
경상남도	창녕군	영산면	계	4885	2816	2069	80	2736	0	1955	591	74	47	0	43	26	0	0
경상남도	창녕군	장마면	계	1695	1032	663	72	960	0	677	180	31	35	0	19	18	0	0
경상남도	창녕군	도천면	계	2369	1359	1010	36	1323	0	968	212	47	45	0	34	17	0	0
경상남도	창녕군	길곡면	계	1370	929	441	58	871	0	610	155	30	39	0	25	12	0	0
경상남도	창녕군	부곡면	계	3223	2129	1094	105	2024	0	1411	360	64	109	0	54	26	0	0
경상남도	양산시	관외사전투표		9317	9314	3	183	9131	0	4297	3820	498	215	0	172	129	0	0
경상남도	양산시	거소우편투표		718	691	27	51	640	0	398	155	32	21	0	20	14	0	0
경상남도	양산시	물금읍	계	40228	21377	18851	464	20913	0	10749	8225	1129	312	0	346	152	0	0
경상남도	양산시	동면	계	16230	8335	7895	174	8161	0	4532	2964	341	148	0	126	50	0	0
경상남도	양산시	원동면	계	3107	1893	1214	89	1804	0	1312	358	52	29	0	39	14	0	0
경상남도	양산시	상북면	계	12793	6770	6023	172	6598	0	4258	1777	321	104	0	93	45	0	0
경상남도	양산시	하북면	계	7976	4586	3390	148	4438	0	3139	966	149	73	0	59	52	0	0
경상남도	양산시	중앙동	계	10508	5098	5410	134	4964	0	3257	1363	163	65	0	89	27	0	0
경상남도	양산시	양주동	계	26462	15329	11133	271	15058	0	7344	6287	837	233	0	256	101	0	0
경상남도	양산시	삼성동	계	18116	9013	9103	183	8830	0	5028	3044	386	116	0	188	68	0	0
경상남도	양산시	강서동	계	7404	3839	3565	87	3752	0	2035	1416	160	46	0	77	18	0	0
경상남도	양산시	서창동	계	21025	10290	10735	453	9837	0	5561	3310	485	170	0	225	86	0	0
경상남도	양산시	소주동	계	15040	7090	7950	260	6830	0	4172	2082	261	106	0	146	63	0	0
경상남도	양산시	평산동	계	23585	11452	12133	176	11276	0	6719	3703	462	140	0	191	61	0	0
경상남도	양산시	덕계동	계	9642	4741	4901	69	4672	0	2821	1510	168	69	0	74	30	0	0
경상남도	하동군	관외사전투표		3958	3958	0	129	3829	0	1913	1442	223	107	0	78	66	0	0
경상남도	하동군	거소우편투표		823	744	79	64	680	0	405	125	59	38	0	30	23	0	0
경상남도	하동군	하동읍	계	7973	5973	2000	282	5691	0	3356	1703	232	177	0	164	59	0	0
경상남도	하동군	화개면	계	2683	2014	669	115	1899	0	1154	528	84	49	0	53	31	0	0
경상남도	하동군	악양면	계	3018	2272	746	137	2135	0	1171	479	126	91	0	170	98	0	0
경상남도	하동군	적량면	계	1760	1420	340	129	1291	0	711	303	62	117	0	82	16	0	0
경상남도	하동군	횡천면	계	1640	1283	357	115	1168	0	714	242	42	94	0	45	31	0	0
경상남도	하동군	고전면	계	2033	1528	505	115	1413	0	894	313	80	55	0	49	22	0	0
경상남도	하동군	금남면	계	3260	2367	893	138	2229	0	1471	444	93	92	0	89	40	0	0
경상남도	하동군	금성면	계	2774	2050	724	114	1936	0	1203	477	89	66	0	72	29	0	0
경상남도	하동군	진교면	계	5247	4063	1184	277	3786	0	2338	899	182	155	0	140	72	0	0
경상남도	하동군	양보면	계	1605	1283	322	104	1179	0	784	226	41	57	0	47	24	0	0
경상남도	하동군	북천면	계	1539	1159	380	88	1071	0	735	190	40	59	0	32	15	0	0
경상남도	하동군	청암면	계	1199	911	288	63	848	0	536	200	39	25	0	29	19	0	0
경상남도	하동군	옥종면	계	3662	2831	831	203	2628	0	1674	507	113	150	0	115	69	0	0
경상남도	남해군	관외사전투표		2913	2912	1	87	2825	0	1396	1076	191	66	0	63	33	0	0
경상남도	남해군	거소우편투표		391	353	38	38	315	0	204	68	15	11	0	11	6	0	0
경상남도	남해군	남해읍	계	9969	7377	2592	442	6935	0	4347	1696	381	178	0	181	152	0	0
경상남도	남해군	이동면	계	3655	2768	887	147	2621	0	1958	394	88	73	0	58	50	0	0
경상남도	남해군	상주면	계	1486	1081	405	73	1008	0	728	160	31	27	0	24	38	0	0
경상남도	남해군	삼동면	계	3512	2582	930	138	2444	0	1598	461	108	92	0	92	93	0	0
경상남도	남해군	미조면	계	2178	1531	647	63	1468	0	1071	243	36	42	0	35	41	0	0
경상남도	남해군	남면	계	3469	2468	1001	201	2267	0	1504	341	92	147	0	90	93	0	0
경상남도	남해군	서면	계	2553	1937	616	145	1792	0	1164	304	87	108	0	65	64	0	0
경상남도	남해군	고현면	계	3415	2566	849	185	2381	0	1498	513	131	97	0	67	75	0	0
경상남도	남해군	설천면	계	2721	2101	620	152	1949	0	1242	385	95	109	0	53	65	0	0
경상남도	남해군	창선면	계	5069	3579	1490	180	3399	0	2534	407	97	171	0	85	105	0	0
경상남도	함양군	관외사전투표		2309	2309	0	75	2234	0	1253	694	119	77	0	53	38	0	0
경상남도	함양군	거소우편투표		550	518	32	61	457	0	311	56	21	34	0	17	18	0	0
경상남도	함양군	함양읍	계	13898	9986	3912	425	9561	0	6390	2047	482	261	0	233	148	0	0
경상남도	함양군	마천면	계	1873	1482	391	82	1400	0	930	260	49	50	0	59	52	0	0
경상남도	함양군	휴천면	계	1326	1005	321	68	937	0	615	138	35	61	0	62	26	0	0
경상남도	함양군	유림면	계	1470	1089	381	63	1026	0	712	140	31	59	0	47	37	0	0
경상남도	함양군	수동면	계	2093	1601	492	73	1528	0	1110	229	59	53	0	56	21	0	0
경상남도	함양군	지곡면	계	1790	1338	452	99	1239	0	824	171	95	75	0	46	28	0	0
경상남도	함양군	안의면	계	4048	3019	1029	192	2827	0	2085	358	106	97	0	121	60	0	0
경상남도	함양군	서하면	계	1158	932	226	63	869	0	599	155	32	35	0	32	16	0	0
경상남도	함양군	서상면	계	1565	1227	338	63	1164	0	788	214	56	44	0	43	19	0	0
경상남도	함양군	백전면	계	1302	971	331	72	899	0	625	121	31	40	0	31	51	0	0
경상남도	함양군	병곡면	계	1158	859	299	48	811	0	550	117	39	40	0	25	40	0	0
경상남도	산청군	관외사전투표		2252	2252	0	48	2204	0	1153	713	144	71	0	43	80	0	0
경상남도	산청군	거소우편투표		189	177	12	14	163	0	108	19	8	10	0	6	12	0	0
경상남도	산청군	산청읍	계	5134	3705	1429	184	3521	0	2388	609	165	143	0	93	123	0	0
경상남도	산청군	차황면	계	1282	966	316	54	912	0	639	127	55	40	0	24	27	0	0
경상남도	산청군	오부면	계	968	654	314	23	631	0	452	93	13	22	0	17	34	0	0
경상남도	산청군	생초면	계	2002	1262	740	48	1214	0	948	129	37	35	0	23	42	0	0
경상남도	산청군	금서면	계	2334	1494	840	61	1433	0	989	234	53	64	0	46	47	0	0
경상남도	산청군	삼장면	계	1570	1009	561	36	973	0	790	107	25	23	0	11	17	0	0
경상남도	산청군	시천면	계	3435	2218	1217	101	2117	0	1515	354	78	66	0	51	53	0	0
경상남도	산청군	단성면	계	4847	2771	2076	100	2671	0	1934	406	119	86	0	56	70	0	0
경상남도	산청군	신안면	계	4474	2996	1478	111	2885	0	1880	545	148	93	0	95	124	0	0
경상남도	산청군	생비량면	계	1069	749	320	30	719	0	526	86	26	31	0	25	25	0	0
경상남도	산청군	신등면	계	1886	1300	586	74	1226	0	836	168	49	49	0	88	36	0	0
경상남도	거창군	관외사전투표		2971	2970	1	94	2876	0	1445	1091	147	83	0	49	61	0	0
경상남도	거창군	거소우편투표		228	213	15	14	199	0	131	36	15	6	0	6	5	0	0
경상남도	거창군	거창읍	계	29381	18742	10639	733	18009	0	11606	4643	784	440	0	302	234	0	0
경상남도	거창군	주상면	계	1429	1187	242	138	1049	0	719	173	43	34	0	40	40	0	0
경상남도	거창군	웅양면	계	1743	1440	303	156	1284	0	860	195	60	51	0	50	68	0	0
경상남도	거창군	고제면	계	1269	1013	256	95	918	0	641	138	67	20	0	29	23	0	0
경상남도	거창군	북상면	계	1376	1005	371	82	923	0	655	140	65	35	0	15	13	0	0
경상남도	거창군	위천면	계	1851	1393	458	100	1293	0	950	214	60	33	0	20	16	0	0
경상남도	거창군	마리면	계	1896	1338	558	92	1246	0	938	182	32	54	0	27	13	0	0
경상남도	거창군	남상면	계	2262	1609	653	87	1522	0	1157	218	33	42	0	31	41	0	0
경상남도	거창군	남하면	계	1452	982	470	41	941	0	722	127	21	30	0	24	17	0	0
경상남도	거창군	신원면	계	1455	1036	419	61	975	0	754	127	28	31	0	20	15	0	0
경상남도	거창군	가조면	계	3526	2402	1124	137	2265	0	1748	257	87	96	0	51	26	0	0
경상남도	거창군	가북면	계	1238	950	288	117	833	0	584	123	24	27	0	24	51	0	0
경상남도	합천군	관외사전투표		3345	3340	5	98	3242	0	1829	1002	164	125	0	75	47	0	0
경상남도	합천군	거소우편투표		687	653	34	45	608	0	484	64	21	11	0	14	14	0	0
경상남도	합천군	합천읍	계	8697	6369	2328	302	6067	0	4130	1258	215	282	0	101	81	0	0
경상남도	합천군	봉산면	계	1393	952	441	63	889	0	668	122	23	26	0	28	22	0	0
경상남도	합천군	묘산면	계	1598	1226	372	77	1149	0	837	171	29	53	0	38	21	0	0
경상남도	합천군	가야면	계	4133	2937	1196	155	2782	0	1977	423	82	155	0	98	47	0	0
경상남도	합천군	야로면	계	2317	1648	669	82	1566	0	1191	193	44	59	0	49	30	0	0
경상남도	합천군	율곡면	계	2246	1730	516	106	1624	0	1163	187	56	81	0	103	34	0	0
경상남도	합천군	초계면	계	2350	1823	527	104	1719	0	1226	234	41	57	0	103	58	0	0
경상남도	합천군	쌍책면	계	1240	984	256	64	920	0	658	86	33	47	0	69	27	0	0
경상남도	합천군	덕곡면	계	823	634	189	38	596	0	434	54	39	24	0	30	15	0	0
경상남도	합천군	청덕면	계	1629	1214	415	76	1138	0	811	120	56	56	0	60	35	0	0
경상남도	합천군	적중면	계	1418	1082	336	98	984	0	691	96	38	31	0	63	65	0	0
경상남도	합천군	대양면	계	1460	1049	411	63	986	0	692	129	30	82	0	28	25	0	0
경상남도	합천군	쌍백면	계	1759	1309	450	79	1230	0	863	110	43	120	0	58	36	0	0
경상남도	합천군	삼가면	계	3178	2335	843	143	2192	0	1518	369	74	108	0	79	44	0	0
경상남도	합천군	가회면	계	1678	1255	423	76	1179	0	810	145	43	43	0	90	48	0	0
경상남도	합천군	대병면	계	1823	1310	513	78	1232	0	987	139	32	36	0	16	22	0	0
경상남도	합천군	용주면	계	2134	1529	605	102	1427	0	1002	192	50	118	0	37	28	0	0
제주특별자치도	제주시	관외사전투표		19965	19953	12	363	19590	0	7944	8825	1062	1075	0	0	467	217	0
제주특별자치도	제주시	거소우편투표		1452	1369	83	156	1213	0	585	395	70	75	0	0	39	49	0
제주특별자치도	제주시	한림읍	계	15080	9503	5577	272	9231	0	4924	3183	325	455	0	0	184	160	0
제주특별자치도	제주시	애월읍	계	21698	12650	9048	334	12316	0	5823	4853	607	601	0	0	213	219	0
제주특별자치도	제주시	구좌읍	계	11199	7575	3624	276	7299	0	3921	2196	274	538	0	0	206	164	0
제주특별자치도	제주시	조천읍	계	15356	9664	5692	320	9344	0	4934	3015	407	643	0	0	167	178	0
제주특별자치도	제주시	한경면	계	6323	4738	1585	185	4553	0	2313	1648	183	190	0	0	99	120	0
제주특별자치도	제주시	추자면	계	1638	969	669	37	932	0	473	379	22	24	0	0	10	24	0
제주특별자치도	제주시	우도면	계	1280	776	504	30	746	0	471	215	15	23	0	0	6	16	0
제주특별자치도	제주시	일도1동	계	2943	1358	1585	34	1324	0	726	448	48	71	0	0	21	10	0
제주특별자치도	제주시	일도2동	계	26067	15964	10103	305	15659	0	7751	5910	524	1127	0	0	195	152	0
제주특별자치도	제주시	이도1동	계	5914	3180	2734	70	3110	0	1655	1085	116	194	0	0	39	21	0
제주특별자치도	제주시	이도2동	계	34663	20968	13695	410	20558	0	9315	8156	982	1514	0	0	362	229	0
제주특별자치도	제주시	삼도1동	계	10833	6295	4538	141	6154	0	3372	1997	249	352	0	0	95	89	0
제주특별자치도	제주시	삼도2동	계	7152	3774	3378	79	3695	0	2038	1189	134	214	0	0	61	59	0
제주특별자치도	제주시	용담1동	계	6435	3391	3044	76	3315	0	1784	1173	124	154	0	0	45	35	0
제주특별자치도	제주시	용담2동	계	12683	7283	5400	183	7100	0	3761	2489	299	365	0	0	100	86	0
제주특별자치도	제주시	건입동	계	7994	4354	3640	92	4262	0	2286	1464	164	227	0	0	61	60	0
제주특별자치도	제주시	화북동	계	16739	9867	6872	224	9643	0	4325	4003	416	632	0	0	150	117	0
제주특별자치도	제주시	삼양동	계	9304	5433	3871	137	5296	0	2384	2257	231	280	0	0	74	70	0
제주특별자치도	제주시	봉개동	계	2316	1375	941	55	1320	0	658	448	70	76	0	0	40	28	0
제주특별자치도	제주시	아라동	계	14626	8531	6095	190	8341	0	3525	3370	387	730	0	0	219	110	0
제주특별자치도	제주시	오라동	계	6044	3643	2401	75	3568	0	1715	1377	139	252	0	0	46	39	0
제주특별자치도	제주시	연동	계	31289	15587	15702	235	15352	0	7635	5971	576	840	0	0	204	126	0
제주특별자치도	제주시	노형동	계	35026	20281	14745	336	19945	0	9054	8263	872	1269	0	0	317	170	0
제주특별자치도	제주시	외도동	계	11558	6697	4861	132	6565	0	2962	2685	416	340	0	0	84	78	0
제주특별자치도	제주시	이호동	계	2963	1742	1221	43	1699	0	935	574	62	77	0	0	24	27	0
제주특별자치도	제주시	도두동	계	2064	1228	836	28	1200	0	585	470	48	56	0	0	24	17	0
제주특별자치도	서귀포시	관외사전투표		8694	8692	2	170	8522	0	3320	4005	477	476	0	0	159	85	0
제주특별자치도	서귀포시	거소우편투표		605	555	50	44	511	0	225	171	31	41	0	0	19	24	0
제주특별자치도	서귀포시	대정읍	계	12922	7921	5001	298	7623	0	4196	1999	395	729	0	0	126	178	0
제주특별자치도	서귀포시	남원읍	계	13762	9916	3846	282	9634	0	4481	3280	353	1199	0	0	111	210	0
제주특별자치도	서귀포시	성산읍	계	10656	7457	3199	240	7217	0	3942	2421	289	317	0	0	111	137	0
제주특별자치도	서귀포시	안덕면	계	7403	4879	2524	156	4723	0	2581	1515	186	261	0	0	80	100	0
제주특별자치도	서귀포시	표선면	계	8265	6312	1953	178	6134	0	3330	2062	261	290	0	0	85	106	0
제주특별자치도	서귀포시	송산동	계	3835	2308	1527	60	2248	0	1284	706	93	111	0	0	22	32	0
제주특별자치도	서귀포시	정방동	계	2223	1021	1202	20	1001	0	594	320	38	29	0	0	10	10	0
제주특별자치도	서귀포시	중앙동	계	3542	1812	1730	51	1761	0	1017	609	50	53	0	0	12	20	0
제주특별자치도	서귀포시	천지동	계	3193	1727	1466	33	1694	0	960	560	61	78	0	0	16	19	0
제주특별자치도	서귀포시	효돈동	계	3796	2768	1028	77	2691	0	1358	1029	129	111	0	0	27	37	0
제주특별자치도	서귀포시	영천동	계	3826	2307	1519	73	2234	0	1108	885	85	82	0	0	36	38	0
제주특별자치도	서귀포시	동홍동	계	14931	8332	6599	172	8160	0	3628	3625	311	427	0	0	80	89	0
제주특별자치도	서귀포시	서홍동	계	6560	3959	2601	103	3856	0	1841	1511	182	231	0	0	43	48	0
제주특별자치도	서귀포시	대륜동	계	7472	5038	2434	151	4887	0	2627	1697	173	240	0	0	66	84	0
제주특별자치도	서귀포시	대천동	계	5402	3480	1922	74	3406	0	1661	1334	122	149	0	0	92	48	0
제주특별자치도	서귀포시	중문동	계	6658	4622	2036	134	4488	0	2237	1791	154	188	0	0	54	64	0
제주특별자치도	서귀포시	예래동	계	2833	1975	858	55	1920	0	1038	650	89	64	0	0	29	50	0
